ЁЯША => ЁЯША, рджрд╛рдд рд╡рд┐рдЪрдХрдгрд╛рд░реЗ рд╣рд╛рд╕реНрдп, рд╕реНрдорд┐рдд, рдЪреЗрд╣рд░рд╛ рд╣рд╛рд╕реНрдп, lol рдордЬреЗрджрд╛рд░
ЁЯШБ => ЁЯШБ, рджрд╛рдд рд╡рд┐рдЪрдХрдгрд╛рд░реЗ рд╣рд╛рд╕реНрдп, рд╣рд╕рдгрд╛рд░реЗ рдбреЛрд│реЗ, рджрд╛рдд рд╡рд┐рдЪрдХрдгрд╛рд▒реНрдпрд╛ рд╣рд╛рд╕реНрдпрд╛рдЪрд╛ рдЪреЗрд╣рд░рд╛, рдЪреЗрд╣рд░рд╛, рд╣рд╛рд╕реНрдп, lol рдордЬреЗрджрд╛рд░
ЁЯШВ => ЁЯШВ, рдЖрдирдВрджрд╛рд╢реНрд░реВ, рдЖрдирдВрдж, рдЕрд╢реНрд░реВ, рдЪреЗрд╣рд░рд╛
ЁЯШГ => ЁЯШГ, рдЦреБрд▓реНрдпрд╛ рддреЛрдВрдбрд╛рдЪреЗ рд╣рд╛рд╕реНрдп, рд╣рд╕рдгреЗ, рд╕реНрдорд┐рдд, рд╣рд╕рдгрд╛рд░рд╛ рдЪреЗрд╣рд░рд╛, рдЪреЗрд╣рд░рд╛, lol, рдордЬреЗрджрд╛рд░
ЁЯШД => ЁЯШД, рдЦреБрд▓реНрдпрд╛ рддреЛрдВрдбрд╛рдЪреЗ рд╣рд╛рд╕реНрдп, рд╕реНрдорд┐рдд, рд╣рд╕рд░рд╛, рдЦреБрд▓реЗ рддреЛрдВрдб, рд╣рд╕рдгреЗ, lol, рдбреЛрд│реЗ рд╣рд╕рдд
ЁЯШЕ => ЁЯШЕ, рдердВрдб рдШрд╛рдорд╛рдЪреЗ рд╣рд╛рд╕реНрдп, рд╣рд╛рд╕реНрдп рдкрд░рдВрддреБ рдердВрдб рдШрд╛рдо, рдердВрдб рдШрд╛рдо
ЁЯШЖ => ЁЯШЖ, рдЦреБрд▓реНрдпрд╛ рддреЛрдВрдбрд╛рдЪреЗ рд╣рд╛рд╕реНрдп, рдбреЛрд│реЗ рдмрдВрдж рдХрд░реВрди рд╣рд╛рд╕реНрдп, рдЦреБрд▓реЗ рддреЛрдВрдб, рдмрдВрдж рдбреЛрд│реЗ, рдЪреЗрд╣рд░рд╛
ЁЯШЙ => ЁЯШЙ, рдбреЛрд│реЗ рдорд┐рдЪрдХрд╛рд╡рдгрд╛рд░рд╛ рдЪреЗрд╣рд░рд╛, рдбреЛрд│реЗ рдорд┐рдЪрдХрд╛рд╡рдгреЗ, рдЪреЗрд╣рд░рд╛
ЁЯШК => ЁЯШК, рд╕реНрдорд┐рдд, рд╣рд╕рдгрд╛рд░реЗ рдбреЛрд│реЗ, рд╣рд╕рдгрд╛рд░рд╛ рдЪреЗрд╣рд░рд╛ рдЖрдгрд┐ рдбреЛрд│реЗ, рд╣рд╕рдгрд╛рд░рд╛ рдЪреЗрд╣рд░рд╛, рдЪреЗрд╣рд░рд╛
ЁЯШЛ => ЁЯШЛ, рд╕реНрд╡рд╛рджрд┐рд╖реНрдЯ рдЪреЗрд╣рд░рд╛, рд╕реНрд╡рд╛рджрд┐рд╖реНрдЯ, рдордЬреЗрджрд╛рд░, рд╣рд╕рдгрд╛рд░рд╛ рдЪреЗрд╣рд░рд╛, рд╕реНрд╡рд╛рджрд┐рд╖реНрдЯ рдЕрдиреНрди, рдЪреЗрд╣рд░рд╛
ЁЯШО => ЁЯШО, рдХреВрд▓, рдЫрд╛рди, рдЦреВрдк рдЫрд╛рди, рдПрдХрджрдо рдЫрд╛рди, рдЪрд╖реНрдореНрдпрд╛рд╕рд╣ рд╣рд╛рд╕реНрдп, рд╣рд╛рд╕реНрдп, рдЪрд╖реНрдореЗ, рдЪреЗрд╣рд░рд╛
ЁЯШН => ЁЯШН, рд╣рд╕рдгрд╛рд░рд╛ рдЪреЗрд╣рд░рд╛, рдбреЛрд│реНрдпрд╛рдВрдордзреНрдпреЗ рд╣реГрджрдп, рдкреНрд░реЗрдо, рдкреНрд░реЗрдорднрд╛рд╡ рд╡реНрдпрдХреНрдд рдХрд░рдгрд╛рд░рд╛, рд╣реГрджрдп, рдбреЛрд│реЗ, рдЪреЗрд╣рд░рд╛
ЁЯШШ => ЁЯШШ, рдЪреБрдВрдмрди рдлреЗрдХрдгреЗ, рдЪреБрдВрдмрди рдлреЗрдХрдгрд╛рд░рд╛ рдЪреЗрд╣рд░рд╛, рдЪреЗрд╣рд░рд╛
ЁЯШЧ => ЁЯШЧ, рдЪреБрдВрдмрди рдЪреЗрд╣рд░рд╛, рдЪреБрдВрдмрди, рдЪреЗрд╣рд░рд╛
ЁЯШЩ => ЁЯШЩ, рдЪреБрдВрдмрди рдЖрдгрд┐ рд╣рд╛рд╕реНрдп, рдЪреЗрд╣рд░рд╛, рд╕реНрдорд┐рдд, рд╣рд╕рдгрд╛рд░реЗ рдбреЛрд│реЗ
ЁЯШЪ => ЁЯШЪ, рдЪреБрдВрдмрди рджреЗрдгреЗ, рдбреЛрд│реЗ рдмрдВрдж рдХрд░реВрди рдЪреБрдВрдмрди рджреЗрдгреЗ, рдмрдВрдж рдХреЗрд▓реЗрд▓реЗ рдбреЛрд│реЗ, рдЪреЗрд╣рд░рд╛
тШ║ => тШ║, рд╕реНрдорд┐рдд, рди рднрд░рд▓реЗрд▓рд╛ рд╕реНрдорд┐рдд рдЪреЗрд╣рд░рд╛, рдЪреЗрд╣рд░рд╛
ЁЯЩВ => ЁЯЩВ, рдЪреЗрд╣рд░рд╛, рд╣рд╛рд╕реНрдп
ЁЯдЧ => ЁЯдЧ, рдЪреЗрд╣рд░рд╛, рдорд┐рдареА рдорд╛рд░рдгреЗ, рдЖрд▓рд┐рдВрдЧрди рджреЗрдгреЗ
ЁЯШЗ => ЁЯШЗ, рддреЗрдЬрд╕реНрд╡реА рд╣рд╛рд╕реНрдп, рд╕реНрдорд┐рдд, рддреЗрдЬрд╕реНрд╡реА, рдЪреЗрд╣рд░рд╛
ЁЯдФ => ЁЯдФ, рдЪреЗрд╣рд░рд╛, рд╡рд┐рдЪрд╛рд░ рдХрд░рдгреЗ
ЁЯШР => ЁЯШР, рдирд┐рд░реНрд╡рд┐рдХрд╛рд░ рдЪреЗрд╣рд░рд╛, рдирд┐рд░реНрд╡рд┐рдХрд╛рд░, рддрдЯрд╕реНрде, рдЪреЗрд╣рд░рд╛, рдЯрд┐рдкреНрдкрдгреА рдирд╛рд╣реА
ЁЯШС => ЁЯШС, рдирд┐рд░реНрд╡рд┐рдХрд╛рд░, рдирд┐рд░реНрд╡рд┐рдХрд╛рд░ рдЪреЗрд╣рд░рд╛, рдЪреЗрд╣рд░рд╛, рдЯрд┐рдкреНрдкрдгреА рдирд╛рд╣реА
ЁЯШ╢ => ЁЯШ╢, рддреЛрдВрдб рдирд╕рд▓реЗрд▓рд╛ рдЪреЗрд╣рд░рд╛, рддреЛрдВрдб рдирд╕рд▓реЗрд▓рд╛, рдЪреЗрд╣рд░рд╛
ЁЯЩД => ЁЯЩД, рдбреЛрд│реЗ, рдЪреЗрд╣рд░рд╛, рдлрд┐рд░рд╡рд┐рдгреЗ
ЁЯШП => ЁЯШП, рдмрдирд╛рд╡рдЯреА рд╣рд╛рд╕реНрдп, рдмрдирд╛рд╡рдЯреА рд╣рд╕рдгреЗ, рдЪреЗрд╣рд░рд╛
ЁЯШг => ЁЯШг, рдердкреНрдкрдб рдорд╛рд░рд▓реЗрд▓рд╛, рдЪреЗрд╣рд░рд╛, рд╣рдЯреНрдЯреА рдЪреЗрд╣рд░рд╛, рд╣рдЯреНрдЯреА
ЁЯШе => ЁЯШе, рдХрд╛рдп рдореНрд╣рдгрддрд╛!, рдирд┐рд░рд╛рд╢ рдкрдг рдЪрд┐рдВрддрд╛рдореБрдХреНрдд, рдЪрд┐рдВрддрд╛рдореБрдХреНрдд, рдирд┐рд░рд╛рд╢, рдЪреЗрд╣рд░рд╛
ЁЯШо => ЁЯШо, рдЙрдШрдбреЗ рддреЛрдВрдб рдЕрд╕рд▓реЗрд▓рд╛ рдЪреЗрд╣рд░рд╛, рдЙрдШрдбреЗ рддреЛрдВрдб, рддреЛрдВрдб, рдЪреЗрд╣рд░рд╛
ЁЯдР => ЁЯдР, рдЪреЗрд╣рд░рд╛, рддреЛрдВрдб, рдЙрдШрдбрдгреЗ, рд╕рд╣рд╛рдиреБрднреВрддреА
ЁЯШп => ЁЯШп, рдирд┐рд╕реНрддрдмреНрдз рдЪреЗрд╣рд░рд╛, рдЕрдЪрдВрднрд┐рдд, рдЖрд╢реНрдЪрд░реНрдпрдЪрдХрд┐рдд, рдЪреЗрд╣рд░рд╛
ЁЯШк => ЁЯШк, рдЭреЛрдкреЗрдд рдЕрд╕рд▓реЗрд▓рд╛, рдЪреЗрд╣рд░рд╛
ЁЯШл => ЁЯШл, рдердХрд▓реЗрд▓рд╛, рдЪреЗрд╣рд░рд╛
ЁЯШ┤ => ЁЯШ┤, рдЭреЛрдкрд▓реЗрд▓рд╛, рдЪреЗрд╣рд░рд╛
ЁЯШМ => ЁЯШМ, рдЪрд┐рдВрддрд╛рдореБрдХреНрдд, рдЪреЗрд╣рд░рд╛
ЁЯдУ => ЁЯдУ, рдЪреЗрд╣рд░рд╛, рдЕрд╡рдпрд╡рд╕реНрдерд┐рдд, рдореБрд░реНрдЦ
ЁЯШЫ => ЁЯШЫ, рдЬреАрдн рдмрд╛рд╣реЗрд░, рдЬреАрдн рдмрд╛рд╣реЗрд░ рдХрд╛рдврд▓реЗрд▓реА, рдЬреАрдн рдмрд╛рд╣реЗрд░ рд▓рдЯрдХрдд рдЕрд╕рд▓реЗрд▓рд╛ рдЪреЗрд╣рд░рд╛, рдЪреЗрд╣рд░рд╛
ЁЯШЬ => ЁЯШЬ, рдЬреАрдн рдмрд╛рд╣реЗрд░, рдЪрд┐рдбрд╡рд┐рдгреЗ, рдПрдХрд╛ рдбреЛрд│рд╛ рдорд┐рдЪрдХрд╛рд╡рдд рдЬреАрдн рдмрд╛рд╣реЗрд░ рдХрд╛рдврд▓реЗрд▓реА, рдбреЛрд│реЗ рдорд┐рдЪрдХрд╛рд╡рдгреЗ, рд╡рд┐рдиреЛрдж, рдЪреЗрд╣рд░рд╛
ЁЯШЭ => ЁЯШЭ, рддрд┐рд░рд╕реНрдХрд╛рд░, рдбреЛрд│реЗ рдмрдВрдж рдХрд░реВрди рдЬреАрдн рдмрд╛рд╣реЗрд░ рдХрд╛рдврд▓реЗрд▓реА, рднрдпрдВрдХрд░, рдЬреАрдн рдмрд╛рд╣реЗрд░ рдХрд╛рдврд▓реЗрд▓реА, рдмрдВрдж рдХреЗрд▓реЗрд▓реЗ рдбреЛрд│реЗ, рдЪреЗрд╣рд░рд╛
тШ╣ => тШ╣, рдЪреЗрд╣рд░рд╛, рдЖрдареНтАНрдпрд╛
ЁЯЩБ => ЁЯЩБ, рдЪреЗрд╣рд░рд╛, рдЖрдареНтАНрдпрд╛
ЁЯШТ => ЁЯШТ, рдирд┐рд░рд╕, рдирд┐рд░рд╕ рдЪреЗрд╣рд░рд╛, рджреБ:рдЦреА, рдЪреЗрд╣рд░рд╛
ЁЯШУ => ЁЯШУ, рдердВрдб рдШрд╛рдо, рдердВрдб рдШрд╛рдорд╛рд╕рд╣ рдЪреЗрд╣рд░рд╛, рдЪреЗрд╣рд░рд╛
ЁЯШФ => ЁЯШФ, рд╡рд┐рдЪрд╛рд░рдордЧреНрди рдЪреЗрд╣рд░рд╛, рдЙрджрд╛рд╕, рд╡рд┐рдЪрд╛рд░рдордЧреНрди, рдЪреЗрд╣рд░рд╛
ЁЯШХ => ЁЯШХ, рдЧреЛрдВрдзрд│рд▓реЗрд▓рд╛ рдЪреЗрд╣рд░рд╛, рдЧреЛрдВрдзрд│рд▓реЗрд▓рд╛, рдЪреЗрд╣рд░рд╛
ЁЯШЦ => ЁЯШЦ, рдЕрдЪрдВрднрд┐рдд рдЪреЗрд╣рд░рд╛, рдЕрдЪрдВрднрд┐рдд, рдЪреЗрд╣рд░рд╛
ЁЯЩГ => ЁЯЩГ, рдЪреЗрд╣рд░рд╛, рд╡рд░реАрд▓ рдмрд╛рдЬреВ-рдЦрд╛рд▓реА
ЁЯШ╖ => ЁЯШ╖, рдорд╛рд╕реНрдХ рдЕрд╕рд▓реЗрд▓рд╛ рдЪреЗрд╣рд░рд╛, рдердВрдб, рд╣рд╡рд╛рдорд╛рди рдЕрдВрддрд░реНрдЧрдд, рд╡реИрджреНрдпрдХреАрдп рдорд╛рд╕реНрдХ, рдорд╛рд╕реНрдХ, рдЪреЗрд╣рд░рд╛
ЁЯдТ => ЁЯдТ, рдЪреЗрд╣рд░рд╛, рдЖрдЬрд╛рд░реА, рдерд░реНрдорд╛рдореАрдЯрд░
ЁЯдХ => ЁЯдХ, рдмреЕрдбреЗрдЬ, рдЪреЗрд╣рд░рд╛, рджреБрдЦрд╛рдкрдд, рдЗрдЬрд╛
ЁЯдС => ЁЯдС, рдЪреЗрд╣рд░рд╛, рдкреИрд╕рд╛, рддреЛрдВрдб
ЁЯШ▓ => ЁЯШ▓, рдЕрдЪрдВрднрд┐рдд рдЪреЗрд╣рд░рд╛, рдЖрд╢реНрдЪрд░реНрдпрдЪрдХрд┐рдд, рдкреВрд░реНрдгрдкрдгреЗ рдзрдХреНрдХрд╛ рдмрд╕рд▓реЗрд▓рд╛, рдзрдХреНрдХрд╛ рдмрд╕рд▓реЗрд▓рд╛, рдЪреЗрд╣рд░рд╛
ЁЯШЮ => ЁЯШЮ, рдирд┐рд░рд╛рд╢, рдирд┐рд░рд╛рд╢рд╛, рдирд┐рд░рд╛рд╢ рдЪреЗрд╣рд░рд╛, рдЪреЗрд╣рд░рд╛
ЁЯШЯ => ЁЯШЯ, рдХрд╛рд│рдЬреА, рднрд┐рддреА рд╡рд╛рдЯрдд рдЕрд╕рд▓реЗрд▓рд╛ рдЪреЗрд╣рд░рд╛, рдЪреЗрд╣рд░рд╛
ЁЯШд => ЁЯШд, рд╡рд┐рдЬрдпреА рднрд╛рд╡, рдореА рдЬрд┐рдВрдХрд▓реЛ рдЕрд╕рд╛ рднрд╛рд╡ рдЕрд╕рд▓реЗрд▓рд╛ рдЪреЗрд╣рд░рд╛, рдореА рдЬрд┐рдВрдХрд▓реЛ
ЁЯШв => ЁЯШв, рд░рдбрдгрд╛рд░рд╛, рд░рдбрдХрд╛ рдЪреЗрд╣рд░рд╛, рджреБ:рдЦреА, рдЕрд╢реНрд░реВ, рдЪреЗрд╣рд░рд╛
ЁЯШн => ЁЯШн, рдореЛрдареНрдпрд╛рдиреЗ рдУрд░рдбреВрди рд░рдбрдгрд╛рд░рд╛, рдЕрд╢реНрд░реВ, рд░рдбрдд рдЕрд╕рд▓реЗрд▓рд╛, рд░рдбрдгреЗ, рдЪреЗрд╣рд░рд╛
ЁЯШж => ЁЯШж, рдЦреБрд▓реНрдпрд╛ рддреЛрдВрдбрд╛рд╕рд╣ рдЖрдареНрдпрд╛ рдЕрд╕рд▓реЗрд▓рд╛ рдЪреЗрд╣рд░рд╛, рдЖрдареНрдпрд╛ рдЕрд╕рд▓реЗрд▓рд╛, рдЦреБрд▓реНрдпрд╛ рддреЛрдВрдбрд╛рдЪрд╛, рдЪреЗрд╣рд░рд╛
ЁЯШз => ЁЯШз, рд╡реНрдпрд╛рдХреВрд│, рджреБ:рдЦреА, рдЪреЗрд╣рд░рд╛
ЁЯШи => ЁЯШи, рднрдпрдВрдХрд░, рднреАрддреА рд╡рд╛рдЯрдд рдЕрд╕рд▓реЗрд▓рд╛, рднреАрддреА рд╡рд╛рдЯрдд рдЕрд╕рд▓реЗрд▓рд╛ рдЪреЗрд╣рд░рд╛, рдЪреЗрд╣рд░рд╛
ЁЯШй => ЁЯШй, рдирдХреЛрд╕рд╛ рдЭрд╛рд▓реЗрд▓рд╛, рдердХрд▓реЗрд▓рд╛, рдирдХреЛрд╕рд╛ рдЭрд╛рд▓реЗрд▓рд╛ рдЪреЗрд╣рд░рд╛, рдЪреЗрд╣рд░рд╛
ЁЯШм => ЁЯШм, рддреЛрдВрдб рд╡реЗрдбреЗрд╡рд╛рдХрдбреЗ рдХрд░рдгрд╛рд░рд╛, рддреЛрдВрдб рд╡реЗрдбреЗрд╡рд╛рдХрдбреЗ рдХрд░рдгрд╛рд░рд╛ рдЪреЗрд╣рд░рд╛, рдЪреЗрд╣рд░рд╛
ЁЯШ░ => ЁЯШ░, рдЙрддрд╛рд╡рд│рд╛ рдЪреЗрд╣рд░рд╛, рдердВрдб рдШрд╛рдорд╛рдЪрд╛ рдирд┐рд│рд╛ рдЪреЗрд╣рд░рд╛, рдЦреБрд▓реЗ рддреЛрдВрдб, рдердВрдб рдШрд╛рдо, рдЪреЗрд╣рд░рд╛
ЁЯШ▒ => ЁЯШ▒, рдШрд╛рдмрд░рд▓реЗрд▓рд╛ рдЪреЗрд╣рд░рд╛, рднреАрддреАрдиреЗ рдУрд░рдбрдгреЗ, рднреАрддреАрдиреЗ рдУрд░рдбрдгрд╛рд░рд╛ рдЪреЗрд╣рд░рд╛, рднреАрддреА, рднрдп, рдШрд╛рдмрд░рд▓реЗрд▓рд╛, рднреАрддреА рд╡рд╛рдЯрдд рдЕрд╕рд▓реЗрд▓рд╛, рдЪреЗрд╣рд░рд╛
ЁЯШ│ => ЁЯШ│, рдЙрддреНрддреЗрдЬрд┐рдд, рдЙрддреНрддреЗрдЬрд┐рдд рдЪреЗрд╣рд░рд╛, рд╡рд┐рд╕реНрдордпрдЪрдХрд┐рдд, рдЪреЗрд╣рд░рд╛
ЁЯШ╡ => ЁЯШ╡, рднреЛрд╡рд│ рдпреЗрдгреЗ, рдЪреЗрд╣рд░рд╛
ЁЯШб => ЁЯШб, рд░рд╛рдЧреАрд╖реНрдЯ, рд░рд╛рдЧреАрдЯ, рд╡реЗрдбрд╛, рд▓рд╛рд▓рдмреБрдВрдж рдЭрд╛рд▓реЗрд▓рд╛ рд░рд╛рдЧреАрд╖реНрдЯ рдЪреЗрд╣рд░рд╛, рд▓рд╛рд▓ рдЪреЗрд╣рд░рд╛, рдЪреЗрд╣рд░рд╛
ЁЯШа => ЁЯШа, рд░рд╛рдЧ, рд╡реЗрдбрд╛, рд░рд╛рдЧреАрдЯ рдЪреЗрд╣рд░рд╛, рдЪреЗрд╣рд░рд╛
ЁЯШИ => ЁЯШИ, рд╢рд┐рдВрдЧ рдЕрд╕рд▓реЗрд▓реЗ рд╣рд╛рд╕реНрдп, рд╕реНрдорд┐рдд, рд╢рд┐рдВрдЧреЗ, рдЪреЗрд╣рд░рд╛
ЁЯС┐ => ЁЯС┐, рд╕реИрддрд╛рдирд╛рдЪреЗ рдЕрдкрддреНрдп, рдмреБрдЯрдХрд╛ рд╕реИрддрд╛рди, рд╕реИрддрд╛рди, рдЪреЗрд╣рд░рд╛
ЁЯС╣ => ЁЯС╣, рдирд░рднрдХреНрд╖рдХ рд░рд╛рдХреНрд╖рд╕, рдЕрдХреНрд░рд╛рд│рд╡рд┐рдХреНрд░рд╛рд│, рдУрдиреА, рдХрд╛рд▓реНрдкрдирд┐рдХ рдХрдерд╛, рдЬрдкрд╛рдиреА рдирд░рднрдХреНрд╖рдХрд╝ рд░рд╛рдХреНрд╖рд╕, рдЪреЗрд╣рд░рд╛
ЁЯС║ => ЁЯС║, рднреВрдд, рдЕрдХреНрд░рд╛рд│рд╡рд┐рдХреНрд░рд╛рд│, рдЯреЗрдВрдЧреВ, рдХрд╛рд▓реНрдкрдирд┐рдХ рдХрдерд╛, рдЬрдкрд╛рдиреА рднреВрдд, рдЪреЗрд╣рд░рд╛
ЁЯТА => ЁЯТА, рдХрд╛рд▓реНрдкрдирд┐рдХ рдХрдерд╛, рд╢рд░реАрд░, рдЪреЗрд╣рд░рд╛
тШа => тШа, рд╢рд░реАрд░, рд╡рд┐рд░реВрджреНрдз рдареЗрд╡рд▓реЗрд▓реА рд╣рд╛рдбреЗ, рдореГрддреНрдпреВ, рдЪреЗрд╣рд░рд╛, рд░рд╛рдХреНрд╖рд╕, рдХрд╡рдЯреА
ЁЯС╗ => ЁЯС╗, рдХрд╛рд▓реНрдкрдирд┐рдХ рдХрдерд╛, рдЪреЗрд╣рд░рд╛
ЁЯС╜ => ЁЯС╜, рдкрд░рдЧреНрд░рд╣, рдпреВрдПрдлрдУ, рдХрд╛рд▓реНрдкрдирд┐рдХ рдХрдерд╛, рдЪреЗрд╣рд░рд╛
ЁЯС╛ => ЁЯС╛, рд░рд╛рдХреНрд╖рд╕, рдпреВрдПрдлрдУ, рдХрд╛рд▓реНрдкрдирд┐рдХ рдХрдерд╛, рдЪреЗрд╣рд░рд╛
ЁЯдЦ => ЁЯдЦ, рдЪреЗрд╣рд░рд╛, рд░реЛрдмреЛрдЯ
ЁЯТй => ЁЯТй, рдорд▓, рдкреВ, рдорд▓рд╛рдЪрд╛ рдвреАрдЧ, рд╢реЗрдг, рдвреАрдЧ
ЁЯШ║ => ЁЯШ║, рдЦреБрд▓реНрдпрд╛ рддреЛрдВрдбрд╛рдЪрд╛ рдорд╛рдВрдЬрд░реАрдЪрд╛ рд╣рд╕рдгрд╛рд░рд╛ рдЪреЗрд╣рд░рд╛, рдорд╛рдВрдЬрд░реАрдЪрд╛ рдЪреЗрд╣рд░рд╛, рдЦреБрд▓реЗ рддреЛрдВрдб, рдЦреБрд▓реЗ. рддреЛрдВрдб, рдорд╛рдВрдЬрд░, рдЪреЗрд╣рд░рд╛
ЁЯШ╕ => ЁЯШ╕, рджрд╛рдд рд╡рд┐рдЪрдХрдЯрдгреЗ, рд╡рд┐рдЪрдХрдгрд╛рд░рд╝реНрдпрд╛ рдЖрдгрд┐ рд╣рд╕рдгрд╛рд░рд╝реНрдпрд╛ рдбреЛрд│реНрдпрд╛рдВрдЪреНрдпрд╛ рдорд╛рдВрдЬрд░реАрдЪрд╛ рдЪреЗрд╣рд░рд╛, рдорд╛рдВрдЬрд░, рдЪреЗрд╣рд░рд╛
ЁЯШ╣ => ЁЯШ╣, рдЖрдирдВрджрд╛рд╢реНрд░реВ, рдорд╛рдВрдЬрд░реАрдЪрд╛ рдЪреЗрд╣рд░рд╛, рдорд╛рдВрдЬрд░, рдЪреЗрд╣рд░рд╛
ЁЯШ╗ => ЁЯШ╗, рд╣рд╕рдгрд╛рд░рд╝реНрдпрд╛ рдорд╛рдВрдЬрд░реАрдЪрд╛ рдЪреЗрд╣рд░рд╛, рдкреНрд░реЗрдорд╛рдд, рдкреНрд░реЗрдо, рд╣реНрд░рджрдп, рдбреЛрд│реЗ, рдорд╛рдВрдЬрд░реАрдЪрд╛ рдЪреЗрд╣рд░рд╛, рдорд╛рдВрдЬрд░, рдЪреЗрд╣рд░рд╛
ЁЯШ╝ => ЁЯШ╝, рдорд╛рдВрдЬрд░реАрдЪрд╛ рддрд┐рд░рдкрд╛ рдЪреЗрд╣рд░рд╛, рддрд┐рд░рдкрд╛, рдЙрдкрд░реЛрдзрд┐рдХ рд╕реНрдорд┐рдд, рдорд╛рдВрдЬрд░реАрдЪрд╛ рдЪреЗрд╣рд░рд╛, рдорд╛рдВрдЬрд░, рдЪреЗрд╣рд░рд╛
ЁЯШ╜ => ЁЯШ╜, рдбреЛрд│реЗ рдмрдВрдж рдЕрд╕рд▓реЗрд▓реА, рдЪреБрдВрдмрди рджреЗрдгрд╛рд░реА, рдЪреБрдВрдмрди, рдбреЛрд│реЗ рдмрдВрдж рдХреЗрд▓реЗрд▓реА, рдорд╛рдВрдЬрд░, рдЪреЗрд╣рд░рд╛
ЁЯЩА => ЁЯЩА, рдирдХреЛрд╕рд╛ рдЭрд╛рд▓реЗрд▓рд╛ рдорд╛рдВрдЬрд░реАрдЪрд╛ рдЪреЗрд╣рд░рд╛, рдЕрд░реЗ рджреЗрд╡рд╛, рдЦрд░реЛрдЦрд░ рдЖрд╢реНрдЪрд░реНрдпрдЪрдХрд┐рдд, рдорд╛рдВрдЬрд░, рдЪреЗрд╣рд░рд╛
ЁЯШ┐ => ЁЯШ┐, рд░рдбрдгрд╛рд░реА, рд░рдбрдгреЗ, рдорд╛рдВрдЬрд░реАрдЪрд╛ рдЪреЗрд╣рд░рд╛, рдорд╛рдВрдЬрд░, рдЪреЗрд╣рд░рд╛
ЁЯШ╛ => ЁЯШ╛, рд░рд╛рдЧреАрд╖реНрдЯ, рдорд╛рдВрдЬрд░реАрдЪрд╛ рдЪреЗрд╣рд░рд╛, рдорд╛рдВрдЬрд░, рдЪреЗрд╣рд░рд╛
ЁЯЩИ => ЁЯЩИ, рдХрд╛рд╣реАрд╣реА рд╡рд╛рдИрдЯ рдкрд╛рд╣реВ рдирдХрд╛, рдХрд╛рд╣реАрд╣реА рд╡рд╛рдИрдЯ рдкрд╛рд╣реВ рдирдХрд╛ рд╡рд╛рдирд░, рд╡рд╛рдирд░
ЁЯЩЙ => ЁЯЩЙ, рдХрд╛рд╣реАрд╣реА рд╡рд╛рдИрдЯ рдРрдХреВ рдирдХрд╛, рдХрд╛рд╣реАрд╣реА рд╡рд╛рдИрдЯ рдРрдХреВ рдирдХрд╛ рд╡рд╛рдирд░, рд╡рд╛рдирд░
ЁЯЩК => ЁЯЩК, рдХрд╛рд╣реАрд╣реА рд╡рд╛рдИрдЯ рдмреЛрд▓реВ рдирдХрд╛, рдХрд╛рд╣реАрд╣реА рд╡рд╛рдИрдЯ рдмреЛрд▓реВ рдирдХрд╛ рд╡рд╛рдирд░, рд╡рд╛рдирд░
ЁЯСж => ЁЯСж, рд▓реЛрдХ
ЁЯСз => ЁЯСз, рд▓реЛрдХ
ЁЯСи => ЁЯСи, рд▓реЛрдХ
ЁЯСй => ЁЯСй, рд╕реНрддреНрд░реА, рд▓реЛрдХ
ЁЯС┤ => ЁЯС┤, рдкреБрд░реВрд╖, рд╡реГрджреНрдз, рд▓реЛрдХ
ЁЯС╡ => ЁЯС╡, рд╡реГрджреНрдз рд╕реНрддреНрд░реА, рд╕реНрддреНрд░реА, рд╡реГрджреНрдз, рд▓реЛрдХ
ЁЯС╢ => ЁЯС╢, рд▓реЛрдХ
ЁЯС▒ => ЁЯС▒, рднреВрд░реЗ, рд▓реЛрдХ
ЁЯСо => ЁЯСо, рдкреЛрд▓рд┐рд╕, рдЕрдзрд┐рдХрд╛рд░реА, рд▓реЛрдХ
ЁЯС▓ => ЁЯС▓, рдкреБрд░реБрд╖, рдЧреБрдЖ рдкрд╛рдИ рдорд╛рдУрд╕рд╣ рдкреБрд░реБрд╖, рд▓реЛрдХ, рдЪреАрдиреА
ЁЯС│ => ЁЯС│, рдкреБрд░реВрд╖, рдлреЗрдЯрд╛, рд▓реЛрдХ
ЁЯС╖ => ЁЯС╖, рдмрд╛рдВрдзрдХрд╛рдо рдХрд╛рдордЧрд╛рд░, рдмрд╛рдВрдзрдХрд╛рдо, рдХрд╛рдордЧрд╛рд░, рд▓реЛрдХ
тЫС => тЫС, рдЬрд╛рд╣рд┐рд░рд╛рдд, рд╡рд┐рд░реВрджреНрдз, рдЪреЗрд╣рд░рд╛ рдЯреЛрдкреА, рд╣реЗрд▓рдореЗрдЯ
ЁЯС╕ => ЁЯС╕, рдХрд╛рд▓реНрдкрдирд┐рдХ рдХрдерд╛, рд▓реЛрдХ
ЁЯТВ => ЁЯТВ, рдЧрд╛рд░реНрдбрдореЕрди, рд▓реЛрдХ
ЁЯОЕ => ЁЯОЕ, рд╕рд╛рдВрддрд╛, рдлрд╛рджрд░ рдЦреНрд░рд┐рд╕рдорд╕, рдЦреНрд░рд┐рд╕рдорд╕, рдЙрддреНрд╕рд╡
ЁЯС╝ => ЁЯС╝, рджреЗрд╡рджреВрдд, рдХрд╛рд▓реНрдкрдирд┐рдХ рдХрдерд╛, рдЪреЗрд╣рд░рд╛
ЁЯТЖ => ЁЯТЖ, рдЪреЗрд╣рд▒реНрдпрд╛рдЪреА рдорд╛рд▓рд┐рд╢, рд╕рд▓реВрди
ЁЯТЗ => ЁЯТЗ, рд╣реЗрдЕрд░рдХрдЯ, рд╕реМрдВрджрд░реНрдп, рдкрд╛рд░реНрд▓рд░
ЁЯС░ => ЁЯС░, рд╡рдзреВ, рдкрдбрджреНрдпрд╛рддреАрд▓ рд╡рдзреВ, рдШреБрдВрдШрдЯ, рд▓рдЧреНрди, рд▓реЛрдХ
ЁЯЩН => ЁЯЩН, рдЖрдареНрдпрд╛ рдпреЗрдгрд╛рд░реА рд╡реНрдпрдХреНрддреА, рд╡реНрдпрдХреНрддреА, рд╣рд╛рд╡рднрд╛рд╡
ЁЯЩО => ЁЯЩО, рд░рд╛рдЧреАрд╖реНрдЯ, рд╡реНрдпрдХреНрддреА, рд╣рд╛рд╡рднрд╛рд╡
ЁЯЩЕ => ЁЯЩЕ, рдЕрдЧрджреА рд╡рд╛рдИрдЯ рд╣рд╛рд╡рднрд╛рд╡, рдХрд╛рд╣реАрд╣реА рдЪрд╛рдВрдЧрд▓реЗ рдирд╛рд╣реА рдЕрд╕реЗ рд╣рд╛рд╡рднрд╛рд╡, рдХрд╛рд╣реА рдЪрд╛рдВрдЧрд▓реЗ рдирд╛рд╣реА, рдирд╛рд╣реА, рд╣рд╛рд╡рднрд╛рд╡, рдЪреЗрд╣рд░рд╛
ЁЯЩЖ => ЁЯЩЖ, рд╕рд░реНрд╡ рдареАрдХ рдЖрд╣реЗ, рд╣рд╛рд╡рднрд╛рд╡, рдЪреЗрд╣рд░рд╛
ЁЯТБ => ЁЯТБ, рдорд╛рд╣рд┐рддреА рдбреЗрд╕реНрдХ, рдорджрдд, рдорд╛рд╣рд┐рддреА, рд▓реЛрдХ
ЁЯЩЛ => ЁЯЩЛ, рдЖрдирдВрджреА рд╡реНрдпрдХреНрддреА, рд╣рд╛рдд рдЙрдВрдЪрд╛рд╡рдгреЗ, рд╣рд╛рдд рдЙрдВрдЪрд╛рд╡рдгрд╛рд░реА рд╡реНрдпрдХреНрддреА, рдЖрдирдВрджреА, рд╡реНрдпрдХреНрддреА, рд╣рд╛рд╡рднрд╛рд╡
ЁЯЩЗ => ЁЯЩЗ, рдорд▓рд╛ рдХреНрд╖рдорд╛ рдХрд░рд╛, рдкреВрд░реНрдгрдкрдгреЗ рдЭреБрдХрдгреЗ, рдХреНрд╖рдорд╛, рдЭреБрдХрдгреЗ, рд╣рд╛рд╡рднрд╛рд╡, рд╡реНрдпрдХреНрддреА
ЁЯЩМ => ЁЯЩМ, рд╣реБрд░реНрд░реЗ, рдЖрдирдВрджрд╛рдиреЗ рджреЛрдиреНрд╣реА рд╣рд╛рдд рдЙрдВрдЪрд╛рд╡рдгреЗ, рджреЛрдиреНрд╣реА рд╣рд╛рдд, рдЙрддреНрд╕рд╡
ЁЯЩП => ЁЯЩП, рджреБрдордбрд▓реЗрд▓реЗ рд╣рд╛рдд, рдкреНрд░рд╛рд░реНрдердирд╛, рдкреНрд░рд╛рд░реНрдердирд╛ рдХрд░реАрдд рдЕрд╕рд▓реЗрд▓реЗ, рд╣рд╛рдд, рд╣рд╛рд╡рднрд╛рд╡
ЁЯЧг => ЁЯЧг, рдЪреЗрд╣рд░рд╛, рдбреЛрдХреЗ, рдЫрд╛рдпрд╛рдЪрд┐рддреНрд░
ЁЯСд => ЁЯСд, рд╡рд░рдЪреНрдпрд╛ рд╢рд░реАрд░рд╛рдЪреА рдЫрд╛рдпрд╛, рд╢рд░реАрд░рд╛рдЪрд╛ рд╡рд░рдЪрд╛ рднрд╛рдЧ, рд▓реЛрдХ
ЁЯСе => ЁЯСе, рд╡рд░рдЪреНрдпрд╛ рд╢рд░реАрд░рд╛рдЪреНрдпрд╛ рдЫрд╛рдпрд╛, рд╢рд░реАрд░рд╛рдЪрд╛ рд╡рд░рдЪрд╛ рднрд╛рдЧ, рд▓реЛрдХ
ЁЯЪ╢ => ЁЯЪ╢, рдкрд╛рджрдЪрд╛рд░реА, рдкрд╛рдпреА рдЪрд╛рд▓рдгрд╛рд░реЗ
ЁЯПГ => ЁЯПГ, рдзрд╛рд╡рдгрд╛рд░реА рд╡реНрдпрдХреНрддреА, рдзрд╛рд╡рдгреЗ, рдореЕрд░реЗрдереЙрди, рдХреНрд░рд┐рдбрд╛
ЁЯСп => ЁЯСп, рд╕рд╕рд╛ рдореБрд▓рдЧреА, рд╕рд╢реНрдпрд╛рдЪреЗ рдХрд╛рди, рдореБрд▓рдЧреА, рд╕реНрддреНрд░реА, рд▓реЛрдХ
ЁЯТГ => ЁЯТГ, рдиреГрддреНрдпрд╛рдВрдЧрдирд╛, рдиреГрддреНрдп, рд▓реЛрдХ
ЁЯХ┤ => ЁЯХ┤, рд╡реНрдпрд╡рд╕рд╛рдп, рдордиреБрд╖реНрдп, рд╕реВрдЯ
ЁЯТП => ЁЯТП, рд▓реЛрдХ, рдкреНрд░рдгрдп
ЁЯТС => ЁЯТС, рдЬреЛрдбреА, рд╣реГрджрдпрд╛рд╕рд╣ рдЬреЛрдбреА, рд╣реГрджрдп, рд▓реЛрдХ, рдкреНрд░рдгрдп
ЁЯСк => ЁЯСк, рд╡рдбреАрд▓, рдЖрдИ, рдореБрд▓рдЧрд╛, рд▓реЛрдХ
ЁЯСл => ЁЯСл, рдкреБрд░реБрд╖ рдЖрдгрд┐ рд╕реНрддреНрд░реА, рдЬреЛрдбреА, рд╣рд╛рдд рдзрд░рд▓реЗрд▓реЗ рдкреБрд░реБрд╖ рдЖрдгрд┐ рд╕реНрддреНрд░реА, рдкреБрд░реБрд╖, рд╕реНрддреНрд░реА, рд╣рд╛рдд рдзрд░рд▓реЗрд▓реЗ, рд▓реЛрдХ
ЁЯСм => ЁЯСм, рджреЛрди рдкреБрд░реБрд╖, рдЬреЛрдбреА, рд╣рд╛рдд рдзрд░рд▓реЗрд▓реЗ рджреЛрди рдкреБрд░реБрд╖, рдкреБрд░реВрд╖, рд╣рд╛рдд рдзрд░рд▓реЗрд▓реЗ, рд▓реЛрдХ
ЁЯСн => ЁЯСн, рджреЛрди рд╕реНрддреНрд░рд┐рдпрд╛, рд╕реНрддреНрд░рд┐рдпрд╛рдВрдЪреА рдЬреЛрдбреА, рд╣рд╛рдд рдзрд░рд▓реЗрд▓реНрдпрд╛ рджреЛрди рд╕реНрддреНрд░рд┐рдпрд╛, рд╕реНрддреНрд░реА, рдзрд░рд▓реЗрд▓реЗ рд╣рд╛рдд, рд▓реЛрдХ
ЁЯП╗ => ЁЯП╗, рдИрдореЛрдЬреА рд╕реБрдзрд╛рд░рдХ, fitzpatrick, рддреНрд╡рдЪрд╛, рдкреНрд░рдХрд╛рд░
ЁЯП╝ => ЁЯП╝, рдИрдореЛрдЬреА рд╕реБрдзрд╛рд░рдХ, fitzpatrick, рддреНрд╡рдЪрд╛, рдкреНрд░рдХрд╛рд░
ЁЯП╜ => ЁЯП╜, рдИрдореЛрдЬреА рд╕реБрдзрд╛рд░рдХ, fitzpatrick, рддреНрд╡рдЪрд╛, рдкреНрд░рдХрд╛рд░
ЁЯП╛ => ЁЯП╛, рдИрдореЛрдЬреА рд╕реБрдзрд╛рд░рдХ, fitzpatrick, рддреНрд╡рдЪрд╛, рдкреНрд░рдХрд╛рд░
ЁЯП┐ => ЁЯП┐, рдИрдореЛрдЬреА рд╕реБрдзрд╛рд░рдХ, fitzpatrick, рддреНрд╡рдЪрд╛, рдкреНрд░рдХрд╛рд░
ЁЯТк => ЁЯТк, рдмрд╛рд╣реВрдЪрд╛ рд╕реНрдирд╛рдпреВ, рд╕реНрдирд╛рдпреВ рд╡рд╛рдХрд╡рдгреЗ, рд╕реНрдирд╛рдпреВ, рдордЬрдмреВрдд, рд╡рд╛рдХрд╡рдгреЗ, рд╡рд┐рдиреЛрджреА, рдЬреЛрд░ рджрд╛рдЦрд╡рдгреЗ
ЁЯСИ => ЁЯСИ, рдбрд╛рд╡реЗ рдмреЛрдЯ, рдбрд╛рд╡реАрдХрдбреЗ рд╕рдВрдХреЗрдд рдХрд░рдгрд╛рд░реЗ рдмреЛрдЯ, рддрд░реНрдЬрдиреА, рдорд│рд╣рд╛рдд, рдмреЛрдЯ
ЁЯСЙ => ЁЯСЙ, рдЙрдЬрд╡реЗ рдмреЛрдЯ, рдбрд╛рд╡реАрдХрдбреЗ рд╕рдВрдХреЗрдд рдХрд░рдгрд╛рд░реЗ рдмреЛрдЯ, рддрд░реНрдЬрдиреА, рдорд│рд╣рд╛рдд, рдмреЛрдЯ
тШЭ => тШЭ, рд╢рд░реАрд░, рдмреЛрдЯ, рд╣рд╛рдд, рддрд░реНрдЬрдиреА, рджрд░реНрд╢рд╡рд┐рдгреЗ, рд╡рд░
ЁЯСЖ => ЁЯСЖ, рдмреЛрдЯ рд╡рд░, рд╡рд░ рд╕рдВрдХреЗрдд рдХрд░рдгрд╛рд░реЗ рдмреЛрдЯ, рддрд░реНрдЬрдиреА, рдорд│рд╣рд╛рдд, рдмреЛрдЯ
ЁЯЦХ => ЁЯЦХ, рд╢рд░реАрд░, рдмреЛрдЯ, рд╣рд╛рдд
ЁЯСЗ => ЁЯСЗ, рдмреЛрдЯ рдЦрд╛рд▓реА, рдЦрд╛рд▓реА рд╕рдВрдХреЗрдд рдХрд░рдгрд╛рд░реЗ рдмреЛрдЯ, рддрд░реНрдЬрдиреА, рдорд│рд╣рд╛рдд, рдмреЛрдЯ
тЬМ => тЬМ, рдХрд╛рддреНрд░реА, рд╡рд┐рдЬрдпреА рд╣рд╛рдд, рд╡рд┐рдЬрдпреА, рд╣реЛрдп
ЁЯЦЦ => ЁЯЦЦ, рдФрдХреНрд╖рд╡рдВрдд рд╣реЛрдгреЗ, рджреАрд░реНрдШрд╛рдпреБрд╖реНрдп рд▓рд╛рднрдгреЗ
ЁЯдШ => ЁЯдШ, рд╢рд░реАрд░, рдмреЛрдЯ, рд╣рд╛рдд, рд╢рд┐рдВрдЧреЗ, рд░реЙрдХ рдСрди
ЁЯЦР => ЁЯЦР, рд╢рд░реАрд░, рдмреЛрдЯ, рд╣рд╛рдд, рдкрд╕рд░рд╡рд┐рд▓реЗрд▓реЗ
тЬЛ => тЬЛ, рдХрд╛рдЧрдж
ЁЯСМ => ЁЯСМ, рдареАрдХ рдЪрд┐рдиреНрд╣, рдареАрдХ рдЕрд╕реЗ рд╣рд╛рддрд╛рдЪреЗ рдЪрд┐рдиреНрд╣, рдареАрдХ, рд╣рд╛рдд, рдЪрд┐рдиреНрд╣, рд╕реБрдВрджрд░
ЁЯСН => ЁЯСН, рдердореНрд╕, рдЕрдк, рд╣рд╛рдд, рдЪрд┐рдиреНрд╣
ЁЯСО => ЁЯСО, рдердореНрд╕, рдбрд╛рдЙрди, рд╣рд╛рдд, рдЪрд┐рдиреНрд╣
тЬК => тЬК, рд░реЙрдХ, рдЙрдВрдЪрд╛рд╡рд▓рд▓реА рдШрдЯреНрдЯ рдореБрда
ЁЯСК => ЁЯСК, рдШрдЯреНрдЯ рдореБрда, рдореБрда, рд╣рд╛рдд
ЁЯСЛ => ЁЯСЛ, рд╣рд╛рдд рд╣рд▓рд╡рд┐рдгреЗ, рд╣рд╛рдд, рд╣рд▓рд╡рд┐рдгреЗ
ЁЯСП => ЁЯСП, рд╣рд╛рддрд╛рдЪреА рдЯрд╛рд│реА, рд╣рд╛рдд, рдЯрд╛рд│реНрдпрд╛, рдЪрд┐рдиреНрд╣
ЁЯСР => ЁЯСР, рдЦреБрд▓реЗ рд╣рд╛рддрд╛рдЪреЗ рдЪрд┐рдиреНрд╣, рдЦреБрд▓реЗ, рдЪрд┐рдиреНрд╣
тЬН => тЬН, рд╢рд░реАрд░, рд╣рд╛рдд, рд▓рд┐рд╣рд┐рдгреЗ
ЁЯТЕ => ЁЯТЕ, рдирдЦрд╛рдВрдЪреА рдирд┐рдЧрд╛ рд░рд╛рдЦрдгреЗ, рдирдЦреЗ, рдиреЗрд▓ рдкреЙрд▓рд┐рд╢, рд╕реМрдВрджрд░реНрдп рдкреНрд░рд╕рд╛рдзрдиреЗ, рдиреЗрд▓рдкреЗрдВрдЯ
ЁЯСВ => ЁЯСВ, рд╢рд░реАрд░
ЁЯСГ => ЁЯСГ, рдЪреЗрд╣рд░рд╛, рд╢рд░реАрд░
ЁЯСг => ЁЯСг, рдкрд╛рд╡рд▓рд╛рдЪрд╛ рдард╕рд╛, рдард╕рд╛, рд╢рд░реАрд░
ЁЯСА => ЁЯСА, рдЪреЗрд╣рд░рд╛
ЁЯСБ => ЁЯСБ, рд╢рд░реАрд░
ЁЯСЕ => ЁЯСЕ, рдЪреЗрд╣рд░рд╛, рд╢рд░реАрд░
ЁЯСД => ЁЯСД, рддреЛрдВрдб, рдЪреЗрд╣рд░рд╛, рд╢рд░реАрд░
ЁЯТЛ => ЁЯТЛ, рдЪреБрдВрдмрди рдЪрд┐рдиреНрд╣, рдУрда, рдЪреБрдВрдмрди, рдкреНрд░рдгрдп
ЁЯТШ => ЁЯТШ, рд╣реГрджрдп рд╡ рдмрд╛рдг, рд╣реГрджрдп, рдмрд╛рдг, рдкреНрд░реЗрдо, рднрд╛рд╡рдирд╛
ЁЯТУ => ЁЯТУ, рдзрдбрдХрдгрд╛рд░реЗ, рдзрдбрдХрди, рд╣реГрджрдп, рдкреНрд░реЗрдо, рднрд╛рд╡рдирд╛
ЁЯТФ => ЁЯТФ, рд╣реГрджрдп рддреБрдЯрдгреЗ, рддреБрдЯрд▓реЗрд▓реЗ рд╣реНрд░рджрдп, рддреБрдЯрдгреЗ, рд╣реГрджрдп, рддреБрдЯрд▓реЗрд▓реЗ, рднрд╛рд╡рдирд╛
ЁЯТХ => ЁЯТХ, рдкреНрд░реЗрдореА, рдкреНрд░реЗрдо, рднрд╛рд╡рдирд╛
ЁЯТЦ => ЁЯТЦ, рдЪрдордХрддреЗ рд╣реГрджрдп, рдЙрддреНрд╕реБрдХ, рдЪрдордХрддреЗ, рдкреНрд░реЗрдо, рднрд╛рд╡рдирд╛
ЁЯТЧ => ЁЯТЧ, рд╡рд╛рдврддреЗ рд╣реГрджрдп, рдЪрд┐рдВрддрд╛рдЧреНрд░рд╕реНрдд, рдЙрддреНрд╕реБрдХ, рд╣реГрджрдп, рдкреНрд░реЗрдо, рднрд╛рд╡рдирд╛
ЁЯТЩ => ЁЯТЩ, рдирд┐рд│реЗ рд╣реГрджрдп, рдирд┐рд│реЗ, рд╣реГрджрдп, рднрд╛рд╡рдирд╛
ЁЯТЪ => ЁЯТЪ, рд╣рд┐рд░рд╡реЗ рд╣реГрджрдп, рд╣рд┐рд░рд╡реЗ, рд╣реГрджрдп, рднрд╛рд╡рдирд╛
ЁЯТЫ => ЁЯТЫ, рдкрд┐рд╡рд│реЗ рд╣реГрджрдп, рдкрд┐рд╡рд│реЗ, рд╣реГрджрдп, рднрд╛рд╡рдирд╛
ЁЯТЬ => ЁЯТЬ, рдЬрд╛рдВрднрд│реЗ рд╣реГрджрдп, рдЬрд╛рдВрднрд│реЗ, рд╣реГрджрдп, рднрд╛рд╡рдирд╛
ЁЯТЭ => ЁЯТЭ, рд░рд┐рдмрдирд╕рд╣ рд╣реГрджрдп, рд╣реГрджрдп, рд░рд┐рдмрди, рд╡реНрд╣реЕрд▓реЗрдВрдЯрд╛рдИрди, рднрд╛рд╡рдирд╛
ЁЯТЮ => ЁЯТЮ, рдлрд┐рд░рдгрд╛рд░реЗ рд╣реГрджрдп, рд╣реГрджрдп, рдлрд┐рд░рдгрд╛рд░реЗ, рд╕реБрдВрджрд░, рдХрд╛рд╡рд╛рдИ, рдкреНрд░реЗрдо, рдореЛрд╣рдХ, рднрд╛рд╡рдирд╛
ЁЯТЯ => ЁЯТЯ, рд╣реГрджрдп рд╕рдЬрд╛рд╡рдЯ, рд╣реГрджрдп
тЭг => тЭг, рдЙрджреНрдЧрд╛рд░рд╡рд╛рдЪрдХ рдЪрд┐рдиреНрд╣, рд╣реГрджрдп, рдЪрд┐рдиреНрд╣, рд╡рд┐рд░рд╛рдордЪрд┐рдиреНрд╣
ЁЯТМ => ЁЯТМ, рд╣реГрджрдп рдЕрд╕рд▓реЗрд▓реЗ рдореЗрд▓, рдкрддреНрд░, рд╣реГрджрдп, рдкреНрд░рдгрдп
ЁЯТд => ЁЯТд, рдирд┐рд╡рд╛рдВрдд, Zzz, рдШреЛрд░рдгрд╛рд░рд╛, рд╡рд┐рдиреЛрджреА, рднрд╛рд╡рдирд╛
ЁЯТв => ЁЯТв, рд░рд╛рдЧреАрдЯ рдЪрд┐рдиреНрд╣, рд╡рд┐рдиреЛрджреА, рднрд╛рд╡рдирд╛
ЁЯТг => ЁЯТг, рд╡рд┐рдиреЛрджреА, рднрд╛рд╡рдирд╛
ЁЯТе => ЁЯТе, рдЯрдХреНрдХрд░рдЪреЗ рдкреНрд░рддреАрдХ, рд╡рд┐рдиреЛрджреА, рднрд╛рд╡рдирд╛
ЁЯТж => ЁЯТж, рдШрд╛рдо, рдШрд╛рдо рдЖрдгрдгрд╛рд░рд╛, рд╡рд┐рдиреЛрджреА, рднрд╛рд╡рдирд╛
ЁЯТи => ЁЯТи, рдЬреЛрд░рд╛рдд рдзрд╛рд╡рдгреЗ, рдзрд╛рд╡рдгреЗ, рдзрд╛рд╡, рд╡рд┐рдиреЛрджреА, рднрд╛рд╡рдирд╛
ЁЯТл => ЁЯТл, рднреЛрд╡рдгреЗ, рддрд╛рд░реЗ рджрд┐рд╕рдгреЗ, рддрд╛рд░реЗ, рд╡рд┐рдиреЛрджреА, рднрд╛рд╡рдирд╛
ЁЯТм => ЁЯТм, рдмреЛрд▓рдгреНрдпрд╛рдЪрд╛ рдлреБрдЧрд╛, рдмреЛрд▓рдгреНрдпрд╛рдЪрд╛ рдмрдмрд▓, рд╕рдВрд╡рд╛рдж рдмрдмрд▓, рдлреБрдЧрд╛, рдмрдмрд▓, рд╕рдВрд╡рд╛рдж, рд╡рд┐рдиреЛрджреА
ЁЯЧи => ЁЯЧи, рд╕рдВрд╡рд╛рдж, рдЙрдЪреНрдЪрд╛рд░
ЁЯЧп => ЁЯЧп, рд░рд╛рдЧ, рдлреБрдЧрд╛, рдмреБрдбрдмреБрдбрд╛, рд╡реЗрдбрд╛
ЁЯТн => ЁЯТн, рд╡рд┐рдЪрд╛рд░рд╛рдВрдЪрд╛ рдлреБрдЧрд╛, рд╡рд┐рдЪрд╛рд░рд╛рдВрдЪрд╛ рдмрдмрд▓, рд╡рд┐рдЪрд╛рд░, рдмрдмрд▓, рд╡рд┐рдиреЛрджреА
ЁЯХ│ => ЁЯХ│, рдЫрд┐рджреНрд░
ЁЯСУ => ЁЯСУ, рдЪрд╛рд│реАрд╢реА, рдХрдкрдбреЗ
ЁЯХ╢ => ЁЯХ╢, рдЧрдбрдж, рдбреЛрд│рд╛, рдЪрд╖реНрдорд╛
ЁЯСФ => ЁЯСФ, рдиреЗрдХрдЯрд╛рдп, рдХрдкрдбреЗ
ЁЯСХ => ЁЯСХ, рдЯреА-рд╢рд░реНрдЯ, рд╢рд░реНрдЯ, рдХрдкрдбреЗ
ЁЯСЦ => ЁЯСЦ, рд╡рд┐рдЬрд╛рд░, рдЪрдбреНрдбреА, рдХрдкрдбреЗ
ЁЯСЧ => ЁЯСЧ, рдбреНрд░реЗрд╕, рд╡рди рдкрд┐рд╕
ЁЯСШ => ЁЯСШ, рдбреНрд░реЗрд╕, рдХрдкрдбреЗ
ЁЯСЩ => ЁЯСЩ, рдмрд┐рдХрд┐рдиреА, рдЖрдВрдШреЛрд│реАрдЪрд╛ рд╕реВрдЯ, рдХрдкрдбреЗ
ЁЯСЪ => ЁЯСЪ, рд╕реНрддреНрд░реАрдЪреЗ рдХрдкрдбреЗ, рдХрдкрдбреЗ
ЁЯСЫ => ЁЯСЫ, рдереИрд▓реА, рдирд╛рдгреНрдпрд╛рдВрдЪреА рдереИрд▓реА, рдирд╛рдгреЗ, рдХрдкрдбреЗ
ЁЯСЬ => ЁЯСЬ, рд╣реЕрдиреНрдбрдмреЕрдЧ, рдмреЕрдЧ, рдХрдкрдбреЗ, рдкрд░реНрд╕
ЁЯСЭ => ЁЯСЭ, рдкрд╛рдЙрдЪ, рдмреЕрдЧ, рдХрдкрдбреЗ
ЁЯЫН => ЁЯЫН, рдкрд┐рд╢рд╡реА, рд╣реЙрдЯреЗрд▓, рдЦрд░реЗрджреА
ЁЯОТ => ЁЯОТ, рд╢рд╛рд│реЗрдЪреЗ рджрдкреНрддрд░, рджрдкреНрддрд░, рд╢рд╛рд│рд╛
ЁЯСЮ => ЁЯСЮ, рдкреБрд░реВрд╖рд╛рдЪреЗ рдмреВрдЯ, рдмреВрдЯ, рдХрдкрдбреЗ
ЁЯСЯ => ЁЯСЯ, рдЦреЗрд│рд╛рдбреВрдВрдЪреЗ рдмреВрдЯ, рд╕реНрдиреАрдХрд░, рдмреВрдЯ, рдХрдкрдбреЗ
ЁЯСа => ЁЯСа, рдЙрдВрдЪ рдЯрд╛рдЪреЗрдЪреЗ рдмреВрдЯ, рдмреВрдЯ, рдХрдкрдбреЗ
ЁЯСб => ЁЯСб, рд╕реНрддреНрд░реАрдпрд╛рдВрдЪреНрдпрд╛ рд╕реЕрдиреНрдбрд▓, рд╕реЕрдиреНрдбрд▓, рд╕реНрддреНрд░реА, рдХрдкрдбреЗ
ЁЯСв => ЁЯСв, рд╕реНрддреНрд░реАрдЪреЗ рдмреВрдЯ, рдмреВрдЯ, рд╕реНрддреНрд░реА, рдХрдкрдбреЗ
ЁЯСС => ЁЯСС, рдХрдкрдбреЗ
ЁЯСТ => ЁЯСТ, рд╕реНрддреНрд░реАрдЪреА рдЯреЛрдкреА, рдЯреЛрдкреА, рдХрдкрдбреЗ
ЁЯОй => ЁЯОй, рд╢реАрд░реНрд╖ рдЯреЛрдкреА, рдЯреЛрдкреА, рдордиреЛрд░рдВрдЬрди, рдЬрд╛рджреВрдЧрд░
ЁЯОУ => ЁЯОУ, рдкрджрд╡реАрдЪреА рдЯреЛрдкреА, рдЯреЛрдкреА, рдкрджрд╡реА, рдЙрддреНрд╕рд╡
ЁЯУ┐ => ЁЯУ┐, рдХрдкрдбреЗ, рдЧрд│реНтАНрдпрд╛рдд рдШрд╛рд▓рд╛рдпрдЪрд╛ рдореЛрддреНрдпрд╛рдЪрд╛ рдХрд┐рдВрд╡рд╛ рд╕реЛрдиреНрдпрд╛рдЪрд╛ рд╣рд╛рд░, рдкреНрд░рд╛рд░реНрдердирд╛, рдзрд░реНрдо
ЁЯТД => ЁЯТД, рд▓рд┐рдкрд╕реНрдЯрд┐рдХ, рдореЗрдХрдЕрдк, рд╕реМрдВрджрд░реНрдп рдкреНрд░рд╕рд╛рдзрдиреЗ
ЁЯТН => ЁЯТН, рдкреНрд░рдгрдп
ЁЯТО => ЁЯТО, рд░рддреНрдирдЦрдбрд╛, рд╣рд┐рд░рд╛, рдкреНрд░рдгрдп
ЁЯР╡ => ЁЯР╡, рд╡рд╛рдирд░рд╛рдЪрд╛ рдЪреЗрд╣рд░рд╛, рд╡рд╛рдирд░, рдЪреЗрд╣рд░рд╛, рдкреНрд░рд╛рдгреА
ЁЯРТ => ЁЯРТ, рд╡рд╛рдирд░, рдкреНрд░рд╛рдгреА
ЁЯР╢ => ЁЯР╢, рдХреБрддреНрд░реНрдпрд╛рдЪрд╛ рдЪреЗрд╣рд░рд╛, рдХреБрддреНрд░рд╛, рдЪреЗрд╣рд░рд╛, рдкреНрд░рд╛рдгреА
ЁЯРХ => ЁЯРХ, рдХреБрддреНрд░реНрдпрд╛рдЪреЗ рдкрд┐рд▓реНрд▓реВ, рдкреНрд░рд╛рдгреА
ЁЯРй => ЁЯРй, рдПрдХ рдкрд╛рд│реАрд╡ рдХреЗрд╕рд╛рд│ рдХреБрддреНрд░рд╛, рдХреБрддреНрд░рд╛, рдкреНрд░рд╛рдгреА
ЁЯР║ => ЁЯР║, рд▓рд╛рдВрдбрдЧрд╛, рдЪреЗрд╣рд░рд╛, рдкреНрд░рд╛рдгреА
ЁЯР▒ => ЁЯР▒, рдорд╛рдВрдЬрд░, рдЪреЗрд╣рд░рд╛, рдкреНрд░рд╛рдгреА
ЁЯРИ => ЁЯРИ, рдкреНрд░рд╛рдгреА
ЁЯжБ => ЁЯжБ, рдЪреЗрд╣рд░рд╛, рд╕рд┐рдВрд╣, рд░рд╛рд╢реАрдЪрдХреНрд░
ЁЯРп => ЁЯРп, рд╡рд╛рдШ, рдкреНрд░рд╛рдгреА
ЁЯРЕ => ЁЯРЕ, рдкреНрд░рд╛рдгреА
ЁЯРЖ => ЁЯРЖ, рдмрд┐рдмрдЯреНрдпрд╛, рдкреНрд░рд╛рдгреА
ЁЯР┤ => ЁЯР┤, рдШреЛрдбреНрдпрд╛рдЪрд╛ рдЪреЗрд╣рд░рд╛, рдШреЛрдбрд╛, рдЪреЗрд╣рд░рд╛, рдкреНрд░рд╛рдгреА
ЁЯРО => ЁЯРО, рдкреНрд░рд╛рдгреА
ЁЯжД => ЁЯжД, рдЪреЗрд╣рд░рд╛, рдХрд╛рд▓реНрдкрдирд┐рдХ рдПрдХрд╢реГрдВрдЧреА рдШреЛрдбрд╛
ЁЯРо => ЁЯРо, рдЧрд╛рдп, рдЪреЗрд╣рд░рд╛, рдкреНрд░рд╛рдгреА
ЁЯРВ => ЁЯРВ, рдкреНрд░рд╛рдгреА
ЁЯРГ => ЁЯРГ, рдкрд╛рдгреА, рдореНрд╣реИрд╕, рдкреНрд░рд╛рдгреА
ЁЯРД => ЁЯРД, рдкреНрд░рд╛рдгреА
ЁЯР╖ => ЁЯР╖, рдбреБрдХреНрдХрд░, рдЪреЗрд╣рд░рд╛, рдкреНрд░рд╛рдгреА
ЁЯРЦ => ЁЯРЦ, рдкреНрд░рд╛рдгреА
ЁЯРЧ => ЁЯРЧ, рд░рд╛рдирдбреБрдХреНрдХрд░, рдкреНрд░рд╛рдгреА
ЁЯР╜ => ЁЯР╜, рдбреБрдХреНрдХрд░рд╛рдЪреЗ рдирд╛рдХ, рдирд╛рдХ, рдбреБрдХреНрдХрд░, рдЪреЗрд╣рд░рд╛, рдкреНрд░рд╛рдгреА
ЁЯРП => ЁЯРП, рдкреНрд░рд╛рдгреА
ЁЯРС => ЁЯРС, рдкреНрд░рд╛рдгреА
ЁЯРР => ЁЯРР, рд╢реЗрд│реА, рдкреНрд░рд╛рдгреА
ЁЯРк => ЁЯРк, рдПрдХ рдХреБрдмрдб рдЕрд╕рд▓реЗрд▓рд╛ рдЙрдВрдЯ, рдХреБрдмрдб, рдорджрд╛рд░реАрдЪрд╛ рдЙрдВрдЯ, рдкреНрд░рд╛рдгреА
ЁЯРл => ЁЯРл, рджреЛрди рдХреБрдмрдб рдЕрд╕рд▓реЗрд▓рд╛ рдЙрдВрдЯ, рдХреБрдмрдб, рдЙрдВрдЯ, рдХреБрдХрдж рдЙрдВрдЯ, рдкреНрд░рд╛рдгреА
ЁЯРШ => ЁЯРШ, рдкреНрд░рд╛рдгреА
ЁЯРн => ЁЯРн, рдореВрд╖рдХрд╛рдЪрд╛ рдЪреЗрд╣рд░рд╛, рдореВрд╖рдХ, рдЪреЗрд╣рд░рд╛, рдкреНрд░рд╛рдгреА
ЁЯРБ => ЁЯРБ, рдореВрд╖рдХ, рдкреНрд░рд╛рдгреА
ЁЯРА => ЁЯРА, рдЙрдВрджреАрд░, рдкреНрд░рд╛рдгреА
ЁЯР╣ => ЁЯР╣, рдШреБрд╢реАрдЪрд╛ рдЪреЗрд╣рд░рд╛, рдШреБрд╕, рдЪреЗрд╣рд░рд╛, рдкреНрд░рд╛рдгреА
ЁЯР░ => ЁЯР░, рд╕рд╢реНрдпрд╛рдЪрд╛ рдЪреЗрд╣рд░рд╛, рд╕рд╕рд╛, рдЪреЗрд╣рд░рд╛, рдкреНрд░рд╛рдгреА
ЁЯРЗ => ЁЯРЗ, рдмрдиреА, рдкреНрд░рд╛рдгреА
ЁЯР╗ => ЁЯР╗, рдЕрд╕реНрд╡рд▓, рдЪреЗрд╣рд░рд╛, рдкреНрд░рд╛рдгреА
ЁЯРи => ЁЯРи, рдХреЛрдЖрд▓рд╛ рдЕрд╕реНрд╡рд▓, рдкреНрд░рд╛рдгреА
ЁЯР╝ => ЁЯР╝, рдкрд╛рдВрдбрд╛, рдЪреЗрд╣рд░рд╛, рдкреНрд░рд╛рдгреА
ЁЯР╛ => ЁЯР╛, рдкрдВрдЬрд╛, рдкрдВрдЬреНрдпрд╛рдЪрд╛ рдард╕рд╛, рдард╕рд╛, рдкреНрд░рд╛рдгреА
ЁЯРФ => ЁЯРФ, рдЪрд┐рдХрди, рдкреНрд░рд╛рдгреА, рдХреЛрдВрдмрдбреА
ЁЯРУ => ЁЯРУ, рдкреНрд░рд╛рдгреА
ЁЯРг => ЁЯРг, рдЕрдВрдбреНрдпрд╛рддреВрди рдмрд╛рд╣реЗрд░ рдпреЗрдгрд╛рд░реЗ рдХреЛрдВрдмрдбреАрдЪреЗ рдкрд┐рд▓реНрд▓реВ, рдХреЛрдВрдмрдбреАрдЪреЗ рдкрд┐рд▓реНрд▓реВ, рдЕрдВрдбреЗ рдлреВрдЯрдгреЗ, рдмрд╛рд│, рдЪрд┐рдХрди, рдкреНрд░рд╛рдгреА
ЁЯРд => ЁЯРд, рдХреЛрдВрдмрдбреАрдЪреЗ рдкрд┐рд▓реНрд▓реВ, рдмрд╛рд│, рдЪрд┐рдХрди, рдкреНрд░рд╛рдгреА
ЁЯРе => ЁЯРе, рдХреЛрдВрдмрдбреАрдЪреЗ рдкрд┐рд▓реНрд▓реВ, рд╕рдореЛрд░ рддреЛрдВрдб рдЕрд╕рд▓реЗрд▓реЗ рдХреЛрдВрдмрдбреАрдЪреЗ рдкрд┐рд▓реНрд▓реВ, рдмрд╛рд│, рдЪрд┐рдХрди, рдкреНрд░рд╛рдгреА
ЁЯРж => ЁЯРж, рдкреНрд░рд╛рдгреА
ЁЯРз => ЁЯРз, рдкрд╢реВ
ЁЯХК => ЁЯХК, рдкрдХреНрд╖реА, рдЙрдбрдгреЗ, рд╢рд╛рдВрддреА
ЁЯР╕ => ЁЯР╕, рдмреЗрдбреВрдХ, рдЪреЗрд╣рд░рд╛, рдкреНрд░рд╛рдгреА
ЁЯРК => ЁЯРК, рдкреНрд░рд╛рдгреА
ЁЯРв => ЁЯРв, рдкреНрд░рд╛рдгреА
ЁЯРН => ЁЯРН, рдкреНрд░рд╛рдгреА
ЁЯР▓ => ЁЯР▓, рджреИрддреНрдпрд╛рдХрд╛рд░ рд╕рд╛рдкрд╛рдЪрд╛ рдЪреЗрд╣рд░рд╛, рджреИрддреНрдп, рдЪреЗрд╣рд░рд╛, рдкреНрд░рд╛рдгреА, рдбреНрд░реЕрдЧрди
ЁЯРЙ => ЁЯРЙ, рдкреНрд░рд╛рдгреА
ЁЯР│ => ЁЯР│, рдлрд╡реНрд╡рд╛рд░рд╛ рдЙрдбрд╡рдгрд╛рд░реА рд╡реНрд╣реЗрд▓, рдлрд╡реНрд╡рд╛рд░рд╛ рдЙрдбрд╡рдгрд╛рд░реА, рд╡реНрд╣реЗрд▓, рдкреНрд░рд╛рдгреА, рджреЗрд╡рдорд╛рд╕рд╛
ЁЯРЛ => ЁЯРЛ, рдкрд╢реВ, рджреЗрд╡рдорд╛рд╕рд╛
ЁЯРм => ЁЯРм, рдкреНрд░рд╛рдгреА
ЁЯРЯ => ЁЯРЯ, рдкреНрд░рд╛рдгреА, рдорд╛рд╕рд│реА
ЁЯРа => ЁЯРа, рдЙрд╖реНрдгрджреЗрд╢реАрдп рдорд╛рд╕рд╛, рдорд╛рд╕рд╛, рдкреНрд░рд╛рдгреА
ЁЯРб => ЁЯРб, рдлреБрдЧрд▓реЗрд▓рд╛ рдорд╛рд╕рд╛, рдорд╛рд╕рд╛, рдкреНрд░рд╛рдгреА
ЁЯРЩ => ЁЯРЩ, рдкреНрд░рд╛рдгреА
ЁЯРЪ => ЁЯРЪ, рд╢рд┐рдВрдкрд▓рд╛, рдЧреЛрд▓ рд╢рд┐рдВрдкрд▓рд╛, рдкреНрд░рд╛рдгреА
ЁЯжА => ЁЯжА, рдХрд░реНрдХ, рд░рд╛рд╢реАрдЪрдХреНрд░
ЁЯРЫ => ЁЯРЫ, рдХрд┐рдбрд╛, рдЧреЛрдо, рдкреНрд░рд╛рдгреА
ЁЯРЬ => ЁЯРЬ, рдкреНрд░рд╛рдгреА
ЁЯРЭ => ЁЯРЭ, рдордзрдорд╛рд╢реНрдпрд╛, рдорд╛рд╢реА, рдкреНрд░рд╛рдгреА
ЁЯРЮ => ЁЯРЮ, рд▓реЗрдбреА рднреБрдВрдЧрд╛, рд▓реЗрдбреАрдмрдЧ, рдХрд┐рдбрд╛, рдкреНрд░рд╛рдгреА
ЁЯХ╖ => ЁЯХ╖, рдХрд┐рдбрд╛
ЁЯХ╕ => ЁЯХ╕, рдХреЛрд│реА, рдЬрд╛рд│реЗ
ЁЯжВ => ЁЯжВ, рд╡реГрд╢реНрдЪрд┐рдХ, рд░рд╛рд╢реАрдЪрдХреНрд░
ЁЯТР => ЁЯТР, рдлреВрд▓, рдкреНрд░рдгрдп
ЁЯМ╕ => ЁЯМ╕, рдЪреЗрд░реА рдлреБрд▓рдгреЗ, рдЪреЗрд░реА, рдлреВрд▓ рдкрд╛рд╣рдгреЗ, рдлреВрд▓
ЁЯТо => ЁЯТо, рдлреВрд▓рд╛рдЪрд╛ рд╕реНрдЯреЕрдореНрдк, рдЪрд╛рдВрдЧрд▓реЗ рдХреЗрд▓реЗ рд╕реНрдЯреЕрдореНрдк, рдлреВрд▓, рд╕реНрдЯреЕрдореНрдк
ЁЯП╡ => ЁЯП╡, рд╡рдирд╕реНрдкрддреА
ЁЯМ╣ => ЁЯМ╣, рдлреВрд▓
ЁЯМ║ => ЁЯМ║, рдлреВрд▓
ЁЯМ╗ => ЁЯМ╗, рдлреВрд▓
ЁЯМ╝ => ЁЯМ╝, рдлреБрд▓рдгреЗ, рдлреВрд▓
ЁЯМ╖ => ЁЯМ╖, рдЯреНрдпреВрд▓рд┐рдк, рдлреВрд▓
ЁЯМ▒ => ЁЯМ▒, рдЕрдВрдХреБрд░, рдХреЛрдВрдм, рддрд░реБрдг рд░реЛрдкрдЯреЗ, рддрд░реБрдг, рдЕрдВрдХреБрд░рдгреЗ
ЁЯМ▓ => ЁЯМ▓, рд╕рджрд╛рд╣рд░рд┐рдд рд╡реГрдХреНрд╖, рд╡реГрдХреНрд╖
ЁЯМ│ => ЁЯМ│, рдЫрд╛рдпрд╛рджрд╛рд░, рдкрд░реНрдгрдкрд╛рддреА, рд╡реГрдХреНрд╖
ЁЯМ┤ => ЁЯМ┤, рдкрд╛рдо рд╡реГрдХреНрд╖, рдкрд╛рдо, рд╡реГрдХреНрд╖
ЁЯМ╡ => ЁЯМ╡, рд░реЛрдкрдЯреЗ, рдХреЕрдХреНрдЯрд╕
ЁЯМ╛ => ЁЯМ╛, рднрд╛рддрд╛рдЪреЗ рд░реЛрдк, рддрд╛рдВрджрд│рд╛рдЪреЗ рдХрдгреАрд╕, рддрд╛рдВрджреВрд│, рдХрдгреАрд╕
ЁЯМ┐ => ЁЯМ┐, рдФрд╖рдзреА рд╡рдирд╕реНрдкрддреА, рдкрд╛рдиреЗ
тШШ => тШШ, рд╡рдирд╕реНрдкрддреА
ЁЯНА => ЁЯНА, рдЪрд╛рд░ рдкрд╛рди рдЕрд╕рд▓реЗрд▓реА рджреБрд░реНрд╡рд╛, рдЪрд╛рд░, рдкрд╛рди, рджреБрд░реНрд╡рд╛, рднрд╛рдЧреНрдпрд╡рд╛рди
ЁЯНБ => ЁЯНБ, рдореЕрдкрд▓ рдкрд╛рди, рдЧрд│рд╛рд▓реЗрд▓реЗ рдкрд╛рди, рдкрд╛рди
ЁЯНВ => ЁЯНВ, рдЧрд│рдгрд╛рд░реА рдкрд╛рдиреЗ, рдЧрд│рд╛рд▓реЗрд▓реА рдкрд╛рдиреЗ, рдЧрд│рдгрд╛рд░реА, рдЧрд│рд╛рд▓реЗрд▓реА, рдкрд╛рди, рдкрд╛рдиреЗ
ЁЯНГ => ЁЯНГ, рд╡рд╛рд▒реНрдпрд╛рд╡рд░ рдЙрдбрдгрд╛рд░реЗ рдкрд╛рди, рд╡рд╛рд╣рдгрд╛рд░рд╛ рд╡рд╛рд░рд╛, рдкрд╛рди, рд╡рд╛рд░рд╛, рд╡рд╛рд╣рдгреЗ
ЁЯНЗ => ЁЯНЗ, рдлрд│
ЁЯНИ => ЁЯНИ, рдлрд│
ЁЯНЙ => ЁЯНЙ, рдЯрд░рдмреВрдЬ, рдлрд│, рдЯрд░рдмреБрдЬрд╛рдЪреА рдлреЛрдб
ЁЯНК => ЁЯНК, рд╕рдВрддреНрд░рд╛, рдлрд│
ЁЯНЛ => ЁЯНЛ, рд▓рд┐рдВрдмреВрд╡рд░реНрдЧреАрдп рдлрд│
ЁЯНМ => ЁЯНМ, рдХреЗрд│реА, рдлрд│
ЁЯНН => ЁЯНН, рдлрд│
ЁЯНО => ЁЯНО, рд╕рдлрд░рдЪрдВрдж, рд▓рд╛рд▓, рдлрд│, рдЕреЕрдкрд▓, рд╕реЗрдм
ЁЯНП => ЁЯНП, рд╕рдлрд░рдЪрдВрдж, рд╣рд┐рд░рд╡реЗ, рдлрд│, рдЕреЕрдкрд▓, рд╕реЗрдм
ЁЯНР => ЁЯНР, рдлрд│
ЁЯНС => ЁЯНС, рдлрд│, рдкреАрдЪ
ЁЯНТ => ЁЯНТ, рдлрд│
ЁЯНУ => ЁЯНУ, рдмреЗрд░реА, рдлрд│
ЁЯНЕ => ЁЯНЕ, рдЯреЛрдореЕрдЯреЛ, рднрд╛рдЬреАрдкрд╛рд▓рд╛
ЁЯНЖ => ЁЯНЖ, рд╡рд╛рдВрдЧреЗ, рднрд╛рдЬреАрдкрд╛рд▓рд╛
ЁЯМ╜ => ЁЯМ╜, рдордХреНрдХрд╛, рдордХреНрдХреНрдпрд╛рдЪреЗ рдХрдгреАрд╕, рдордХрд╛
ЁЯМ╢ => ЁЯМ╢, рдЧрд░рдо, рдорд┐рд░реА, рд╡рдирд╕реНрдкрддреА
ЁЯНД => ЁЯНД, рдорд╢рд░реВрдо, рдЕрд│рдВрдмреА
ЁЯМ░ => ЁЯМ░, рддрд╛рдВрдмреВрд╕ рдкрд┐рдВрдЧрдЯ
ЁЯНЮ => ЁЯНЮ, рдмреНрд░реЗрдбрдЪрд╛ рддреБрдХрдбрд╛, рд░реЗрд╕реНрдЯреЙрд░рдВрдЯ
ЁЯзА => ЁЯзА, рдЪреАрдЬ
ЁЯНЦ => ЁЯНЦ, рдордЯрдг, рд╣рдбреНрдбреА рдЕрд╕рд▓реЗрд▓реЗ рдорд╛рдВрд╕, рд░реЗрд╕реНрдЯреЙрд░рдВрдЯ
ЁЯНЧ => ЁЯНЧ, рдЪрд┐рдХрди рд▓реЗрдЧ, рдХреБрдХреНрдХреБрдЯрдкрд╛рд▓рди, рддрдВрдЧрдбреА, рд░реЗрд╕реНрдЯреЙрд░рдВрдЯ
ЁЯНФ => ЁЯНФ, рд╣реЕрдореНрдмрд░реНрдЧрд░, рдмрд░реНрдЧрд░, рд░реЗрд╕реНрдЯреЙрд░рдВрдЯ
ЁЯНЯ => ЁЯНЯ, рдлреНрд░рд╛рдЗрдЬ, рдлреНрд░реЗрдВрдЪ рдлреНрд░рд╛рдЗрдЬ, рд░реЗрд╕реНрдЯреЙрд░рдВрдЯ
ЁЯНХ => ЁЯНХ, рдкрд┐рдЭреНрдЭрд╛ рд╕реНрд▓рд╛рдЗрд╕, рд╕реНрд▓рд╛рдЗрд╕, рд░реЗрд╕реНрдЯреЙрд░рдВрдЯ
ЁЯМн => ЁЯМн, рдлреНрд░рдБрдХрдлрд░реНрдЯрд░, рд╕реЙрд╕
ЁЯМо => ЁЯМо, рдореЗрдХреНрд╕рд┐рдХрди
ЁЯМп => ЁЯМп, рдореЗрдХреНрд╕рд┐рдХрди
ЁЯН▓ => ЁЯН▓, рд╢рд┐рдЬрдгреЗ, рднреЛрдЬрди рдкрд╛рддреНрд░, рд░реЗрд╕реНрдЯреЙрд░рдВрдЯ, рд╕реНрдЯреНрдпреВ
ЁЯН▒ => ЁЯН▒, рдмреЗрдВрдЯреЛ, рдмреЙрдХреНрд╕, рд░реЗрд╕реНрдЯреЙрд░рдВрдЯ
ЁЯНШ => ЁЯНШ, рднрд╛рдд
ЁЯНЩ => ЁЯНЩ, рдУрдирд┐рдЧрд┐рд░реА, рддрд╛рдВрджреВрд│, рд░реЗрд╕реНрдЯреЙрд░рдВрдЯ
ЁЯНЪ => ЁЯНЪ, рднрд╛рдд, рд░реЗрд╕реНрдЯреЙрд░рдВрдЯ
ЁЯНЫ => ЁЯНЫ, рдЖрдордЯреА рдЖрдгрд┐ рднрд╛рдд, рдЖрдордЯреА, рднрд╛рдд, рд░реЗрд╕реНрдЯреЙрд░рдВрдЯ
ЁЯНЬ => ЁЯНЬ, рд░реЕрдореЗрди, рдиреВрдбрд▓реНрд╕рдЪреА рдХрдЯреЛрд░реА, рдиреВрдбрд▓, рд╡рд╛рдлрд╛рд│рдгрд╛рд░реЗ, рдХрдЯреЛрд░реА, рдиреВрдбрд▓реНрд╕, рд░реЗрд╕реНрдЯреЙрд░рдВрдЯ
ЁЯНЭ => ЁЯНЭ, рдкрд╛рд╕реНрддрд╛, рд░реЗрд╕реНрдЯреЙрд░рдВрдЯ
ЁЯНа => ЁЯНа, рднрд╛рдЬрд▓реЗрд▓реЗ рдмрдЯрд╛рдЯреЗ, рд░рддрд╛рд│реЗ, рдЧреЛрдб, рднрд╛рдЬрд▓реЗрд▓реЗ, рд░реЗрд╕реНрдЯреЙрд░рдВрдЯ
ЁЯНв => ЁЯНв, рд╕реАрдлреВрдб рд╕реНрдЯрд┐рдХ, рд╕рдореБрджреНрд░реА рднреЛрдЬрди, рд╕реНрдЯрд┐рдХ, рд░реЗрд╕реНрдЯреЙрд░рдВрдЯ
ЁЯНг => ЁЯНг, рд░реЗрд╕реНрдЯреЙрд░рдВрдЯ
ЁЯНд => ЁЯНд, рддрд│рд▓реЗрд▓рд╛ рдХреЛрд│рдВрдмреА рдорд╛рд╕рд╛, рдХреЛрд│рдВрдмреА, рдорд╛рд╕рд╛, рд░реЗрд╕реНрдЯреЙрд░рдВрдЯ
ЁЯНе => ЁЯНе, рдлрд┐рд╢ рдХреЗрдХ, рд╡реЗрд╖реНрдЯрдг рдЕрд╕рд▓реЗрд▓рд╛ рдлрд┐рд╢ рдХреЗрдХ, рдорд╛рд╕, рд░реЗрд╕реНрдЯреЙрд░рдВрдЯ
ЁЯНб => ЁЯНб, рдореЛрдЪреА, рдореЛрдЪреА рдмреЙрд▓, рдореЛрдЪреА рдмреЙрд▓ рд╕реНрдЯрд┐рдХ, рд░реЗрд╕реНрдЯреЙрд░рдВрдЯ
ЁЯНж => ЁЯНж, рдореБрд▓рд╛рдпрдо рдЖрдЗрд╕реНрдХреНрд░реАрдо, рдЖрдЗрд╕реНрдХреНрд░реАрдо, рд╕реЙрдлреНрдЯ рд╕рд░реНрд╡реНрд╣, рдорд▓рдИ, рд░реЗрд╕реНрдЯреЙрд░рдВрдЯ
ЁЯНз => ЁЯНз, рдХрд┐рд╕рд▓реЗрд▓рд╛ рдмрд░реНрдл, рдмрд░реНрдл, рдХрд┐рд╕рд▓реЗрд▓рд╛, рд░реЗрд╕реНрдЯреЙрд░рдВрдЯ
ЁЯНи => ЁЯНи, рдЖрдЗрд╕реНрдХреНрд░реАрдо, рдмрд░реНрдл, рдорд▓рдИ, рд░реЗрд╕реНрдЯреЙрд░рдВрдЯ
ЁЯНй => ЁЯНй, рд░реЗрд╕реНрдЯреЙрд░рдВрдЯ
ЁЯНк => ЁЯНк, рд░реЗрд╕реНрдЯреЙрд░рдВрдЯ
ЁЯОВ => ЁЯОВ, рд╡рд╛рдврджрд┐рд╡рд╕ рдХреЗрдХ, рд╡рд╛рдврджрд┐рд╡рд╕, рдХреЗрдХ, рдЙрддреНрд╕рд╡
ЁЯН░ => ЁЯН░, рд╢реЙрд░реНрдЯрдХреЗрдХ, рд╕реНрд▓рд╛рдЗрд╕ рдХреЗрд▓реЗрд▓рд╛ тАЛтАЛрдХреЗрдХ, рдХреЗрдХ, рд░реЗрд╕реНрдЯреЙрд░рдВрдЯ
ЁЯНл => ЁЯНл, рдЪреЙрдХрд▓реЗрдЯ, рдмрд╛рд░
ЁЯНм => ЁЯНм, рдЪреЙрдХрд▓реЗрдЯ
ЁЯНн => ЁЯНн, рд▓реЙрд▓рд┐рдкреЙрдк, рдХрдБрдбреА, рдЪреЙрдХрд▓реЗрдЯ
ЁЯНо => ЁЯНо, рдкреБрдбрд┐рдВрдЧ, рд░реЗрд╕реНрдЯреЙрд░рдВрдЯ
ЁЯНп => ЁЯНп, рдордз, рднрд╛рдВрдбреЗ, рд░реЗрд╕реНрдЯреЙрд░рдВрдЯ
ЁЯН╝ => ЁЯН╝, рдмрд╛рд│рд╛рдЪреА рдмрд╛рдЯрд▓реА, рджреВрдз, рдмрд╛рдЯрд▓реА, рдкреЗрдп
тШХ => тШХ, рдкреЗрдп, рдХреЙрдлреА, рдкрд┐рдгреЗ, рдЧрд░рдо, рд╡рд╛рдлрд╛рд│рд▓реЗрд▓рд╛, рдЪрд╣рд╛
ЁЯН╡ => ЁЯН╡, рдЪрд╣рд╛рдЪрд╛ рдХрдк, рдЪрд╣рд╛, рдкреЗрдп
ЁЯН╢ => ЁЯН╢, рд╕реЗрдХ рдмрд╛рдЯрд▓реА рдЖрдгрд┐ рдХрдк, рдХрдк, рдмрд╛рдЯрд▓реА, рдкреЗрдп, рд░реЗрд╕реНрдЯреЙрд░рдВрдЯ, рдмрд╛рд░, рдЬрдкрд╛рдиреА рджрд╛рд░реВ
ЁЯН╛ => ЁЯН╛, рдмрд╛рд░, рдмреЙрдЯрд▓, рдХреЙрд░реНрдХ, рдкреЗрдп, рдкреЙрдкрд┐рдВрдЧ
ЁЯН╖ => ЁЯН╖, рд╡рд╛рдЗрди, рд╡рд╛рдЗрдирдЪрд╛ рдЧреНрд▓рд╛рд╕, рдЧреНрд▓рд╛рд╕, рдкреЗрдп, рд░реЗрд╕реНрдЯреЙрд░рдВрдЯ, рдмрд╛рд░
ЁЯН╕ => ЁЯН╕, рдХреЙрдХрдЯреЗрд▓, рдХреЙрдХрдЯреЗрд▓рдЪрд╛ рдЧреНрд▓рд╛рд╕, рд░реЗрд╕реНрдЯреЙрд░рдВрдЯ, рдмрд╛рд░
ЁЯН╣ => ЁЯН╣, рдЯреНрд░реЙрдкрд┐рдХрд▓, рдкреЗрдп, рд░реЗрд╕реНрдЯреЙрд░рдВрдЯ, рдмрд╛рд░
ЁЯН║ => ЁЯН║, рдмрд┐рдЕрд░, рдмрд┐рдЕрд░ рдордЧ, рдордЧ, рд░реЗрд╕реНрдЯреЙрд░рдВрдЯ, рдмрд╛рд░
ЁЯН╗ => ЁЯН╗, рдмрд┐рдЕрд░, рдордЧреНрдЬ, рдордЧ, рд░реЗрд╕реНрдЯреЙрд░рдВрдЯ, рдмрд╛рд░
ЁЯН╜ => ЁЯН╜, рд╕реНрд╡рдпрдВрдкрд╛рдХ рдХрд░рдгреЗ, рдХрд╛рдЯрд╛, рд╕реБрд░реА, рддрд╛рдЯрд▓реА
ЁЯН┤ => ЁЯН┤, рдХрд╛рдЯрд╛ рдЖрдгрд┐ рдЪрд╛рдХреВ, рдХрд╛рдЯрд╛, рдЪрд╛рдХреВ, рд░реЗрд╕реНрдЯреЙрд░рдВрдЯ
ЁЯН│ => ЁЯН│, рдлреНрд░рд╛рдЗрдВрдЧ рдкреЕрди, рдХреБрдХреАрдВрдЧ, рд░реЗрд╕реНрдЯреЙрд░рдВрдЯ, рдХрдврдИ, рддрд╡рд╛
ЁЯП║ => ЁЯП║, рдореЗрд╖, рд╕реНрд╡рдпрдВрдкрд╛рдХ рдХрд░рдгреЗ, рдкреЗрдп, рдЬрдЧ, рд╕рд╛рдзрди, рд╣рддреНрдпрд╛рд░, рд░рд╛рд╢реАрдЪрдХреНрд░
ЁЯМН => ЁЯМН, рдЬрдЧ, рдкреГрдереНрд╡реА, рдпреБрд░реЛрдк, рдЖрдлреНрд░рд┐рдХрд╛
ЁЯМО => ЁЯМО, рдЬрдЧ, рдкреГрдереНрд╡реА, рдЕрдореЗрд░рд┐рдХрд╛
ЁЯМП => ЁЯМП, рдЬрдЧ, рдкреГрдереНрд╡реА, рдЖрд╢рд┐рдпрд╛, рдСрд╕реНрдЯреНрд░реЗрд▓рд┐рдпрд╛
ЁЯМР => ЁЯМР, рдЬрдЧ, рд╡рд┐рд╢реНрд╡ рд░реЗрдЦрд╛, рдЕрдХреНрд╖рд╛рдВрд╢-рд░реЗрдЦрд╛рдВрд╢, рдкреГрдереНрд╡реАрдЧреЛрд▓
ЁЯЧ║ => ЁЯЧ║, рдирдХрд╛рд╢рд╛, рд╡рд┐рд╢реНрд╡
ЁЯПФ => ЁЯПФ, рдердВрдб, рдкрд░реНрд╡рдд, рд╣рд┐рдо
ЁЯМЛ => ЁЯМЛ, рдЬреНрд╡рд╛рд▓рд╛рдореБрдЦреАрдЪрд╛ рдЙрджреНрд░реЗрдХ
ЁЯЧ╗ => ЁЯЧ╗, рдорд╛рдЙрдВрдЯ рдлреБрдЬреА, рдорд╛рдЙрдВрдЯрди
ЁЯПЦ => ЁЯПЦ, рд╕рдореБрджреНрд░рдХрд┐рдирд╛рд░рд╛, рдЫрддреНрд░реА
ЁЯПЭ => ЁЯПЭ, рд╡рд╛рд│рд╡рдВрдЯ, рдмреЗрдЯ
ЁЯПЮ => ЁЯПЮ, рдЙрджреНрдпрд╛рди
ЁЯПЫ => ЁЯПЫ, рдЗрдорд╛рд░рдд, рдХрд▓рд╛рдХреГрддреА рдЕрд╕рд▓реЗрд▓реЗ
ЁЯПЧ => ЁЯПЧ, рдЗрдорд╛рд░рдд, рдмрд╛рдВрдзрдХрд╛рдо
ЁЯПШ => ЁЯПШ, рдЗрдорд╛рд░рдд, рдШрд░
ЁЯПЩ => ЁЯПЩ, рдЗрдорд╛рд░рдд, рд╢рд╣рд░
ЁЯПЪ => ЁЯПЪ, рдЗрдорд╛рд░рдд, рд╕реЛрдбрд▓реЗрд▓реЗ рдШрд░, рдШрд░
ЁЯПа => ЁЯПа, рдШрд░, рдЗрдорд╛рд░рдд
ЁЯПб => ЁЯПб, рдШрд░, рдмрд╛рдЧ рдЕрд╕рд▓реЗрд▓реЗ рдШрд░, рдмрд╛рдЧ, рдЗрдорд╛рд░рдд
тЫк => тЫк, рдЗрдорд╛рд░рдд
ЁЯХЛ => ЁЯХЛ, рдЗрд╕реНрд▓рд╛рдо, рдореБрд╕реНрд▓рд┐рдо, рдзрд░реНрдо
ЁЯХМ => ЁЯХМ, рдЗрд╕реНрд▓рд╛рдо, рдореБрд╕реНрд▓рд┐рдо, рдзрд░реНрдо
ЁЯХН => ЁЯХН, рдЬреНрдпреВ, рдЬреНрдпреВрдЗрд╢, рдзрд░реНрдо, рджреЗрдКрд│
тЫй => тЫй, рдзрд░реНрдо, рд╢рд┐рдиреНрддреЛ, рддреАрд░реНрдерд╕реНрдерд╛рди
ЁЯПв => ЁЯПв, рдХрд╛рд░реНрдпрд╛рд▓рдп рдЗрдорд╛рд░рдд, рдХрд╛рд░реНрдпрд╛рд▓рдп, рдЗрдорд╛рд░рдд
ЁЯПг => ЁЯПг, рдкреЛрд╕реНрдЯ рдСрдлрд┐рд╕, рдЬрдкрд╛рдиреА, рдкреЛрд╕реНрдЯ, рдЗрдорд╛рд░рдд
ЁЯПд => ЁЯПд, рдпреБрд░реЛрдкрд┐рдпрди рдкреЛрд╕реНрдЯ рдСрдлрд┐рд╕, рдпреБрд░реЛрдкрд┐рдпрди, рдкреЛрд╕реНрдЯ, рдЗрдорд╛рд░рдд
ЁЯПе => ЁЯПе, рд╣реЙрд╕реНрдкрд┐рдЯрд▓, рдЗрдорд╛рд░рдд
ЁЯПж => ЁЯПж, рдЗрдорд╛рд░рдд
ЁЯПи => ЁЯПи, рдЗрдорд╛рд░рдд
ЁЯПй => ЁЯПй, рд╣реЙрдЯреЗрд▓, рдкреНрд░реЗрдо, рдкреНрд░рдгрдп рд╣реЙрдЯреЗрд▓, рдЗрдорд╛рд░рдд рдкреНрд░реЗрдо
ЁЯПк => ЁЯПк, рд╕реБрд╡рд┐рдзрд╛ рд╕реНрдЯреЛрдЕрд░, рд╕реБрд╡рд┐рдзрд╛, рд╕реНрдЯреЛрдЕрд░, рдЗрдорд╛рд░рдд
ЁЯПл => ЁЯПл, рд╢рд╛рд│реЗрдЪреА рдЗрдорд╛рд░рдд, рдЗрдорд╛рд░рдд
ЁЯПм => ЁЯПм, рд╡рд┐рднрд╛рдЧ рд╕реНрдЯреЛрдЕрд░, рд╡рд┐рднрд╛рдЧ, рд╕реНрдЯреЛрдЕрд░
ЁЯПн => ЁЯПн, рдЗрдорд╛рд░рдд
ЁЯПп => ЁЯПп, рдЬрдкрд╛рдиреА рдХрд┐рд▓реНрд▓рд╛, рдХрд┐рд▓реНрд▓рд╛, рдЗрдорд╛рд░рдд
ЁЯП░ => ЁЯП░, рдпреБрд░реЛрдкрд┐рдпрди рдХрд┐рд▓реНрд▓рд╛, рдХрд┐рд▓реНрд▓рд╛, рдЗрдорд╛рд░рдд
ЁЯТТ => ЁЯТТ, рд╡рд┐рд╡рд╛рд╣рд╛рдЪреЗ рдзрд╛рд░реНрдорд┐рдХ рд╕реНрдерд│, рд▓рдЧреНрди, рдзрд╛рд░реНрдорд┐рдХ рд╕реНрдерд│, рдкреНрд░рдгрдп
ЁЯЧ╝ => ЁЯЧ╝, рдЯреЛрдХрд┐рдпреЛ рдЯреЙрд╡рд░
ЁЯЧ╜ => ЁЯЧ╜, рд╕реНрдЯреЕрдЪреНрдпреВ рдСрдл рд▓рд┐рдмрд░реНрдЯреА, рдкреБрддрд│рд╛, рд╕реНрд╡рд╛рддрдВрддреНрд░реНрдпрджреЗрд╡рддреЗрдЪрд╛ рдкреБрддрд│рд╛, рд╕реНрд╡рд╛рддрдВрддреНрд░реНрдп
ЁЯЧ╛ => ЁЯЧ╛, рдирдХрд╛рд╢рд╛, рдЬрдкрд╛рди
тЫ▓ => тЫ▓, рдлрд╡рд╛рд░рд╛
тЫ║ => тЫ║, рдХреЕрдореНрдкрд┐рдВрдЧ
ЁЯМБ => ЁЯМБ, рдЕрдВрдзреБрдХ, рдзреБрдХреЗ
ЁЯМГ => ЁЯМГ, рд░рд╛рддреНрд░реАрдЪреЗ рддрд╛рд░реЗ, рддрд╛рд░реЗ, рд░рд╛рддреНрд░
ЁЯМД => ЁЯМД, рд╕реБрд░реНрдпреЛрджрдп, рд╕рдХрд╛рд│рдЪрд╛ рд╕реВрд░реНрдп, рдбреЛрдВрдЧрд░рд╛рд╡рд░реАрд▓ рд╕реБрд░реНрдпреЛрджрдп, рдбреЛрдВрдЧрд░
ЁЯМЕ => ЁЯМЕ, рд╕реБрд░реНрдпреЛрджрдп, рд╕рдХрд╛рд│рдЪрд╛ рд╕реВрд░реНрдп
ЁЯМЖ => ЁЯМЖ, рддреАрдиреНрд╣реАрд╕рд╛рдВрдЬреЗрдЪреЗ рд╢рд╣рд░, рддреАрдиреНрд╣реАрд╕рд╛рдВрдЬрд╛, рд╕рдВрдзреНрдпрд╛рдХрд╛рд│, рд╕реБрд░реНрдпрд╛рд╕реНрдд, рд╢рд╣рд░, рдЗрдорд╛рд░рдд, рднреВрджреГрд╢реНрдп
ЁЯМЗ => ЁЯМЗ, рд╕реБрд░реНрдпрд╛рд╕реНрдд, рддреАрдиреНрд╣реАрд╕рд╛рдВрдЬрд╛, рдЗрдорд╛рд░рддреАрдВрд╡рд░реАрд▓ рд╕реБрд░реНрдпрд╛рд╕реНрдд, рдЗрдорд╛рд░рдд
ЁЯМЙ => ЁЯМЙ, рд░рд╛рддреНрд░реАрдЪрд╛ рдкреВрд▓, рдкреВрд▓, рд░рд╛рддреНрд░
тЩи => тЩи, рдЧрд░рдо, рдЧрд░рдо рдкрд╛рдгреНрдпрд╛рдЪрд╛ рдЭрд░рд╛, рдЭрд░реЗ, рд╡рд╛рдлрд╛ рдпреЗрдгрд╛рд░рд╛
ЁЯММ => ЁЯММ, рд╣рд╡рд╛рдорд╛рди
ЁЯОа => ЁЯОа, рдЭреБрд▓рд╛, рдЭреБрд▓рд╛ рдЕрд╕рд▓реЗрд▓рд╛ рдШреЛрдбрд╛, рдШреЛрдбрд╛, рдордиреЛрд░рдВрдЬрди, рдЬрддреНрд░рд╛
ЁЯОб => ЁЯОб, рдЖрдХрд╛рд╢рдкрд╛рд│рдгрд╛, рдЙрдВрдЪ рдЖрдХрд╛рд╢, рдкрд╛рд│рдгрд╛, рдХрд░рдордгреВрдХ рдкрд╛рд░реНрдХ, рдордиреЛрд░рдВрдЬрди, рдЬрддреНрд░рд╛
ЁЯОв => ЁЯОв, рд░реЛрд▓рд░, рдХреЛрд╕реНрдЯрд░, рдХрд░рдордгреВрдХ рдкрд╛рд░реНрдХ, рдордиреЛрд░рдВрдЬрди
ЁЯТИ => ЁЯТИ, рдиреНрд╣рд╛рд╡реНрдпрд╛рдЪреЗ рджреБрдХрд╛рди, рдиреНрд╣рд╛рд╡реНрдпрд╛рдЪреА рдХрд╛рдареА, рдиреНрд╣рд╛рд╡реА, рдХрд╛рдареА
ЁЯОк => ЁЯОк, рд╕рд░реНрдХрд╕, рд╕рд░реНрдХрд╕ рддрдВрдмреВ, рддрдВрдмреВ, рдордиреЛрд░рдВрдЬрди
ЁЯОн => ЁЯОн, рдЪреЗрд╣рд▒реНрдпрд╛рдЪрд╛ рдорд╛рд╕реНрдХ, рдкреНрд░рджрд░реНрд╢рди рдХрд▓рд╛, рдХрд▓рд╛, рдордиреЛрд░рдВрдЬрди, рдкреНрд░рджрд░реНрд╢рди
ЁЯЦ╝ => ЁЯЦ╝, рдХрд▓рд╛, рдлреНрд░реЗрдо, рд╕рдВрдЧреНрд░рд╣рд╛рд▓рдп, рд░рдВрдЧрд╡рд┐рдгреЗ, рдЪрд┐рддреНрд░
ЁЯОи => ЁЯОи, рд░рдВрдЧ рдкрдЯреНрдЯрд┐рдХрд╛, рдХрд▓рд╛рдХрд╛рд░ рдкреЕрд▓реЗрдЯ, рдкреЕрд▓реЗрдЯ, рдХрд▓рд╛рд╡рдВрдд, рдкреЗрдВрдЯ, рдХрд▓рд╛, рдЪрд┐рддреНрд░рдХрд▓рд╛
ЁЯО░ => ЁЯО░, рд╕реНрд▓реЙрдЯ, рдЧреЗрдо
ЁЯЪВ => ЁЯЪВ, рд╡рд╛рдлреЗрдЪреЗ рдЗрдВрдЬрд┐рди, рдЗрдВрдЬрд┐рди, рд░реЗрд▓реНрд╡реЗ, рд╡рд╛рд╣рди
ЁЯЪГ => ЁЯЪГ, рд░реЗрд▓реНрд╡реЗ, рд╡рд┐рджреНрдпреБрдд рд░реЗрд▓реНрд╡реЗ рдЧрд╛рдбреА, рд░реЗрд▓реНрд╡реЗрдЪрд╛ рдбрдмрд╛, рдЗрд▓реЗрдХреНрдЯреНрд░рд┐рдХ, рдЯреНрд░рд╛рдо, рд╡рд╛рд╣рди
ЁЯЪД => ЁЯЪД, рдЧрддрд┐рдорд╛рди рдЧрд╛рдбреА, рд╢рд┐рдВрдХрд╛рдиреНрд╕реЗрди, рд░реЗрд▓реНрд╡реЗ, рд╡рд╛рд╣рди, рд╣рд╛рдп-рд╕реНрдкреАрдб рдЯреНрд░реЗрди
ЁЯЪЕ => ЁЯЪЕ, рдЧрддрд┐рдорд╛рди рдЧрд╛рдбреА, рдмреБрд▓реЗрдЯ рдЯреНрд░реЗрди, рдмреБрд▓реЗрдЯрд╕рд╛рд░рдЦреНрдпрд╛ рдирд╛рдХрд╛рдЪреА рд╢рд┐рдВрдХрд╛рдиреНрд╕реЗрди, рд░реЗрд▓реНрд╡реЗ, рд╡рд╛рд╣рди, рд╢рд┐рдВрдХрд╛рдиреНрд╕реЗрди
ЁЯЪЖ => ЁЯЪЖ, рд░реЗрд▓реНрд╡реЗ, рдЖрдЧрдЧрд╛рдбреА, рд╡рд╛рд╣рди
ЁЯЪЗ => ЁЯЪЗ, рднреБрдпрд╛рд░реА рд░реЗрд▓реНрд╡реЗ, рд╡рд╛рд╣рди, рдЯреНрд░реЗрди
ЁЯЪИ => ЁЯЪИ, рдкреНрд░рдХрд╛рд╢ рд░реЗрд▓реНрд╡реЗ, рдкреНрд░рдХрд╛рд╢, рд░реЗрд▓реНрд╡реЗ, рд╡рд╛рд╣рди, рдЯреНрд░реЗрди
ЁЯЪЙ => ЁЯЪЙ, рд░реЗрд▓реНрд╡реЗ рд╕реНрдерд╛рдирдХ, рд░реЗрд▓реНрд╡реЗ, рдЯреНрд░реЗрди
ЁЯЪК => ЁЯЪК, рд╡рд╛рд╣рди
ЁЯЪЭ => ЁЯЪЭ, рд╡рд╛рд╣рди
ЁЯЪЮ => ЁЯЪЮ, рдбреЛрдВрдЧрд░рд╛рд╡рд░реАрд▓ рд░реЗрд▓реНрд╡реЗ, рдкрд░реНрд╡рддреАрдп рдХреЗрдмрд▓ рдХрд╛рд░, рдбреЛрдВрдЧрд░рд╛рд╡рд░реАрд▓, рд░реЗрд▓реНрд╡реЗ, рдХрд╛рд░, рд╡рд╛рд╣рди
ЁЯЪЛ => ЁЯЪЛ, рдЯреНрд░рд╛рдордЧрд╛рдбреА, рдЯреНрд░рд╛рдо, рдХрд╛рд░, рд╡рд╛рд╣рди
ЁЯЪМ => ЁЯЪМ, рд╡рд╛рд╣рди
ЁЯЪН => ЁЯЪН, рдпреЗрдд рдЕрд╕рд▓реЗрд▓реА рдмрд╕, рдмрд╕, рдпреЗрдд рдЕрд╕рд▓реЗрд▓реЗ, рд╡рд╛рд╣рди
ЁЯЪО => ЁЯЪО, рдмрд╕, рдЯреНрд░реЙрд▓реА, рд╡рд╛рд╣рди
ЁЯЪП => ЁЯЪП, рдмрд╕ рд╕реНрдЯреЙрдк, рд╕реНрдЯреЙрдк, рдмрд╕
ЁЯЪР => ЁЯЪР, рдмрд╕, рд╡рд╛рд╣рди
ЁЯЪС => ЁЯЪС, рд░реБрдЧреНрдгрд╡рд╛рд╣рд┐рдХрд╛, рд╡рд╛рд╣рди
ЁЯЪТ => ЁЯЪТ, рдЕрдЧреНрдирд┐рд╢рд╛рдордХ, рджрдордХрд▓, рдлрд╛рдпрд░, рдЗрдВрдЬрд┐рди, рд╡рд╛рд╣рди
ЁЯЪУ => ЁЯЪУ, рдкреЛрд▓рд┐рд╕рд╛рдВрдЪреА рдХрд╛рд░, рдЧрд╕реНрдд рдХрд░рдгрд╛рд░реА рдХрд╛рд░, рдкреЛрд▓рд┐рд╕, рд╡рд╛рд╣рди
ЁЯЪФ => ЁЯЪФ, рдпреЗрдд рдЕрд╕рд▓реЗрд▓реА рдкреЛрд▓рд┐рд╕рд╛рдВрдЪреА рдЧрд╛рдбреА, рдкреЛрд▓рд┐рд╕рд╛рдВрдЪреА рдЧрд╛рдбреА, рдкреЛрд▓рд┐рд╕, рд╡рд╛рд╣рди
ЁЯЪХ => ЁЯЪХ, рд╡рд╛рд╣рди
ЁЯЪЦ => ЁЯЪЦ, рдпреЗрдд рдЕрд╕рд▓реЗрд▓реА рдЯреЕрдХреНрд╕реА, рдЯреЕрдХреНрд╕реА, рд╡рд╛рд╣рди
ЁЯЪЧ => ЁЯЪЧ, рдХрд╛рд░, тАЛтАЛрдСрдЯреЛрдореЛрдмрд╛рдИрд▓, рд╡рд╛рд╣рди
ЁЯЪШ => ЁЯЪШ, рдпреЗрдд рдЕрд╕рд▓реЗрд▓реА рдХрд╛рд░, рдпреЗрдд рдЕрд╕рд▓реЗрд▓реЗ рд╡рд╛рд╣рди, рдХрд╛рд░, рд╡рд╛рд╣рдиреЗ, рдпреЗрдд рдЕрд╕рд▓реЗрд▓реА, рд╡рд╛рд╣рди
ЁЯЪЩ => ЁЯЪЩ, RV, рдордиреЛрд░рдВрдЬрдХ рд╡рд╛рд╣рди, рдХрд╛рд░, рд╡рд╛рд╣рди
ЁЯЪЪ => ЁЯЪЪ, рд╡рд┐рддрд░рдг рдЯреНрд░рдХ, рдЯреНрд░рдХ, рд╡рд╛рд╣рди
ЁЯЪЫ => ЁЯЪЫ, рд▓реЙрд░реА, рд╕реЗрдореА, рдЖрд░реНрдЯрд┐рдХреНрдпреВрд▓реЗрдЯреЗрдб рд▓реЙрд░реА, рдЯреНрд░рдХ, рдЯреНрд░реЗрд▓рд░, рд╡рд╛рд╣рди
ЁЯЪЬ => ЁЯЪЬ, рд╡рд╛рд╣рди
ЁЯЪ▓ => ЁЯЪ▓, рджреБрдЪрд╛рдХреА, рд╡рд╛рд╣рди
тЫ╜ => тЫ╜, рдкреЗрдЯреНрд░реЛрд▓ рдкрдВрдк, рдЧреЕрд╕ рд╕реНрдЯреЗрд╢рди, рдЗрдВрдзрди рдкрдВрдк, рдЗрдВрдзрди, рдЧреЕрд╕, рд╕реНрдЯреЗрд╢рди, рдкреЗрдЯреНрд░реЛрд▓, рдбрд┐рдЭреЗрд▓
ЁЯЫг => ЁЯЫг, рджреГрддрдорд╛рд░реНрдЧ, рд░рд╕реНрддрд╛
ЁЯЫд => ЁЯЫд, рдЯреНрд░реЗрди
ЁЯЪи => ЁЯЪи, рдлрд┐рд░рдгрд╛рд░рд╛ рдкреНрд░рдХрд╛рд╢, рдкреЛрд▓рд┐рд╕ рдкреНрд░рдХрд╛рд╢, рдкреЛрд▓рд┐рд╕ рджрд┐рд╡рд╛, рдкреЛрд▓рд┐рд╕рд╛рдВрдЪреА рдЧрд╛рдбреА
ЁЯЪе => ЁЯЪе, рд╡рд╛рд╣рддреВрдХ рджрд┐рд╡реЗ, рдЖрдбрд╡реЗ рд╡рд╛рд╣рддреВрдХ рджрд┐рд╡реЗ, рд╡рд╛рд╣рддреВрдХ рд╕рд┐рдЧреНрдирд▓, рджрд┐рд╡реЗ, рд╡рд╛рд╣рддреВрдХ
ЁЯЪж => ЁЯЪж, рд╡рд╛рд╣рддреВрдХ рджрд┐рд╡реЗ, рдЙрднреЗ рд╡рд╛рд╣рддреВрдХ рджрд┐рд╡реЗ, рд╡рд╛рд╣рддреВрдХ рд╕рд┐рдЧреНрдирд▓, рджрд┐рд╡реЗ, рд╡рд╛рд╣рддреВрдХ
ЁЯЪз => ЁЯЪз, рдмрд╛рдВрдзрдХрд╛рдо рдЪрд╛рд▓реВ рдЖрд╣реЗ, рдмрд╛рдВрдзрдХрд╛рдо рдЪрд┐рдиреНрд╣, рдЪрд┐рдиреНрд╣
тЪУ => тЪУ, рдЕрдБрдХрд░, рдЧрд│, рдЪрд┐рдиреНрд╣
тЫ╡ => тЫ╡, рд╕реЗрд▓рдмреЛрдЯ, рдмреЛрдЯ, рдиреМрдХрд╛, рд╕рдореБрджреНрд░реА рд░рд┐рд╕реЙрд░реНрдЯ, рд░рд┐рд╕реЙрд░реНрдЯ
ЁЯЪг => ЁЯЪг, рдордЪрд╡рд╛, рдмреЛрдЯ, рд╡рд╛рд╣рди
ЁЯЪд => ЁЯЪд, рдмреЛрдЯ, рд╡рд╛рд╣рди
ЁЯЫ│ => ЁЯЫ│, рдкреНрд░рд╡рд╛рд╕реА, рдЬрд╣рд╛рдЬ, рд╡рд╛рд╣рди
тЫ┤ => тЫ┤, рдирд╛рд╡
ЁЯЫе => ЁЯЫе, рдирд╛рд╡, рдореЛрдЯрд░рдмреЛрдЯ, рд╡рд╛рд╣рди
ЁЯЪв => ЁЯЪв, рд╡рд╛рд╣рди
тЬИ => тЬИ, рд╡рд╛рд╣рди
ЁЯЫй => ЁЯЫй, рд╡рд┐рдорд╛рди, рд╡рд╛рд╣рди
ЁЯЫл => ЁЯЫл, рд╡рд┐рдорд╛рди, рд╡рд╛рд╣рди, рдЪреЗрдХ рдЗрди рдХрд░рдгреЗ, рдирд┐рд░реНрдЧрдорди, рдирд┐рд░реНрдЧрдордиреЗ
ЁЯЫм => ЁЯЫм, рд╡рд┐рдорд╛рди, рдЖрдЧрдорди, рдЖрдЧрдорди рд╣реЛрдд рдЖрд╣реЗ, рдЙрддрд░рдд рдЖрд╣реЗ, рд╡рд╛рд╣рди
ЁЯТ║ => ЁЯТ║, рдЦреБрд░реНрдЪреА
ЁЯЪБ => ЁЯЪБ, рд╡рд╛рд╣рди
ЁЯЪЯ => ЁЯЪЯ, рд░реЗрд▓реНрд╡реЗ, рдЯрд╛рдВрдЧрд▓реЗрд▓реЗ, рд╡рд╛рд╣рди
ЁЯЪа => ЁЯЪа, рдбреЛрдВрдЧрд░рд╛рд╡рд░реАрд▓ рдХреЗрдмрд▓ рдХрд╛рд░, рдХреЗрдмрд▓, рдЧрд╛рдбреА, рдбреЛрдВрдЧрд░, рд╡рд╛рд╣рди
ЁЯЪб => ЁЯЪб, рдХреЗрдмрд▓ рдХрд╛рд░, рд╣рд╡рд╛рдИ рдЯреНрд░рд╛рдорд╡реЗ, рд░реЛрдкрд╡реЗ, рд╣рд╡рд╛рдИ, рдЯреНрд░рд╛рдорд╡реЗ, рдЧреЛрдВрдбреЛрд▓рд╛, рд╡рд╛рд╣рди
ЁЯЪА => ЁЯЪА, рд╡рд╛рд╣рди
ЁЯЫ░ => ЁЯЫ░, рдЕрдВрддрд░рд╛рд│, рд╡рд╛рд╣рди
ЁЯЫО => ЁЯЫО, рдШрдВрдЯрд╛, рд╣реЙрдЯреЗрд▓, рдмреЗрд▓
ЁЯЪк => ЁЯЪк, рджрд╛рд░
ЁЯЫМ => ЁЯЫМ, рд╣реЙрдЯреЗрд▓, рдЭреЛрдк
ЁЯЫП => ЁЯЫП, рд╣реЙрдЯреЗрд▓, рдЭреЛрдк
ЁЯЫЛ => ЁЯЫЛ, рдХрд╛рдКрдЪ, рд╣реЙрдЯреЗрд▓, рджрд┐рд╡рд╛
ЁЯЫА => ЁЯЫА, рдЖрдВрдШреЛрд│, рдмрд╛рде, рдЯрдмрдмрд╛рде
ЁЯЫБ => ЁЯЫБ, рдмрд╛рдердЯрдм
тМЫ => тМЫ, рд╡рд╛рд│реВ рдШрдбреНрдпрд╛рд│, рддрд╛рд╕рд╛рдЪреЗ рдШрдбреНрдпрд╛рд│, рд╡рд╛рд│реВ
тП│ => тП│, рд╡рд╛рд│реВрдЪрд╛ рдЯрд╛рдЗрдорд░, рд╡рд╛рд│реВрдЪрд╛ рддрд╛рд╕рд╛рдЪреЗ рдШрдбреНрдпрд╛рд│, рддрд╛рд╕рд╛рдЪреЗ рдШрдбреНрдпрд╛рд│, рдЯрд╛рдЗрдорд░
тП░ => тП░, рдЧрдЬрд░, рдШрдбреНрдпрд╛рд│, рдЕрд▓рд╛рд░реНрдо
тП▒ => тП▒, рдШрдбреНтАНрдпрд╛рд│
тП▓ => тП▓, рдШрдбреНтАНрдпрд╛рд│, рдЯрд╛рдпрдорд░
ЁЯХ░ => ЁЯХ░, рдШрдбреНтАНрдпрд╛рд│
ЁЯХЫ => ЁЯХЫ, 12 рд╡рд╛рдЬрд▓реЗ, рдШрдбреНрдпрд╛рд│, рдмрд╛рд░рд╛, 12:00
ЁЯХз => ЁЯХз, рд╕рд╛рдбреЗ рдмрд╛рд░рд╛, рдШрдбреНрдпрд╛рд│, 12:30
ЁЯХР => ЁЯХР, 1 рд╡рд╛рдЬрд▓реЗ, рдШрдбреНрдпрд╛рд│, рдПрдХ, 1:00
ЁЯХЬ => ЁЯХЬ, рджреАрдб, рдШрдбреНрдпрд╛рд│, 1:30
ЁЯХС => ЁЯХС, 2 рд╡рд╛рдЬрд▓реЗ, рдШрдбреНрдпрд╛рд│, рджреЛрди, 2:00
ЁЯХЭ => ЁЯХЭ, рдЕрдбреАрдЪ, рдШрдбреНрдпрд╛рд│, 2:30
ЁЯХТ => ЁЯХТ, 3 рд╡рд╛рдЬрд▓реЗ, рдШрдбреНрдпрд╛рд│, рддреАрди, 3:00
ЁЯХЮ => ЁЯХЮ, рд╕рд╛рдбреЗ рддреАрди рдШрдбреНрдпрд╛рд│, 3:30
ЁЯХУ => ЁЯХУ, 4 рд╡рд╛рдЬрд▓реЗ, рдШрдбреНрдпрд╛рд│, рдЪрд╛рд░, 4:00
ЁЯХЯ => ЁЯХЯ, рд╕рд╛рдбреЗ рдЪрд╛рд░, рдШрдбреНрдпрд╛рд│, 4:30
ЁЯХФ => ЁЯХФ, 5 рд╡рд╛рдЬрд▓реЗ, рдШрдбреНрдпрд╛рд│, рдкрд╛рдЪ, 5:00
ЁЯХа => ЁЯХа, рд╕рд╛рдбреЗ рдкрд╛рдЪ, рдШрдбреНрдпрд╛рд│, 5:30
ЁЯХХ => ЁЯХХ, 6 рд╡рд╛рдЬрд▓реЗ, рдШрдбреНрдпрд╛рд│, рд╕рд╣рд╛, 6:00
ЁЯХб => ЁЯХб, рд╕рд╛рдбреЗ рд╕рд╣рд╛ рдШрдбреНрдпрд╛рд│, 6:30
ЁЯХЦ => ЁЯХЦ, 7 рд╡рд╛рдЬрд▓реЗ, рдШрдбреНрдпрд╛рд│, рд╕рд╛рдд, 7:00
ЁЯХв => ЁЯХв, рд╕рд╛рдбреЗ рд╕рд╛рдд, рдШрдбреНрдпрд╛рд│, 7:30
ЁЯХЧ => ЁЯХЧ, 8 рд╡рд╛рдЬрд▓реЗ, рдШрдбреНрдпрд╛рд│, рдЖрда, 8:00
ЁЯХг => ЁЯХг, рд╕рд╛рдбреЗ рдЖрда, рдШрдбреНрдпрд╛рд│, 8:30
ЁЯХШ => ЁЯХШ, 9 рд╡рд╛рдЬрд▓реЗ, рдШрдбреНрдпрд╛рд│, рдирдК, 9:00
ЁЯХд => ЁЯХд, рд╕рд╛рдбреЗ рдирдК, рдШрдбреНрдпрд╛рд│, 9:30
ЁЯХЩ => ЁЯХЩ, 10 рд╡рд╛рдЬрд▓реЗ, рдШрдбреНрдпрд╛рд│, рджрд╣рд╛, 10:00
ЁЯХе => ЁЯХе, рд╕рд╛рдбреЗ рджрд╣рд╛, рдШрдбреНрдпрд╛рд│, 10:30
ЁЯХЪ => ЁЯХЪ, 11 рд╡рд╛рдЬрд▓реЗ, рдШрдбреНрдпрд╛рд│, рдЕрдХрд░рд╛, 11:00
ЁЯХж => ЁЯХж, рд╕рд╛рдбреЗ рдЕрдХрд░рд╛, рдШрдбреНрдпрд╛рд│, 11:30
ЁЯМС => ЁЯМС, рдЧрдбрдж рдЪрдВрджреНрд░, рдЧрдбрдж, рдЪрдВрджреНрд░
ЁЯМТ => ЁЯМТ, рдЪрдВрджреНрд░рдХреЛрд░, рдЪрдВрджреНрд░рдХреЛрд░ рдЪрдВрджреНрд░, рдЪрдВрджреНрд░
ЁЯМУ => ЁЯМУ, рдЪрддреБрд░реНрдереАрдЪрд╛ рдЪрдВрджреНрд░, рдЪрдВрджреНрд░, рдЪрддреБрд░реНрдереА
ЁЯМФ => ЁЯМФ, рдЪрдВрджреНрд░рдХреЛрд░, рдХреБрдмрдбрд╛ рдЪрдВрджреНрд░, рдХреБрдмрдбрд╛, рдЪрдВрджреНрд░
ЁЯМХ => ЁЯМХ, рдкреВрд░реНрдг рдЪрдВрджреНрд░, рдкреВрд░реНрдг, рддреЗрдЬрд╕реНрд╡реА рдЪрдВрджреНрд░, рддреЗрдЬрд╕реНрд╡реА, рдЪрдВрджреНрд░
ЁЯМЦ => ЁЯМЦ, рдШрдЯрддрд╛ рдЪрдВрджреНрд░, рдШрдЯрддрд╛, рдХреБрдмрдбрд╛ рдЪрдВрджреНрд░, рдХреБрдмрдбрд╛, рдЪрдВрджреНрд░
ЁЯМЧ => ЁЯМЧ, рдЪрддреБрд░реНрдереАрдЪрд╛ рдЪрдВрджреНрд░, рдЪрдВрджреНрд░
ЁЯМШ => ЁЯМШ, рдЪрдВрджреНрд░рдХреЛрд░, рдШрдЯрддрд╛ рдЪрдВрджреНрд░, рдШрдЯрддрд╛, рдЪрдВрджреНрд░
ЁЯМЩ => ЁЯМЩ, рдЪрдВрджреНрд░
ЁЯМЪ => ЁЯМЪ, рдЪрдВрджреНрд░, рдЪреЗрд╣рд░рд╛ рдЕрд╕рд▓реЗрд▓рд╛ рдЕрдорд╛рд╡рд╕реНрдпреЗрдЪрд╛ рдЪрдВрджреНрд░, рдЪреЗрд╣рд░рд╛
ЁЯМЫ => ЁЯМЫ, рдЪрддреБрд░реНрдереАрдЪреНрдпрд╛ рдЪрдВрджреНрд░рд╛рдЪрд╛ рдЪреЗрд╣рд░рд╛, рдЪреЗрд╣рд░рд╛ рдЕрд╕рд▓реЗрд▓рд╛ рдЪрддреБрд░реНрдереАрдЪрд╛ рдЪрдВрджреНрд░, рдЪреЗрд╣рд░рд╛ рдЕрд╕рд▓реЗрд▓реА рдЪрдВрджреНрд░рдХреЛрд░, рдХреГрд╖реНрдг рдкрдХреНрд╖рд╛рддреАрд▓ рдЪрдВрджреНрд░, рдЪрддреБрд░реНрдереАрдЪрд╛ рдЪрдВрджреНрд░, рдЪрдВрджреНрд░, рдЪреЗрд╣рд░рд╛
ЁЯМЬ => ЁЯМЬ, рдЪреЗрд╣рд░рд╛ рдЕрд╕рд▓реЗрд▓реА рдЪрдВрджреНрд░рдХреЛрд░, рдЪреЗрд╣рд░рд╛, рдЪрдВрджреНрд░, рдЪрдВрджреНрд░рдХреЛрд░
ЁЯМб => ЁЯМб, рд╣рд╡рд╛рдорд╛рди
тША => тША, рдЪрдордХрдгрд╛рд░рд╛, рдХрд┐рд░рдг, рдЕрдВрддрд░рд╛рд│, рд╕реВрд░реНрдпрдкреНрд░рдХрд╛рд╢рд╛рдЪрд╛, рд╣рд╡рд╛рдорд╛рди
ЁЯМЭ => ЁЯМЭ, рдЪреЗрд╣рд░рд╛ рдЕрд╕рд▓реЗрд▓рд╛ рдкреМрд░реНрдгрд┐рдореЗрдЪрд╛ рдЪрдВрджреНрд░, рдЪреЗрд╣рд░рд╛ рдЕрд╕рд▓реЗрд▓рд╛ рдкреВрд░реНрдг рдЪрдВрджреНрд░, рдЪрдВрджреНрд░, рдкреМрд░реНрдгрд┐рдорд╛, рдкреВрд░реНрдг рдЪрдВрджреНрд░, рдЪреЗрд╣рд░рд╛
ЁЯМЮ => ЁЯМЮ, рд╕реВрд░реНрдпрд╛рдЪрд╛ рдЪреЗрд╣рд░рд╛, рд╕реВрд░реНрдп, рдЪреЗрд╣рд░рд╛
тнР => тнР, рддрд╛рд░рд╛
ЁЯМЯ => ЁЯМЯ, рдЪрдордХрддрд╛ рддрд╛рд░рд╛, рдЪрдордХрджрд╛рд░, рдЪрдордХрдгрд╛рд░рд╛, рдЪрдордХ, рдЪрдордЪрдорддрд╛, рддрд╛рд░рд╛
ЁЯМа => ЁЯМа, рддреБрдЯрдгрд╛рд░рд╛ рддрд╛рд░рд╛, рддрд╛рд░рд╛ рддреБрдЯрдгреЗ, рддреБрдЯрддрд╛ рддрд╛рд░рд╛, рддрд╛рд░рд╛
тШБ => тШБ, рдореЗрдШ, рд╣рд╡рд╛рдорд╛рди
тЫЕ => тЫЕ, рдврдЧрд╛рдВрдЪреНрдпрд╛ рдорд╛рдЧреЗ рджрдбрд▓реЗрд▓рд╛ рд╕реВрд░реНрдп, рдврдЧрд╛рдВрд╕рд╣ рд╕реВрд░реНрдп, рд╕реВрд░реНрдп, рдореЗрдШ
тЫИ => тЫИ, рдореЗрдШ, рдврдЧ, рд╡рд╛рджрд│, рд╣рд╡рд╛рдорд╛рди
ЁЯМд => ЁЯМд, рдврдЧ, рд╕реВрд░реНрдп, рд╣рд╡рд╛рдорд╛рди
ЁЯМе => ЁЯМе, рдврдЧ, рд╕реВрд░реНрдп, рд╣рд╡рд╛рдорд╛рди
ЁЯМж => ЁЯМж, рдврдЧ, рдкрд╛рдКрд╕, рд╕реВрд░реНрдп, рд╣рд╡рд╛рдорд╛рди
ЁЯМз => ЁЯМз, рдврдЧ, рдкрд╛рдКрд╕, рд╣рд╡рд╛рдорд╛рди
ЁЯМи => ЁЯМи, рдврдЧ, рдердВрдб, рд╣рд┐рдо, рд╣рд╡рд╛рдорд╛рди
ЁЯМй => ЁЯМй, рдврдЧ, рд╡рд┐рдЬрд╛ рдЪрдордХрдгреЗ, рд╣рд╡рд╛рдорд╛рди
ЁЯМк => ЁЯМк, рдврдЧ, рд╣рд╡рд╛рдорд╛рди, рдЪрдХреНрд░рд╛рд╡рд╛рдд
ЁЯМл => ЁЯМл, рдврдЧ, рд╣рд╡рд╛рдорд╛рди
ЁЯМм => ЁЯМм, рд╡рд╛рд╣рдгреЗ, рдврдЧ, рдЪреЗрд╣рд░рд╛, рд╣рд╡рд╛рдорд╛рди, рд╡рд╛рд░рд╛
ЁЯМА => ЁЯМА, рддреБрдлрд╛рди, рд╡рд╛рд╡рдЯрд│, рднреЛрд╡рд░рд╛
ЁЯМВ => ЁЯМВ, рдЫрддреНрд░реА, рдкрд╛рдКрд╕, рдкрд╛рд╡рд╕рд╛рд│реА
тШВ => тШВ, рдХрдкрдбреЗ, рдкрд╛рдКрд╕, рд╣рд╡рд╛рдорд╛рди
тШФ => тШФ, рдХрдкрдбреЗ, рдереЗрдВрдм, рдкрд╛рдКрд╕, рдЫрддреНрд░реА, рд╣рд╡рд╛рдорд╛рди
тЫ▒ => тЫ▒, рдкрд╛рдКрд╕, рд╕реВрд░реНрдп, рдЫрддреНрд░реА, рд╣рд╡рд╛рдорд╛рди
тЪб => тЪб, рдЙрдЪреНрдЪ рд╡реНрд╣реЛрд▓реНрдЯреЗрдЬрдЪрд╛ рдзреЛрдХрд╛, рдЙрдЪреНрдЪ рд╡реНрд╣реЛрд▓реНрдЯреЗрдЬ рдЪрд┐рдиреНрд╣, рдЙрдЪреНрдЪ, рд╡реНрд╣реЛрд▓реНрдЯреЗрдЬ, рдЪрд┐рдиреНрд╣
тЭД => тЭД, рдердВрдб, рд╣рд┐рдо, рд╣рд╡рд╛рдорд╛рди
тШГ => тШГ, рдердВрдб, рд╣рд┐рдо, рд╣рд╡рд╛рдорд╛рди
тЫД => тЫД, рд╕реНрдиреЛрдореЕрди, рдмрд░реНрдлрд╛рдкрд╛рд╕реВрди рдмрдирд╡рд▓реЗрд▓реА рдордиреБрд╖реНрдпрд╛рдЪреА рдореВрд░реНрддрд┐, рдмрд░реНрдлрд╛рд╢рд┐рд╡рд╛рдп рдмрд░реНрдлреАрд▓реНрдпрд╛ рдордиреБрд╖реНрдпрд╛рдЪреА рдореВрд░реНрддрд┐, рдмрд░реНрдл
тШД => тШД, рдЕрдВрддрд░рд╛рд│, рдЖрдХрд╛рд╢
ЁЯФе => ЁЯФе, рдЖрдЧ, рд╕рд╛рдзрди
ЁЯТз => ЁЯТз, рдердВрдб рдШрд╛рдо, рдШрд╛рдо, рдШрд╛рдо рдЖрдгрдгрд╛рд░рд╛, рд╡рд┐рдиреЛрджреА
ЁЯМК => ЁЯМК, рд▓рд╛рдЯ, рдорд╣рд╛рд╕рд╛рдЧрд░рд╛рдЪреА рд▓рд╛рдЯ
ЁЯОГ => ЁЯОГ, рдЬреЕрдХ-рдУ-рд▓реЕрдВрдЯрд░реНрди, рдЬреЕрдХ, рдХрдВрджреАрд▓, рд╣реЕрд▓реЛрд╡рд┐рди, рднреЛрдкрд│рд╛, рдЙрддреНрд╕рд╡
ЁЯОД => ЁЯОД, рдЭрд╛рдб, рдЙрддреНрд╕рд╡
ЁЯОЖ => ЁЯОЖ, рдЖрддрд╖рдмрд╛рдЬреА, рдЙрддреНрд╕рд╡
ЁЯОЗ => ЁЯОЗ, рдЪрдордХрдгрд╛рд░реЗ, рдЖрддрд╖рдмрд╛рдЬреА, рдЪрдордХрдгрд╛рд░реА рдЖрддрд╖рдмрд╛рдЬреА, рдЙрддреНрд╕рд╡, рдлрдЯрд╛рдХреЗ
тЬи => тЬи, рдЪрдордХрддреЗ, рдЪрдордХрдгрд╛рд░реЗ рддрд╛рд░реЗ, рддрд╛рд░реЗ
ЁЯОИ => ЁЯОИ, рдЙрддреНрд╕рд╡, рд╡рд╛рдврджрд┐рд╡рд╕
ЁЯОЙ => ЁЯОЙ, рдкрд╛рд░реНрдЯреА, рдкреЙрдкрд░, рдЙрддреНрд╕рд╡
ЁЯОК => ЁЯОК, рдХреЙрдирдлреЗрдЯреА, рдХреЙрдирдлреЗрдЯреА рдЪреЗрдВрдбреВ, рдЪреЗрдВрдбреВ, рдЙрддреНрд╕рд╡
ЁЯОЛ => ЁЯОЛ, рдЭрд╛рдб рдЖрдгрд┐ рдХрд╛рдЧрджреА рдкрдЯреНрдЯреНрдпрд╛, рд╕реНрдЯрд╛рд░ рдЙрддреНрд╕рд╡, рдЭрд╛рдб, рдХрд╛рдЧрджрд╛рдЪреНрдпрд╛ рдкрдЯреНрдЯреНрдпрд╛, рдЙрддреНрд╕рд╡, рддрд╛рдирд╛рдмрд╛рдЯрд╛ рдЭрд╛рдб
ЁЯОМ => ЁЯОМ, рдХреНрд░реЙрд╕ рдЭреЗрдВрдбреЗ, рдХреНрд░реЙрд╕ рдХреЗрд▓реЗрд▓реЗ рдЬрдкрд╛рдиреА рдЭреЗрдВрдбреЗ, рдХреНрд░реЙрд╕ рдХреЗрд▓реЗрд▓реЗ рдЭреЗрдВрдбреЗ, рдЙрддреНрд╕рд╡
ЁЯОН => ЁЯОН, рдкрд╛рдЗрди рд╕рдЬрд╛рд╡рдЯ, рдирд╡реАрди рд╡рд░реНрд╖, рдЬрдкрд╛рдиреА, рдкрд╛рдЗрди, рдЙрддреНрд╕рд╡
ЁЯОО => ЁЯОО, рдмрд╛рд╣реБрд▓реНрдпрд╛, рдмрд╛рд╣реБрд▓реНрдпрд╛рдВрдЪрд╛ рдорд╣реЛрддреНрд╕рд╡, рд╕рдг, рдЬрдкрд╛рдиреА, рдЙрддреНрд╕рд╡
ЁЯОП => ЁЯОП, рд╕реНрдЯреНрд░реАрдорд░, рдЙрддреНрд╕рд╡
ЁЯОР => ЁЯОР, рд╡рд┐рдВрдб рдЪрд╛рдЗрдо, рдШрдВрдЯреА
ЁЯОС => ЁЯОС, рдЪрдВрджреНрд░ рдкрд╛рд╣рдгреЗ, рдЪрдВрджреНрд░ рджрд░реНрд╢рдирд╛рдЪрд╛ рдЙрддреНрд╕рд╡, рдЪрдВрджреНрд░, рдкрд╛рд╣рдгреЗ, рдЙрддреНрд╕рд╡
ЁЯОА => ЁЯОА, рд░рд┐рдмрди, рдЙрддреНрд╕рд╡
ЁЯОБ => ЁЯОБ, рднреЗрдЯ, рднреЗрдЯрд╡рд╕реНрддреВ, рдкреЕрдХ рдХреЗрд▓реЗрд▓реА рднреЗрдЯрд╡рд╕реНрддреВ, рдкреЕрдХ рдХреЗрд▓реЗрд▓реЗ, рдЙрддреНрд╕рд╡
ЁЯОЦ => ЁЯОЦ, рд╕реЛрд╣рд│рд╛, рдкрджрдХ, рд╕реИрдиреНрдп
ЁЯОЧ => ЁЯОЧ, рд╕реЛрд╣рд│рд╛, рд╕реНрдорд░рдгрдкрддреНрд░, рдлрд┐рдд
ЁЯОЮ => ЁЯОЮ, рд╕рд┐рдиреЗрдорд╛, рдлрд┐рд▓реНрдо, рдлреНрд░реЗрдо, рдЪрд┐рддреНрд░рдкрдЯ
ЁЯОЯ => ЁЯОЯ, рдкреНрд░рд╡реЗрд╢, рддрд┐рдХрд┐рдЯ
ЁЯОл => ЁЯОл, рддрд┐рдХреАрдЯ, рдордиреЛрд░рдВрдЬрди
тЪ╜ => тЪ╜, рд╕реЙрдХрд░ рдмреЙрд▓, рд╕реЙрдХрд░, рдмреЙрд▓
тЪ╛ => тЪ╛, рдмреЙрд▓
ЁЯПА => ЁЯПА, рдмрд╛рд╕реНрдХреЗрдЯрдмреЙрд▓ рд╣реБрдк, рдЪреЗрдВрдбреВ, рд╣реБрдк, рдХреНрд░реАрдбрд╛
ЁЯПИ => ЁЯПИ, рдЕрдореЗрд░рд┐рдХрди, рдЪреЗрдВрдбреВ, рдХреНрд░реАрдбрд╛
ЁЯПЙ => ЁЯПЙ, рдлреБрдЯрдмреЙрд▓, рд╕реЙрдХрд░ рдмреЙрд▓, рдЪреЗрдВрдбреВ, рдХреНрд░реАрдбрд╛, рд░рдЧреНрдмреА
ЁЯО╛ => ЁЯО╛, рдЯреЗрдирд┐рд╕ рдмреЙрд▓, рдЯреЗрдирд┐рд╕ рд░реЕрдХреЗрдЯ рдЖрдгрд┐ рдЪреЗрдВрдбреВ, рдЪреЗрдВрдбреВ, рдХреНрд░рд┐рдбрд╛
ЁЯО▒ => ЁЯО▒, рдмрд┐рд▓рд┐рдпрд░реНрдб, рдЖрда рдЪреЗрдВрдбреВ, рдЧреЗрдо
ЁЯО│ => ЁЯО│, рдЧреЛрд▓рдВрджрд╛рдЬреА рдЪреЗрдВрдбреВ, рдЪреЗрдВрдбреВ, рдЧреЗрдо
тЫ│ => тЫ│, рдЫрд┐рджреНрд░рд╛рдордзреАрд▓ рдЭреЗрдВрдбрд╛, рдЧреЛрд▓реНрдл, рдЧреЛрд▓реНрдлрдЪрд╛ рдзреНрд╡рдЬ, рдЫрд┐рджреНрд░рд╛рдордзреНрдпреЗ рдзреНрд╡рдЬ
ЁЯПМ => ЁЯПМ, рдЪреЗрдВрдбреВ, рдЧреЛрд▓реНрдл
тЫ╕ => тЫ╕, рдмрд░реНрдл
ЁЯОг => ЁЯОг, рдорд╛рд╕реЗрдорд╛рд░реА, рдорд╛рд╕реЗрдорд╛рд░реАрдЪрд╛ рд░реЙрдб рдЖрдгрд┐ рдорд╛рд╕реЗ, рдорд╛рд╕реЗ, рд░реЙрдб, рдкреБрдирд░реНрдирд┐рд░реНрдорд┐рддреА, рдордиреЛрд░рдВрдЬрди
ЁЯО╜ => ЁЯО╜, рд░рдирд┐рдВрдЧ рд╢рд░реНрдЯ, рдкрдЯреНрдЯреНрдпрд╛рдВрдЪреЗ рд░рдирд┐рдВрдЧ рд╢рд░реНрдЯ, рдкрдЯреНрдЯреА, рдХреНрд░рд┐рдбрд╛
ЁЯО┐ => ЁЯО┐, рдмрд░реНрдлрд╛рд╡рд░реВрди рдШрд╕рд░рдгрд╛рд░рд╛, рд╣рд┐рдо
тЫ╖ => тЫ╖, рд╣рд┐рдо
ЁЯПВ => ЁЯПВ, рд╕реНрдиреЛрдмреЙрд░реНрдбрд░, рд╕реНрдиреЛрдмреЛрд░реНрдбрд┐рдВрдЧ, рд╕реНрдиреЛрдмреЛрд░реНрдб, рдХреНрд░рд┐рдбрд╛
ЁЯПД => ЁЯПД, рд╕рд░реНрдл, рд╕рд░реНрдлрд░, рдХреНрд░рд┐рдбрд╛
ЁЯПЗ => ЁЯПЗ, рд╢рд░реНрдпрддреАрдЪрд╛ рдШреЛрдбрд╛, рдЬреЙрдХреА, рд░реЗрд╕рд┐рдВрдЧ, рдШреЛрдбрд╛, рдХреНрд░реАрдбрд╛
ЁЯПК => ЁЯПК, рдЬрд▓рддрд░рдгрдкрдЯреВ, рдЬрд▓рддрд░рдг, рдкреЛрд╣рдгреЗ, рдХреНрд░реАрдбрд╛
тЫ╣ => тЫ╣, рдЪреЗрдВрдбреВ
ЁЯПЛ => ЁЯПЛ, рд╡рдЬрди
ЁЯЪ┤ => ЁЯЪ┤, рд╕рд╛рдпрдХрд▓рд╕реНрд╡рд╛рд░, рджреБрдЪрд╛рдХреАрд╕реНрд╡рд╛рд░, рджреБрдЪрд╛рдХреА
ЁЯЪ╡ => ЁЯЪ╡, рдбреЛрдВрдЧрд░рд╛рд╡рд░реАрд▓ рд╕рд╛рдпрдХрд▓рд╕реНрд╡рд╛рд░, рджреБрдЪрд╛рдХреА, рд╕рд╛рдпрдХрд▓рд╕реНрд╡рд╛рд░, рдбреЛрдВрдЧрд░
ЁЯПО => ЁЯПО, рдХрд╛рд░, рд╢рд░реНрдпрдд
ЁЯПН => ЁЯПН, рд╢рд░реНрдпрдд рд▓рд╛рд╡рдгреЗ
ЁЯПЕ => ЁЯПЕ, рдкрджрдХ
ЁЯПЖ => ЁЯПЖ, рдЯреНрд░реЙрдлреА, рдмрдХреНрд╖реАрд╕, рдХрдк
ЁЯПП => ЁЯПП, рдЪреЗрдВрдбреВ, рдмреЕрдЯ, рдЦреЗрд│
ЁЯПР => ЁЯПР, рдЪреЗрдВрдбреВ, рдЦреЗрд│
ЁЯПС => ЁЯПС, рдЪреЗрдВрдбреВ, рдореИрджрд╛рди, рдЦреЗрд│, рд╣реЙрдХреА, рд╕реНрдЯрд┐рдХ
ЁЯПТ => ЁЯПТ, рдЦреЗрд│, рд╣реЙрдХреА, рд╣рд┐рдо, рд░рдмрд░реА рдЪрдХрддреА, рд╕реНрдЯрд┐рдХ
ЁЯПУ => ЁЯПУ, рдЪреЗрдВрдбреВ, рдмреЕрдЯ, рдЬреНрдЮреЗрд│, рдкреЕрдбрд▓, рдЯреЗрдмрд▓, рдЯреЗрдирд┐рд╕
ЁЯП╕ => ЁЯП╕, рдкрдХреНрд╖реА, рдЦреЗреЗрд│, рд░реЕрдХреЗрдЯ, рдмреЕрдбрдорд┐рдВрдЯрдирдЪреНрдпрд╛ рдЦреЗрд│рд╛рддреАрд▓ рдлреВрд▓
ЁЯОп => ЁЯОп, рд▓рдХреНрд╖реНрдп, рдереЗрдЯ рдирд┐рд╢рд╛рдгрд╛, рд▓рдХреНрд╖реНрдпрд╛рд╡рд░ рдирд┐рд╢рд╛рдгрд╛, рдирд┐рд╢рд╛рдгрд╛, рдЧреЗрдо
ЁЯОо => ЁЯОо, рдЧреЗрдо рдирд┐рдпрдВрддреНрд░рдХ, рдирд┐рдпрдВрддреНрд░рдХ, рдЧреЗрдо
ЁЯХ╣ => ЁЯХ╣, рдЦреЗрд│, рд╡реНрд╣рд┐рдбрд┐рдУ рдЧреЗрдо
ЁЯО▓ => ЁЯО▓, рдЧреЗрдо рдлрд╛рд╕реЗ, рдлрд╛рд╕реЗ, рдЧреЗрдо
тЩа => тЩа, рдЦреЗрд│рдгреНтАНрдпрд╛рдЪреЗ рдкрддреНрддреЗ, рдЦреЗрд│
тЩе => тЩе, рдЦреЗрд│рдгреНтАНрдпрд╛рдЪреЗ рдкрддреНрддреЗ, рдЦреЗрд│
тЩж => тЩж, рдЦреЗрд│рдгреНтАНрдпрд╛рдЪреЗ рдкрддреНрддреЗ, рдЪрд╡рдХрдЯ, рдЦреЗрд│
тЩг => тЩг, рдЦреЗрд│рдгреНтАНрдпрд╛рдЪреЗ рдкрддреНрддреЗ, рдЦреЗрд│
ЁЯГП => ЁЯГП, рдЦреЗрд│рдгреНрдпрд╛рдЪрд╛ рдкрддреНрддрд╛, рдЦреЗрд│рдгреЗ
ЁЯАД => ЁЯАД, рдорд╣рдЬреЛрдВрдЧ рдЯрд╛рдЗрд▓, рд▓рд╛рд▓ рдбреНрд░реЕрдЧрди
ЁЯО┤ => ЁЯО┤, рдЦреЗрд│рдгреНрдпрд╛рдЪреЗ рдкрддреНрддреЗ, рдлреВрд▓ рдЕрд╕рд▓реЗрд▓рд╛ рдкрддреНрддрд╛, рдлреВрд▓, рдкрддреНрддреНрдпрд╛рдЪрд╛ рдЧреЗрдо, рдкрддреНрддрд╛, рдЧреЗрдо, рд╣рд╛рдирд╛рдлреБрдбрд╛
ЁЯФЗ => ЁЯФЗ, рдмреЛрд▓реВ рдирдпреЗ, рдХреГрдкрдпрд╛ рд╢рд╛рдВрдд рд░рд╣рд╛, рд╢рд╛рдВрдд рд░рд╣рд╛, рд░рджреНрдж рдХрд░рдгреНрдпрд╛рдЪреНрдпрд╛ рдЪрд┐рдиреНрд╣рд╛рд╕рд╣ рд╕реНрдкреАрдХрд░
ЁЯФИ => ЁЯФИ, рдзреНрд╡рдиреАрдХреНрд╖реЗрдкрдХ
ЁЯФЙ => ЁЯФЙ, рд╕реНрдкреАрдХрд░, рдХрдореА рдзреНрд╡рдиреА, рдХрдореА, рдХрдореА рдзреНрд╡рдиреА рдЕрд╕рд▓реЗрд▓рд╛ рд╕реНрдкреАрдХрд░
ЁЯФК => ЁЯФК, рд╕реНрдкреАрдХрд░, рдЙрдЪреНрдЪ рдзреНрд╡рдиреА, рдЙрдЪреНрдЪ, рдЙрдЪреНрдЪ рдзреНрд╡рдиреА рдЕрд╕рд▓реЗрд▓рд╛ рд╕реНрдкреАрдХрд░
ЁЯУв => ЁЯУв, рд▓рд╛рдЙрдбрд╕реНрдкреАрдХрд░, рд╕рд╛рд░реНрд╡рдЬрдирд┐рдХ рдЕрднрд┐рднрд╛рд╖рдг, рд╣рд╛рддрд╛рддреАрд▓ рд╕реНрдкреАрдХрд░, рд╕рдВрд╡рд╛рдж
ЁЯУг => ЁЯУг, рдЖрдирдВрджрджрд╛рдпрдХ, рд╕рдВрд╡рд╛рдж
ЁЯУп => ЁЯУп, рдкреЛрд╕реНрдЯрд▓, рд╣реЙрд░реНрди
ЁЯФФ => ЁЯФФ, рдзрд╛рд░реНрдорд┐рдХ рд╕реНрдерд│, рдЪреЕрдкреЗрд▓
ЁЯФХ => ЁЯФХ, рдШрдВрдЯрд╛ рдирд╛рд╣реА, рдЖрд╡рд╛рдЬ рдирд╛рд╣реА, рд░рджреНрдж рдЪрд┐рдиреНрд╣рд╛рд╕рд╣ рдШрдВрдЯрд╛, рдШрдВрдЯрд╛
ЁЯО╝ => ЁЯО╝, рд╕рдВрдЧреАрдд рд╕реНрдХреЛрдЕрд░, рд╕рдВрдЧреАрдд, рд╕реНрдХреЛрдЕрд░
ЁЯО╡ => ЁЯО╡, рд╕рдВрдЧреАрдд рд╕реНрд╡рд░, рд╕рдВрдЧреАрдд, рд╕реНрд╡рд░
ЁЯО╢ => ЁЯО╢, рд╡рд╛рджреНрдп рд╕реНрд╡рд░, рд╕рдВрдЧреАрдд, рд╕реНрд╡рд░
ЁЯОЩ => ЁЯОЩ, рдорд╛рдЗрдХ, рдорд╛рдпрдХреНрд░реЛрдлрд╛рди, рд╕рдВрдЧреАрдд, рд╕реНрдЯреБрдбрд┐рдУ
ЁЯОЪ => ЁЯОЪ, рдкрд╛рддрд│реА, рд╕рдВрдЧреАрдд, рд╕реНрд▓рд╛рдпрдбрд░
ЁЯОЫ => ЁЯОЫ, рд╕рдВрдЧреАрдд
ЁЯОд => ЁЯОд, рдорд╛рдЗрдХ, рдХрд░рд╛рдУрдХреЗ, рдордиреЛрд░рдВрдЬрди
ЁЯОз => ЁЯОз, рдордиреЛрд░рдВрдЬрди, рдЧрд╛рдгреА
ЁЯО╖ => ЁЯО╖, рд╕реЕрдХреНрд╕реЛрдлреЛрди, рд╕рдВрдЧреАрдд рд╡рд╛рджреНрдпрд╡реГрдВрдж, рд╕рдВрдЧреАрдд, рд╡рд╛рджреНрдпрд╡реГрдВрдж
ЁЯО╕ => ЁЯО╕, рд╕рдВрдЧреАрдд рд╡рд╛рджреНрдпрд╡реГрдВрдж, рд╕рдВрдЧреАрдд, рд╡рд╛рджреНрдпрд╡реГрдВрдж
ЁЯО╣ => ЁЯО╣, рдкрд┐рдпрд╛рдиреЛ, рд╕рдВрдЧреАрдд рдХреАрдмреЛрд░реНрдб, рдХреАрдмреЛрд░реНрдб, рд╡рд╛рджреНрдп, рд╕рдВрдЧреАрдд, рд╡рд╛рджреНрдпрд╡реГрдВрдж
ЁЯО║ => ЁЯО║, рд░рдгрд╢рд┐рдВрдЧ, рд╕рдВрдЧреАрдд рд╡рд╛рджреНрдпрд╡реГрдВрдж, рд╕рдВрдЧреАрдд, рд╡рд╛рджреНрдпрд╡реГрдВрдж, рдЯреНрд░рдВрдкреЗрдЯ
ЁЯО╗ => ЁЯО╗, рд╡реНрд╣рд╛рдпреЛрд▓рд┐рди, рд╕рдВрдЧреАрдд рд╡рд╛рджреНрдпрд╡реГрдВрдж, рд╕рдВрдЧреАрдд, рд╡рд╛рджреНрдпрд╡реГрдВрдж
ЁЯУ▒ => ЁЯУ▒, рд╕реЗрд▓ рдлреЛрди, рдореЛрдмрд╛рдЗрд▓ рдлреЛрди, рдлреЛрди
ЁЯУ▓ => ЁЯУ▓, рдмрд╛рдгрд╛рд╕рд╣реАрдд рд╕реЗрд▓ рдлреЛрди, рдХреЙрд▓ рдХрд░рд╛, рдореЛрдмрд╛рдЗрд▓ рдлреЛрди, рдлреЛрди рдХрд░рд╛
тШО => тШО, рдлреЛрди
ЁЯУЮ => ЁЯУЮ, рдлреЛрди, рдЯреЗрд▓рд┐рдлреЛрди, рдлреЛрдирдЪрд╛ рд░рд┐рд╕рд┐рд╡реНрд╣рд░, рд╕рдВрд╡рд╛рдж
ЁЯУЯ => ЁЯУЯ, рд╕рдВрд╡рд╛рдж
ЁЯУа => ЁЯУа, рдлреЕрдХреНрд╕, рд╕рдВрд╡рд╛рдж
ЁЯФЛ => ЁЯФЛ, рд╡рд┐рдЬреЗрд░реА
ЁЯФМ => ЁЯФМ, рд╡рд┐рджреНрдпреБрдд рдкреНрд▓рдЧ, рд╡рд┐рджреНрдпреБрдд
ЁЯТ╗ => ЁЯТ╗, PC, рд╡реИрдпрдХреНрддрд┐рдХ рд╕рдВрдЧрдгрдХ, рд╕рдВрдЧрдгрдХ, рд╡реИрдпрдХреНрддрд┐рдХ, рд▓реЕрдкрдЯреЙрдк
ЁЯЦе => ЁЯЦе, рд╕рдВрдЧрдгрдХ, рдбреЗрд╕реНрдХрдЯреЙрдк
ЁЯЦи => ЁЯЦи, рд╕рдВрдЧрдгрдХ
тМи => тМи, рд╕рдВрдЧрдгрдХ
ЁЯЦ▒ => ЁЯЦ▒, 3, рдмрдЯрдг, рд╕рдВрдЧрдгрдХ, рдорд╛рдКрд╕, рддреАрди
ЁЯЦ▓ => ЁЯЦ▓, рд╕рдВрдЧрдгрдХ
ЁЯТ╜ => ЁЯТ╜, рдПрдордбреА, рдорд┐рдиреА рдбрд┐рд╕реНрдХ, рдбрд┐рд╕реНрдХ
ЁЯТ╛ => ЁЯТ╛, рдлреНрд▓реЙрдкреА, рдбрд┐рд╕реНрдХ
ЁЯТ┐ => ЁЯТ┐, рдмреНрд▓реНрдпреВ-рд░реЗ, рдбреАрд╡реНрд╣реАрдбреА, рд╕реАрдбреА, рдбрд┐рд╕реНрдХ
ЁЯУА => ЁЯУА, рдбреАрд╡реНрд╣реАрдбреА рдбрд┐рд╕реНрдХ, рдбрд┐рд╕реНрдХ
ЁЯОе => ЁЯОе, рдореВрд╡реНрд╣реА рдХреЕрдореЗрд░рд╛, рдЪрд┐рддреНрд░рдкрдЯ, рдордиреЛрд░рдВрдЬрди
ЁЯОм => ЁЯОм, рдХреНрд▓реЕрдкрд░рдмреЛрд░реНрдб, рдХреНрд▓реЕрдкрд░, рдЪрд┐рддреНрд░рдкрдЯ, рдордиреЛрд░рдВрдЬрди, рдЪрд┐рддреНрд░рдкрдЯрд╛рдЪрд╛ рдореБрд╣реБрд░реНрдд
ЁЯУ╜ => ЁЯУ╜, рд╕рд┐рдиреЗрдорд╛, рдлрд┐рд▓реНрдо, рдЪрд┐рддреНрд░рдкрдЯ, рдкреНрд░реЛрдЬреЗрдХреНрдЯрд░, рд╡реНрд╣рд┐рдбрд┐рдУ
ЁЯУ║ => ЁЯУ║, рдЯреАрд╡реНрд╣реА, рджреВрд░рджрд░реНрд╢рди
ЁЯУ╕ => ЁЯУ╕, рдХреЕрдореЗрд░рд╛, рдлреНрд▓реЕрд╢, рд╡реНрд╣рд┐рдбрд┐рдУ
ЁЯУ╣ => ЁЯУ╣, рд╡реНрд╣рд┐рдбрд┐рдУ рдХреЕрдо, рдХреЕрдореЗрд░рд╛, рд╡реНрд╣рд┐рдбрд┐рдУ
ЁЯУ╝ => ЁЯУ╝, рд╡реНрд╣рд┐рдбрд┐рдУ рдЯреЗрдк, рд╡реНрд╣рд┐рдбрд┐рдУ, рдЯреЗрдк
ЁЯФН => ЁЯФН, рднрд┐рдВрдЧ, рд╢реЛрдз, рдбрд╛рд╡реАрдХрдбреЗ-рд╡рд╛рдХрд▓реЗрд▓реЗ рднрд┐рдВрдЧ, рдбрд╛рд╡реАрдХрдбреЗ-рд╡рд╛рдХрд▓реЗрд▓реА, рдХрд╛рдЪ
ЁЯФО => ЁЯФО, рднрд┐рдВрдЧ, рд╢реЛрдз, рдЙрдЬрд╡реАрдХрдбреЗ-рд╡рд╛рдХрд▓реЗрд▓реЗ рднрд┐рдВрдЧ, рдЙрдЬрд╡реАрдХрдбреЗ-рд╡рд╛рдХрд▓реЗрд▓реА, рдХрд╛рдЪ
ЁЯФн => ЁЯФн, рдЯреЗрд▓реЗрд╕реНрдХреЛрдк, рджреБрд░реНрдмрд┐рдг
ЁЯУб => ЁЯУб, рдЙрдкрдЧреНрд░рд╣ рдбрд┐рд╢, рдЙрдкрдЧреНрд░рд╣ рдПрдВрдЯрд┐рдирд╛, рдЕрдБрдЯрд┐рдирд╛, рдбрд┐рд╢, рдЙрдкрдЧреНрд░рд╣, рд╕рдВрд╡рд╛рдж
ЁЯХп => ЁЯХп, рджрд┐рд╡рд╛
ЁЯТб => ЁЯТб, рд╡рд┐рдЬреЗрдЪрд╛ рджрд┐рд╡рд╛, рдПрдХ рдХрд▓реНрдкрдирд╛ рдорд┐рд│рд╛рд▓реА, рд╡рд┐рджреНрдпреБрдд, рдкреНрд░рдХрд╛рд╢, рдмрд▓реНрдм, рд╡рд┐рдиреЛрджреА
ЁЯФж => ЁЯФж, рдкреНрд░рдХрд╛рд╢, рдорд╢рд╛рд▓, рд╡рд┐рджреНрдпреБрдд
ЁЯПо => ЁЯПо, рд▓рд╛рд▓ рдХрдВрджреАрд▓, рд▓рд╛рд▓, рдХрдВрджреАрд▓, рдЗрдЬрд╛рдХрд╛рдпрд╛, рдмрд╛рд░, рд░реЗрд╕реНрдЯреЙрд░рдВрдЯ
ЁЯУФ => ЁЯУФ, рд╕реБрд╢реЛрднрд┐рдд рдиреЛрдЯрдмреБрдХ, рд╕рдЬрд╛рд╡рдЯ, рдиреЛрдЯрдмреБрдХ, рдХрд╡реНрд╣рд░ рд╡рд╣реА
ЁЯУХ => ЁЯУХ, рдкреБрд╕реНрддрдХ
ЁЯУЦ => ЁЯУЦ, рдЙрдШрдбреЗ рдкреБрд╕реНрддрдХ, рдкреБрд╕реНрддрдХ
ЁЯУЧ => ЁЯУЧ, рд╣рд┐рд░рд╡реЗ рдкреБрд╕реНрддрдХ, рдкреБрд╕реНрддрдХ
ЁЯУШ => ЁЯУШ, рдкреБрд╕реНрддрдХ, рдирд┐рд│реЗ рдкреБрд╕реНрддрдХ
ЁЯУЩ => ЁЯУЩ, рдирд╛рд░рдВрдЧреА рдкреБрд╕реНрддрдХ, рдкреБрд╕реНрддрдХ
ЁЯУЪ => ЁЯУЪ, рдкреБрд╕реНрддрдХ
ЁЯУУ => ЁЯУУ, рдиреЛрдЯрдмреБрдХ
ЁЯУТ => ЁЯУТ, рдЦрд╛рддреЗрд╡рд╣реА, рдиреЛрдЯрдмреБрдХ
ЁЯУГ => ЁЯУГ, рджрд╕реНрддрдРрд╡рдЬ, рдПрдХ рд╡рд▓рдпрд╛рд╕рд╣ рдкреГрд╖реНрда, рдкреГрд╖реНрда
ЁЯУЬ => ЁЯУЬ, рд╕реНрдХреНрд░реЛрд▓, рдХрд╛рдЧрдж рд╕реНрдХреНрд░реЛрд▓
ЁЯУД => ЁЯУД, рджрд╕реНрддрдРрд╡рдЬ, рджрд░реНрд╢рдиреА рдкреГрд╖реНрда, рджрд░реНрд╢рдиреА, рдкреГрд╖реНрда
ЁЯУ░ => ЁЯУ░, рд╡реГрддреНрддрдкрддреНрд░, рдмрд╛рддрдореНрдпрд╛, рдХрд╛рдЧрдж
ЁЯЧЮ => ЁЯЧЮ, рдмрд╛рддрдореНрдпрд╛, рд╡рд░реНрддрдорд╛рдирдкрддреНрд░, рдкреЗрдкрд░, рдЧреБрдВрдбрд╛рд│рд▓реЗрд▓реЗ
ЁЯУС => ЁЯУС, рдорд╛рд░реНрдХрд░, рдЯреЕрдм, рдмреБрдХрдорд╛рд░реНрдХ
ЁЯТ░ => ЁЯТ░, рдкреИрд╢рд╛рдЪреА рдкрд┐рд╢рд╡реА, рдбреЙрд▓рд░ рдкрд┐рд╢рд╡реА, рдкреИрд╕рд╛, рдкрд┐рд╢рд╡реА
ЁЯТ┤ => ЁЯТ┤, рдпреЗрди рдиреЛрдЯ, рдмрдБрдХрдиреЛрдЯ, рдпреЗрди, рдкреИрд╕рд╛, рдмрд┐рд▓, рдиреЛрдЯ
ЁЯТ╡ => ЁЯТ╡, рдбреЙрд▓рд░ рдиреЛрдЯ, рдмрдБрдХрдиреЛрдЯ, рдбреЙрд▓рд░, рдкреИрд╕рд╛, рдмрд┐рд▓, рдиреЛрдЯ
ЁЯТ╢ => ЁЯТ╢, рдпреБрд░реЛ рдиреЛрдЯ, рдпреБрд░реЛ, рдмрдБрдХрдиреЛрдЯ, рдкреИрд╕рд╛, рдмрд┐рд▓, рдиреЛрдЯ
ЁЯТ╖ => ЁЯТ╖, рдкрд╛рдЙрдВрдб рдиреЛрдЯ, рдкрд╛рдЙрдВрдб, рдмрдБрдХрдиреЛрдЯ, рдкреИрд╕рд╛
ЁЯТ╕ => ЁЯТ╕, рдЙрдбрдгрд╛рд░реЗ рдкреИрд╕реЗ, рдкрдВрдЦ рдЕрд╕рд▓реЗрд▓реЗ рдкреИрд╕реЗ, рдЙрдбрдгрд╛рд░реА рдмрдБрдХрдиреЛрдЯ, рдмрдБрдХ, рдиреЛрдЯ, рдкреИрд╕рд╛
ЁЯТ│ => ЁЯТ│, рдХрд╛рд░реНрдб, рдХреНрд░реЗрдбрд┐рдЯ
ЁЯТ╣ => ЁЯТ╣, рд╡рд╛рдврддрд╛ рдмрд╛рдЬрд╛рд░, рдКрд░реНрдзреНрд╡рдЧрд╛рдореА рдЪрд╛рд░реНрдЯ, рд╡рд░, рдЪрд╛рд░реНрдЯ, рдмрд╛рдЬрд╛рд░
тЬЙ => тЬЙ, рдИ-рдореЗрд▓, рдИрдореЗрд▓
ЁЯУз => ЁЯУз, рдореЗрд▓, рдкрддреНрд░, рд╕рдВрд╡рд╛рдж
ЁЯУи => ЁЯУи, рдпреЗрдгрд╛рд░реЗ рдореЗрд▓, рдкреНрд░рд╛рдкреНрдд рдореЗрд▓, рдпреЗрдгрд╛рд░реЗ, рдИ-рдореЗрд▓, рдореЗрд▓, рдкрддреНрд░, рд▓рд┐рдлрд╛рдлрд╛, рд╕рдВрд╡рд╛рдж
ЁЯУй => ЁЯУй, рдЬрд╛рдгрд╛рд░реА рдореЗрд▓, рдкреНрд░реЗрд╖рд┐рдд рдореЗрд▓, рдЬрд╛рдгрд╛рд░реА, рдИ-рдореЗрд▓, рдореЗрд▓, рдкрддреНрд░, рд▓рд┐рдлрд╛рдлрд╛, рд╕рдВрд╡рд╛рдж
ЁЯУд => ЁЯУд, рдкреНрд░реЗрд╖рд┐рдд рдореЗрд▓, рдкреНрд░реЗрд╖рд┐рдд рдмреЙрдХреНрд╕, рдореЗрд▓, рдкреНрд░реЗрд╖рд┐рдд, рдмреЙрдХреНрд╕, рдЖрдЙрдЯрдмреЙрдХреНрд╕, рдЯреНрд░реЗ, рд╕рдВрд╡рд╛рдж
ЁЯУе => ЁЯУе, рдЗрдирдмреЙрдХреНрд╕, рдкреНрд░рд╛рдкреНрдд рдЭрд╛рд▓реЗрд▓реЗ рдореЗрд▓, рдореЗрд▓, рдкреНрд░рд╛рдкреНрдд, рдмреЙрдХреНрд╕, рдЯреНрд░реЗ, рд╕рдВрд╡рд╛рдж
ЁЯУж => ЁЯУж, рдкрд╛рд░реНрд╕рд▓, рдмреЙрдХреНрд╕
ЁЯУл => ЁЯУл, рдореЗрд▓рдмреЙрдХреНрд╕, рдмрдВрдж, рдЙрдВрдЪрд╛рд╡рд▓реЗрд▓рд╛ рдзреНрд╡рдЬ рдЕрд╕рд▓реЗрд▓рд╛ рдореЗрд▓рдмреЙрдХреНрд╕, рдореЗрд▓, рдзреНрд╡рдЬ
ЁЯУк => ЁЯУк, рдореЗрд▓рдмреЙрдХреНрд╕ рдмрдВрдж, рд╡рд╛рдХрд▓реЗрд▓рд╛ рдзреНрд╡рдЬ рдЕрд╕рд▓реЗрд▓рд╛ рдореЗрд▓рдмреЙрдХреНрд╕, рдореЗрд▓, рдзреНрд╡рдЬ
ЁЯУм => ЁЯУм, рдореЗрд▓рдмреЙрдХреНрд╕, рдЦреБрд▓рд╛, рдЙрдВрдЪрд╛рд╡рд▓реЗрд▓рд╛ рдзреНрд╡рдЬ рдЕрд╕рд▓реЗрд▓рд╛ рдЦреБрд▓рд╛ рдореЗрд▓рдмреЙрдХреНрд╕, рдореЗрд▓ рдзреНрд╡рдЬ
ЁЯУн => ЁЯУн, рдореЗрд▓рдмреЙрдХреНрд╕, рдЦреБрд▓рд╛, рдЭреБрдХрд▓реЗрд▓рд╛ рдзреНрд╡рдЬ рдЕрд╕рд▓реЗрд▓рд╛ рдЦреБрд▓рд╛ рдореЗрд▓рдмреЙрдХреНрд╕, рдореЗрд▓ рдзреНрд╡рдЬ
ЁЯЧ│ => ЁЯЧ│, рдорддрдкрддреНрд░рд┐рдХрд╛, рдкреЗрдЯреА
тЬТ => тЬТ, рдирд┐рдм, рдкреЗрди
ЁЯЦЛ => ЁЯЦЛ, рд╢рд╛рдЗрдЪреЗ рдкреЗрди
ЁЯЦК => ЁЯЦК, рдмреЙрд▓рдкреЗрди
ЁЯЦМ => ЁЯЦМ, рд░рдВрдЧрд╡рд┐рдгреЗ
ЁЯЦН => ЁЯЦН, рд░рдВрдЧрд╛рдЪреНрдпрд╛ рдХрд╛рдбреАрдиреЗ рдХрд╛рдврд▓реЗрд▓реЗ рдЪрд┐рддреНрд░
ЁЯУЭ => ЁЯУЭ, рдореЗрдореЛ рдкреБрд╕реНрддрдХ, рд╕рдВрд╡рд╛рдж
ЁЯТ╝ => ЁЯТ╝, 
ЁЯУБ => ЁЯУБ, рдлрд╛рдЗрд▓ рдлреЛрд▓реНрдбрд░, рдлрд╛рдЗрд▓, рдлреЛрд▓реНрдбрд░
ЁЯУВ => ЁЯУВ, рдЙрдШрдбреЗ рдлреЛрд▓реНрдбрд░, рдЦреБрд▓реЗ рдлрд╛рдЗрд▓ рдлреЛрд▓реНрдбрд░, рдЦреБрд▓реЗ, рдлрд╛рдЗрд▓, рдлреЛрд▓реНрдбрд░
ЁЯЧВ => ЁЯЧВ, рдХрд╛рд░реНрдб, рд╡рд┐рднрд╛рдЬрди рдХрд░рдгрд╛рд░рд╛, рдЕрдиреБрдХреНрд░рдордгрд┐рдХрд╛
ЁЯУЕ => ЁЯУЕ, рджрд┐рдирджрд░реНрд╢рд┐рдХрд╛
ЁЯУЖ => ЁЯУЖ, рдлрд╛рдбрдгрд╛рд░реЗ рдХреЕрд▓реЗрдВрдбрд░, рдХреЕрд▓реЗрдВрдбрд░
ЁЯЧТ => ЁЯЧТ, рдЯреАрдк, рдкреЕрдб, рд╕реНрдкрд╛рдпрд░рд▓
ЁЯЧУ => ЁЯЧУ, рдХреЕрд▓реЗрдВрдбрд░, рдкреЕрдб, рд╕реНрдкрд╛рдпрд░рд▓
ЁЯУЗ => ЁЯУЗ, рдХрд╛рд░реНрдб рдирд┐рд░реНрджреЗрд╢рд╛рдВрдХ, рд░реЛрд▓реЛрдбреЗрдХреНрд╕, рдирд┐рд░реНрджреЗрд╢рд╛рдВрдХ
ЁЯУИ => ЁЯУИ, рд╡рд╛рдврддрд╛ рдмрд╛рдЬрд╛рд░рд╛рдЪрд╛ рдХрд▓, рд╡рд╛рдврддрд╛ рдмрд╛рдЬрд╛рд░рд╛рдЪрд╛ рдХрд▓ рдЕрд╕рд▓реЗрд▓рд╛ рдЪрд╛рд░реНрдЯ, рдЪрд╛рд░реНрдЯ, рдЖрд▓реЗрдЦ, рд╡рд╛рдврддрд╛
ЁЯУЙ => ЁЯУЙ, рдХрдореА рд╣реЛрдгрд╛рд░рд╛ рдХрд▓, рдХрдореА рд╣реЛрдгрд╛рд░рд╛ рдХрд▓рдЪрд╛ рдЪрд╛рд░реНрдЯ, рдЖрд▓реЗрдЦ, рдХрдореА рд╣реЛрдгрд╛рд░рд╛
ЁЯУК => ЁЯУК, рдмрд╛рд░ рдЖрд▓реЗрдЦ, рдЪрд╛рд░реНрдЯ
ЁЯУМ => ЁЯУМ, рдкрд┐рди
ЁЯУН => ЁЯУН, рдЧреЛрд▓ рдкреБрд╢рдкрд┐рди, рдкреБрд╢рдкрд┐рди, рдкрд┐рди
ЁЯУО => ЁЯУО, рдХреНрд▓рд┐рдк
ЁЯЦЗ => ЁЯЦЗ, рджреБрд╡рд╛, рдкреЗрдкрд░рдХреНрд▓рд┐рдк
ЁЯУП => ЁЯУП, рд╕рд░рд│ рд░реВрд▓рд░, рд░реВрд▓рд░
ЁЯУР => ЁЯУР, рддреНрд░рд┐рдХреЛрдгреА рд░реВрд▓рд░, рддреНрд░рд┐рдХреЛрдг, рд╕реЗрдЯ рд╕реНрдХреНрд╡реЗрдЕрд░, рд░реВрд▓рд░
тЬВ => тЬВ, рд╕рд╛рдзрди
ЁЯЧГ => ЁЯЧГ, рдмреЙрдХреНрд╕, рдХрд╛рд░реНрдб, рдлрд╛рдИрд▓
ЁЯЧД => ЁЯЧД, рдХрдкрд╛рдЯ, рдлрд╛рдИрд▓
ЁЯФТ => ЁЯФТ, рдмрдВрдж рдХреБрд▓реВрдк
ЁЯФУ => ЁЯФУ, рдХреБрд▓реВрдк
ЁЯФП => ЁЯФП, рдХреБрд▓реВрдк, рдЧреЛрдкрдиреАрдпрддрд╛, рд╢рд╛рдИрдЪреНрдпрд╛ рдкреЗрдирд╛рд╕рд╣ рдХреБрд▓реВрдк, рд╢рд╛рдИ рдкреЗрди
ЁЯФР => ЁЯФР, рдмрдВрдж рдХреБрд▓реВрдк, рдХрд┐рд▓реНрд▓реАрд╕рд╣ рдХреБрд▓реВрдк, рд╕реБрд░рдХреНрд╖рд┐рдд
ЁЯФС => ЁЯФС, рдХрд┐рд▓реНрд▓реА, рд╕рдВрдХреЗрддрд╢рдмреНрдж
ЁЯЧЭ => ЁЯЧЭ, рд╕рдВрдХреЗрдд, рдЪрд╛рд╡реА, рдХреБрд▓реВрдк, рдЬреБрдиреЗ
ЁЯФи => ЁЯФи, рд╕рд╛рдзрди
тЫП => тЫП, рд╢реЛрдзрдгреЗ, рд╕рд╛рдзрди
тЪТ => тЪТ, рд╣рд╛рддреЛрдбрд╛, рдкрд┐рдХ, рд╕рд╛рдзрди
ЁЯЫа => ЁЯЫа, рд╣рд╛рддреЛрдбрд╛, рд╕рд╛рдзрди, рдкрд╛рдирд╛
ЁЯФз => ЁЯФз, рд╕рд╛рдзрди
ЁЯФй => ЁЯФй, рдирдЯ-рдмреЛрд▓реНрдЯ, рдирдЯ, рдЦреАрд│, рд╕рд╛рдзрди
тЪЩ => тЪЩ, рд╕рд╛рдзрди
ЁЯЧЬ => ЁЯЧЬ, рд╕рд╛рдзрди, рдЙрдкрд╕рд╛рдзрди
тЪЧ => тЪЧ, рд░рд╕рд╛рдпрдирд╢рд╛рд╕реНрддреНрд░, рд╕рд╛рдзрди
тЪЦ => тЪЦ, рдиреНрдпрд╛рдп, рддреВрд│ рд░рд╛рд╢реА, рдорд╛рдкрди, рд╕рд╛рдзрди, рд╡рдЬрди, рд░рд╛рд╢реАрдЪрдХреНрд░рд╛рддреАрд▓ рд░рд╛рд╢реА
ЁЯФЧ => ЁЯФЧ, рджреБрд╡рд╛ рдЪрд┐рдиреНрд╣, рджреБрд╡реЗ, рджреЛрди рдЧреЛрд▓ рдХрдбреНрдпрд╛
ЁЯТЙ => ЁЯТЙ, рд╢реЙрдЯ, рдЗрдВрдЬрдХреНрд╢рди рджреЗрдгреЗ, рд╕реБрдИ, рдФрд╖рдз, рдбреЙрдХреНрдЯрд░
ЁЯТК => ЁЯТК, рдЧреЛрд│реА, рдФрд╖рдз, рдбреЙрдХреНрдЯрд░
ЁЯЧб => ЁЯЧб, рдЪрд╛рдХреВ, рд╣рддреНрдпрд╛рд░
ЁЯФк => ЁЯФк, рд╕реНрд╡рдпрдВрдкрд╛рдХрд╛рдЪрд╛ рдЪрд╛рдХреВ, рд╕реБрд░реА
тЪФ => тЪФ, рдПрдХрдореЗрдХрд╛рдВрд╡рд┐рд░реВрджреНрдз рдареЗрд╡рд▓реЗрд▓реЗ, рддрд▓рд╡рд╛рд░реА, рд╣рддреНрдпрд╛рд░
ЁЯФл => ЁЯФл, рдЧрди, рдкрд┐рд╕реНрддреВрд▓, рд░рд┐рд╡реНрд╣реЙрд▓реНрд╡реНрд╣рд░
ЁЯЫб => ЁЯЫб, рд╣рддреНрдпрд╛рд░
ЁЯП╣ => ЁЯП╣, рдмрд╛рдг, рдзрдиреБрд╖реНрдп, рдзрдиреБ рд░рд╛рд╢реА, рд╣рддреНрдпрд╛рд░
ЁЯПБ => ЁЯПБ, рдЪрд┐рддреНрд░рд╡рд┐рдЪрд┐рддреНрд░ рдзреНрд╡рдЬ, рдзреНрд╡рдЬ, рдЪреМрдХрдбреНрдпрд╛рдЪрд╛ рдзреНрд╡рдЬ, рд░реЗрд╕рд┐рдВрдЩ, рдХреНрд░рд┐рдбрд╛
ЁЯП│ => ЁЯП│, рддрд░рдВрдЧрдгрд╛рд░рд╛
ЁЯП┤ => ЁЯП┤, рддрд░рдВрдЧрдгрд╛рд░рд╛
ЁЯЪй => ЁЯЪй, рд╕реНрдерд╛рди рдзреНрд╡рдЬ, рд╕реНрдерд╛рди рдорд╛рд╣рд┐рддреА рдзреНрд╡рдЬ, рддреНрд░рд┐рдХреЛрдгреА рд╕реНрдерд╛рди рдзреНрд╡рдЬ, рдзреНрд╡рдЬ, рд╕реНрдерд╛рди
ЁЯЪм => ЁЯЪм, рдзреВрдореНрд░рдкрд╛рди рдЪрд┐рдиреНрд╣, рдзреВрдореНрд░рдкрд╛рди рдкрд░рд╡рд╛рдирдЧреА, рдЪрд┐рдиреНрд╣
тЪ░ => тЪ░, рдореГрддреНрдпреВ
тЪ▒ => тЪ▒, рдореГрддреНрдпреВ, рджрдлрдирд╡рд┐рдзреА
ЁЯЧ┐ => ЁЯЧ┐, рдореЛрдпрд╛рдИрдЪрд╛ рдкреБрддрд│рд╛, рдкреБрддрд│рд╛, рдореЛрдпрд╛рдИ
ЁЯЫв => ЁЯЫв, рдкрд┐рдВрдк, рддреЗрд▓
ЁЯФо => ЁЯФо, рдХреНрд░рд┐рд╕реНрдЯрд▓ рдмреЙрд▓, рднрд╡рд┐рд╖реНрдп рд╕рд╛рдВрдЧрдгреЗ, рдХреНрд░рд┐рд╕реНрдЯрд▓, рдЪреЗрдВрдбреВ, рднрд╡рд┐рд╖реНрдп
ЁЯПз => ЁЯПз, рдПрдЯреАрдПрдо, рдСрдЯреЛрдореЗрдЯреЗрдб рдЯреЗрд▓рд░, рд╕реНрд╡рдпрдВрдЪрд▓рд┐рдд, рдЯреЗрд▓рд░
ЁЯЪо => ЁЯЪо, рдХрдЪрд░рд╛ рддреНрдпрд╛рдЪреНрдпрд╛ рдЬрд╛рдЧреАрдЪ рдХрд░рд╛рд╡рд╛, рдХрдЪрд░рд╛рдкреЗрдЯреА, рдЪрд┐рдиреНрд╣
ЁЯЪ░ => ЁЯЪ░, рдкрд┐рдгреНрдпрд╛рдЪреЗ рдкрд╛рдгреА, рдкрд┐рдгреНрдпрд╛рдпреЛрдЧреНрдп рдкрд╛рдгреА, рдкрд┐рдгреНрдпрд╛рдЪреНрдпрд╛ рдкрд╛рдгреНрдпрд╛рдЪреЗ рдЪрд┐рдиреНрд╣
тЩ┐ => тЩ┐, рд╡реНрд╣реАрд▓рдЪреЗрдЕрд░рдЪрд╛ рдкреНрд░рд╡реЗрд╢, рд╡реНрд╣реАрд▓рдЪреЗрдЕрд░, рдкреНрд░рд╡реЗрд╢, рд╡реНрд╣реАрд▓рдЪреЗрдЕрд░ рдкреНрд░рддреАрдХ, рдЪрд┐рдиреНрд╣
ЁЯЪ╣ => ЁЯЪ╣, рдкреБрд░реБрд╖рд╛рдЪреЗ рдЪрд┐рдиреНрд╣, рдкреБрд░реБрд╖ рдкреНрд░рддреАрдХ, рдЪрд┐рдиреНрд╣, рдкреБрд░реВрд╖ рдкреНрд░рд╕рд╛рдзрдирдЧреГрд╣
ЁЯЪ║ => ЁЯЪ║, рдорд╣рд┐рд▓реЗрдЪреЗ рдЪрд┐рдиреНрд╣, рдорд╣рд┐рд▓реЗрдЪреА рдЦреЛрд▓реА, рдорд╣рд┐рд▓рд╛ рдкреНрд░рддреАрдХ, рдЪрд┐рдиреНрд╣, рд╕реНрддреНрд░реА рдкреНрд░рд╕рд╛рдзрдирдЧреГрд╣
ЁЯЪ╗ => ЁЯЪ╗, рд╡рд┐рд╢реНрд░рд╛рдордЧреГрд╣ рдЪрд┐рдиреНрд╣, рдкреНрд░рд╕рд╛рдзрдирдЧреГрд╣, рд╢реМрдЪрд╛рд▓рдп
ЁЯЪ╝ => ЁЯЪ╝, рдЧрд╛рдбреАрдордзреНрдпреЗ рдмрд╛рд│ рдЖрд╣реЗ, рдмрд╛рд│рд╛рдЪреЗ рдХрдкрдбреЗ рдмрджрд▓рдгреНрдпрд╛рдЪреЗ рд╕реНрдерд╛рди, рдмрд╛рд│
ЁЯЪ╛ => ЁЯЪ╛, рд╡реЙрдЯрд░ рдХреНрд▓реЛрд╕реЗрдЯ, WC, рд╡рд┐рд╢реНрд░рд╛рдордЧреГрд╣
ЁЯЫВ => ЁЯЫВ, рдкрд╛рд╕рдкреЛрд░реНрдЯ, рдирд┐рдпрдВрддреНрд░рдг
ЁЯЫГ => ЁЯЫГ, рд╕реАрдорд╛рд╢реБрд▓реНрдХ
ЁЯЫД => ЁЯЫД, рд╕рд╛рдорд╛рди рддрд╛рдмреНрдпрд╛рдд рдШреЗрдгреЗ, рд╕рд╛рдорд╛рди
ЁЯЫЕ => ЁЯЫЕ, рд╕реБрдЯрд▓реЗрд▓реЗ рд╕рд╛рдорд╛рди, рдмреЕрдЧ рд╕реЗрд╡рд╛, рд╕рд╛рдорд╛рди, рдмреЕрдЧ
тЪа => тЪа, рдЪреЗрддрд╛рд╡рдгреА рдЪрд┐рдиреНрд╣, рдЪрд┐рдиреНрд╣
ЁЯЪ╕ => ЁЯЪ╕, рд░рд╕реНрддрд╛ рдУрд▓рд╛рдВрдбрдгрд╛рд░реА рдореБрд▓реЗ, рдореБрд▓реЗ, рдУрд▓рд╛рдВрдбрдгреЗ, рдЪрд┐рдиреНрд╣
тЫФ => тЫФ, рдкреНрд░рд╡реЗрд╢ рдмрдВрдж рдЪрд┐рдиреНрд╣, рдкреНрд░рд╡реЗрд╢ рдирд╛рд╣реА, рдирд┐рд╖рд┐рджреНрдз, рдирд╛рд╣реА, рдЪрд┐рдиреНрд╣
ЁЯЪл => ЁЯЪл, рдкреНрд░рд╡реЗрд╢ рдирд┐рд╖рд┐рджреНрдз рдЪрд┐рдиреНрд╣, рдкреНрд░рд╡реЗрд╢ рдирд╛рд╣реА, рдЪрд┐рдиреНрд╣
ЁЯЪ│ => ЁЯЪ│, рджреБрдЪрд╛рдХреА рдирд╛рд╣реА, рд╕рд╛рдпрдХрд▓реАрдВрд╕рд╛рдареА рдирд╛рд╣реА, рд╕рд╛рдпрдХрд▓реАрд╕ рдкрд░рд╡рд╛рдирдЧреА рдирд╛рд╣реА, рджреБрдЪрд╛рдХреА, рд╡рд╛рд╣рди
ЁЯЪн => ЁЯЪн, рдзреВрдореНрд░рдкрд╛рди рдХрд░реВ рдирдпреЗ рдЪрд┐рдиреНрд╣, рдЪрд┐рдиреНрд╣
ЁЯЪп => ЁЯЪп, рдХрдЪрд░рд╛ рдХрд░реВ рдирдпреЗ рдЪрд┐рдиреНрд╣, рдХрдЪрд░рд╛ рдХрд░реВ рдирдХрд╛, рдХрдЪрд░рд╛ рдирд╛рд╣реА, рдЪрд┐рдиреНрд╣
ЁЯЪ▒ => ЁЯЪ▒, рдкрд┐рдгреНрдпрд╛рдЪреЗ рдкрд╛рдгреА рдирд╛рд╣реА, рдкрд╛рдгреА, рдкрд┐рдгреНрдпрд╛рдпреЛрдЧреНрдп рдирд╛рд╣реА
ЁЯЪ╖ => ЁЯЪ╖, рдкрд╛рджрдЪрд╛рд░реА рдирд╛рд╣реА, рдкрд╛рджрдЪрд╛рд▒реНрдпрд╛рдВрдирд╛ рдЕрдиреБрдорддреА рдирд╛рд╣реА, рдкрд╛рджрдЪрд╛рд░реА, рдЪрд╛рд▓рдгрд╛рд░реЗ, рдЪрд┐рдиреНрд╣
тмЖ => тмЖ, рдмрд╛рдг, рдорд╣рддреНрддрд╡рд╛рдЪреЗ, рджрд┐рд╢рд╛, рдЙрддреНрддрд░
тЖЧ => тЖЧ, рдмрд╛рдг, рджрд┐рд╢рд╛, рдЕрдВрддрд░реНрдЧрдд рдорд╣рддреНрддреНрд╡рд╛рдЪреЗ, рдЙрддреНрддрд░рдкреВрд░реНрд╡
тЮб => тЮб, рдмрд╛рдг, рдЕрдВрддрд░реНрдЧрдд рдорд╣рддреНрддреНрд╡рд╛рдЪреЗ, рджрд┐рд╢рд╛, рдкреВрд░реНрд╡
тЖШ => тЖШ, рдмрд╛рдг, рджрд┐рд╢рд╛, рдЕрдВрддрд░реНрдЧрдд рдорд╣рддреНрддреНрд╡рд╛рдЪреЗ, рджрдХреНрд╖рд┐рдгрдкреВрд░реНрд╡
тмЗ => тмЗ, рдмрд╛рдг, рдорд╣рддреНрддреНрд╡рд╛рдЪреЗ, рджрд┐рд╢рд╛, рдЦрд╛рд▓реА, рджрдХреНрд╖рд┐рдг
тЖЩ => тЖЩ, рдмрд╛рдг, рджрд┐рд╢рд╛, рдЕрдВрддрд░реНрдЧрдд рдорд╣рддреНрддреНрд╡рд╛рдЪреЗ, рджрдХреНрд╖рд┐рдгрдкрд╢реНрдЪрд┐рдо
тмЕ => тмЕ, рдмрд╛рдг, рдорд╣рддреНрддрд╡рд╛рдЪреЗ, рджрд┐рд╢рд╛, рдкрд╢реНрдЪрд┐рдо
тЖЦ => тЖЦ, рдмрд╛рдг, рджрд┐рд╢рд╛, рдЕрдВрддрд░реНрдЧрдд рдорд╣рддреНрддрд╡рд╛рдЪреЗ, рдЙрддреНрддрд░рдкрд╢реНрдЪрд┐рдо
тЖХ => тЖХ, рдмрд╛рдг
тЖФ => тЖФ, рдмрд╛рдг
тЖй => тЖй, рдмрд╛рдг
тЖк => тЖк, рдмрд╛рдг
тд┤ => тд┤, рдмрд╛рдг
тд╡ => тд╡, рдмрд╛рдг
ЁЯФГ => ЁЯФГ, рд░реАрд▓реЛрдб рдХрд░рд╛, рд░реАрд▓реЛрдб рдЪрд┐рдиреНрд╣, рдШрдбреНрдпрд╛рд│рд╛рдЪреНрдпрд╛ рджрд┐рд╢реЗрдиреЗ рдЙрднреЗ рдмрд╛рдг, рдмрд╛рдг
ЁЯФД => ЁЯФД, рдШрдбреНрдпрд╛рд│реНрдпрд╛рдЪреНрдпрд╛ рд╡рд┐рд░реБрджреНрдз рджрд┐рд╢реЗрдиреЗ рдмрд╛рдг, рдШрдбреНрдпрд╛рд│реНрдпрд╛рдЪреНрдпрд╛ рд╡рд┐рд░реБрджреНрдз рджрд┐рд╢реЗрдиреЗ, рдмрд╛рдг
ЁЯФЩ => ЁЯФЩ, рдкрд░рдд, рдбрд╛рд╡реНрдпрд╛ рдмрд╛рдгрд╛рд╕рд╣ рдкрд░рдд, рдмрд╛рдг рдкрд░рдд, рдбрд╛рд╡рд╛ рдмрд╛рдг, рдмрд╛рдг
ЁЯФЪ => ЁЯФЪ, рд╢реЗрд╡рдЯ, рд╢реЗрд╡рдЯ рдмрд╛рдг, рдбрд╛рд╡реНрдпрд╛ рдмрд╛рдгрд╛рд╕рд╣ рд╢реЗрд╡рдЯ, рдбрд╛рд╡рд╛ рдмрд╛рдг, рдмрд╛рдг
ЁЯФЫ => ЁЯФЫ, рдЪрд╛рд▓реВ рдмрд╛рдг, рдЙрджреНрдЧрд╛рд░рд╡рд╛рдЪрдХ рдЪрд┐рдиреНрд╣рд╛рд╕рд╣ рдЪрд╛рд▓реВ рдмрд╛рдг, рдмрд╛рдг, рдЙрджреНрдЧрд╛рд░рд╡рд╛рдЪрдХ рдЪрд┐рдиреНрд╣, рдЙрджреНрдЧрд╛рд░рд╡рд╛рдЪрдХ
ЁЯФЬ => ЁЯФЬ, рд▓рд╡рдХрд░рдЪ рдЪрд┐рдиреНрд╣, рд▓рд╡рдХрд░рдЪ, рдЙрдЬрд╡реНрдпрд╛ рдмрд╛рдгрд╛рд╕рд╣ рд▓рд╡рдХрд░рдЪ, рдмрд╛рдг
ЁЯФЭ => ЁЯФЭ, рд╢реАрд░реНрд╖ рдЪрд┐рдиреНрд╣, рд╢реАрд░реНрд╖, рд╡рд░ рдмрд╛рдгрд╛рд╕рд╣ рд╢реАрд░реНрд╖, рд╡рд░ рдмрд╛рдг, рд╡рд░
ЁЯЫР => ЁЯЫР, рдзрд░реНрдо, рдкреВрдЬрд╛
тЪЫ => тЪЫ, рдирд╛рд╕реНрддрд┐рдХ, рдЕрдгреБ
ЁЯХЙ => ЁЯХЙ, рд╣рд┐рдВрджреВ, рдзрд░реНрдо
тЬб => тЬб, рдбреЗрд╡реНрд╣рд┐рдб, рдЬреНрдпреВ, рдЬреНрдпреВрдЗрд╢, рдзрд░реНрдо, рддрд╛рд░рд╛
тШ╕ => тШ╕, рдмреБрджреНрдз рдзрд░реНрдорд╛рдЪреЗ, рдзрд░реНрдо, рдЪрдХреНрд░
тШп => тШп, рдзрд░реНрдо, рдЯрд╛рдУ, рдЯрд╛рдУрд╡рд╛рджреА, рдпрд╛рдВрдЧ, рдпрд┐рди
тЬЭ => тЬЭ, рдХреНрд░рд┐рд╢реНрдЪрди рдзрд░реНрдореАрдп, рдХреНрд░реЙрд╕, рдзрд░реНрдо
тШж => тШж, рдХреНрд░рд┐рд╢реНрдЪрди рдзрд░реНрдореАрдп, рдХреНрд░реЙрд╕, рдзрд░реНрдо
тШк => тШк, рдЗрд╕реНрд▓рд╛рдо, рдореБрд╕реНрд▓рд┐рдо, рдзрд░реНрдо
тШо => тШо, рд╢рд╛рдВрддреА
ЁЯХО => ЁЯХО, рдореЗрдгрдмрддреНрддреА рдареЗрд╡рд╛рдпрдЪреЗ рдШрд░, рдореЗрдгрдмрддреНрддреА, рдзрд░реНрдо
ЁЯФп => ЁЯФп, рд╖рдЯреНрдХреЛрдиреА рддрд╛рд░рд╛, рднрд╡рд┐рд╖реНрдп рд╕рд╛рдВрдЧрдгреЗ, рд╕рд╣рд╛ рдХреЛрдирд╛рдВрдЪрд╛, рддрд╛рд░рд╛, рднрд╡рд┐рд╖реНрдп
тЩ╗ => тЩ╗, рдкреБрдирд░реНрд╡рд╛рдкрд░рд╛рдЪреЗ рдкреНрд░рддреАрдХ, рдШрди рд╕рд╛рд░реНрд╡рддреНрд░рд┐рдХ рдкреБрдирд░реНрд╡рд╛рдкрд░рд╛рдЪреЗ рдкреНрд░рддреАрдХ, рдкреБрдирд░реНрд╡рд╛рдкрд░, рд╕рд╛рд░реНрд╡рддреНрд░рд┐рдХ, рдЪрд┐рдиреНрд╣, рд░рд┐рд╕рд╛рдпрдХрд▓рд┐рдВрдЧ
ЁЯУЫ => ЁЯУЫ, рдмрд┐рд▓реНрд▓рд╛, рдирд╛рд╡
ЁЯФ░ => ЁЯФ░, рд╣рд┐рд░рд╡реА рдЖрдгрд┐ рдкрд┐рд╡рд│реА рдкрд╛рдиреЗ, рд╣рд┐рд░рд╡реА рдЖрдгрд┐ рдкрд┐рд╡рд│реА, рдирд╡рд╢рд┐рдХреНрдпрд╛, рдЬрдкрд╛рдиреА
ЁЯФ▒ => ЁЯФ▒, рддреНрд░рд┐рд╢реВрд│ рдЪрд┐рдиреНрд╣, рдЕрдБрдХрд░, рддреНрд░рд┐рд╢реВрд▓, рдирд┐рд╢рд╛рдгреА
тнХ => тнХ, рд╡рд░реНрддреБрд│, o
тЬЕ => тЬЕ, рдЪреЗрдХ рдорд╛рд░реНрдХ, рдЪреЗрдХ
тШС => тШС, рдорддрдкрддреНрд░рд┐рдХрд╛, рдмреЙрдХреНрд╕, рдЪреЗрдХ
тЬФ => тЬФ, рдЪреЗрдХ, рдЪрд┐рдиреНрд╣
тЬЦ => тЬЦ, рд░рджреНрдж рдХрд░рд╛, рдЧреБрдгрд╛рдХрд╛рд░, рдЧреБрдгрд╛рдХрд╛рд░ рдХрд░рд╛, x
тЭМ => тЭМ, рдХреНрд░реЙрд╕ рдЪрд┐рдиреНрд╣, тАЬXтАЭ
тЭО => тЭО, рдЪреМрд░рд╕ рдордзреНрдпреЗ рдХреНрд░реЙрд╕ рдЪрд┐рдиреНрд╣, рдЪреМрд░рд╕ рдордзреАрд▓ тАЬXтАЭ
тЮХ => тЮХ, рдЕрдзрд┐рдХ, рдореЛрдареЗ рдЕрдзрд┐рдХ рдЪрд┐рдиреНрд╣, рдЕрдзрд┐рдХ рдЪрд┐рдиреНрд╣, рдЪрд┐рдиреНрд╣
тЮЦ => тЮЦ, рдЙрдгреЗ, рдореЛрдареЗ рд╡рдЬрд╛ рдЪрд┐рдиреНрд╣, рд╡рдЬрд╛ рдЪрд┐рдиреНрд╣, рдЪрд┐рдиреНрд╣
тЮЧ => тЮЧ, рднрд╛рдЧрд╛рдХрд╛рд░, рдореЛрдареЗ рднрд╛рдЧрд╛рдХрд╛рд░ рдЪрд┐рдиреНрд╣, рднрд╛рдЧрд╛рдХрд╛рд░ рдЪрд┐рдиреНрд╣, рдЪрд┐рдиреНрд╣
тЮ░ => тЮ░, рд▓рд╣рд░ рдЕрд╕рд▓реЗрд▓рд╛ рд▓реВрдк, рдореЛрдб, рд▓реВрдк
тЮ┐ => тЮ┐, рджреБрд╣реЗрд░реА рд▓рд╣рд░ рдЕрд╕рд▓реЗрд▓рд╛ рд▓реВрдк, рдЬрдкрд╛рди, рд╡рд┐рдирд╛рдореВрд▓реНрдп рдбрд╛рдпрд▓
уА╜ => уА╜, рдЪрд┐рдиреНрд╣, рдкрд╛рд░реНрдЯ
тЬ│ => тЬ│, рдлреБрд▓реА, рддрд╛рд░рд╛
тЬ┤ => тЬ┤, рддрд╛рд░рд╛
ЁЯТ▒ => ЁЯТ▒, рдЪрд▓рди, рдкреИрд╕рд╛, рд╡рд┐рдирд┐рдордп
ЁЯТ▓ => ЁЯТ▓, рдбреЙрд▓рд░ рдЪрд┐рдиреНрд╣, рдард│рдХ рдбреЙрд▓рд░ рдЪрд┐рдиреНрд╣, рдбреЙрд▓рд░, рдкреИрд╕рд╛
тА╝ => тА╝, рдзреБрдорд╛рдХреВрд│, рдЙрджреНрдЧрд╛рд░рд╡рд╛рдЪрдХ рдЪрд┐рдиреНрд╣, рдЪрд┐рдиреНрд╣, рд╡рд┐рд░рд╛рдордЪрд┐рдиреНрд╣
тБЙ => тБЙ, рдЙрджреНрдЧрд╛рд░рд╡рд╛рдЪрдХ, рд╡рд┐рд░рд╛рдордЪрд┐рдиреНрд╣, рдЪрд┐рдиреНрд╣, рдкреНрд░рд╢реНрди
тЭУ => тЭУ, рдкреНрд░рд╢реНрди рдЪрд┐рдиреНрд╣, рдкреНрд░рд╢реНрди, рднрд░реАрд╡ рдкреНрд░рд╢реНрди рдЪрд┐рдиреНрд╣, рд╡рд┐рд░рд╛рдордЪрд┐рдиреНрд╣
тЭФ => тЭФ, рдкреЛрдХрд│ рдкреНрд░рд╢реНрди рдЪрд┐рдиреНрд╣, рдкреНрд░рд╢реНрди, рдкреНрд░рд╢реНрди рдЪрд┐рдиреНрд╣, рд╡рд┐рд░рд╛рдордЪрд┐рдиреНрд╣
тЭХ => тЭХ, рдкреЛрдХрд│ рдЙрджреНрдЧрд╛рд░рд╡рд╛рдЪрдХ рдЪрд┐рдиреНрд╣, рдЙрджреНрдЧрд╛рд░, рдЙрджреНрдЧрд╛рд░рд╡рд╛рдЪрдХ рдЪрд┐рдиреНрд╣, рд╡рд┐рд░рд╛рдордЪрд┐рдиреНрд╣
тЭЧ => тЭЧ, рдкреЛрдХрд│ рдЙрджреНрдЧрд╛рд░рд╡рд╛рдЪрдХ рдЪрд┐рдиреНрд╣, рд╡рд┐рд░рд╛рдордЪрд┐рдиреНрд╣
уА░ => уА░, рджреАрд░реНрдШ рдЖрд╡рд╛рдЬ рдЪрд┐рдиреНрд╣, рдирд╛рдЧрдореЛрдбреА, рдбреЕрд╢, рд╡рд┐рд░рд╛рдордЪрд┐рдиреНрд╣
┬й => ┬й, рдХреЙрдкреАрд░рд╛рдЗрдЯ
┬о => ┬о, рдиреЛрдВрджрдгреАрдХреГрдд
тДв => тДв, рдЯреНрд░реЗрдбрдорд╛рд░реНрдХ рдЪрд┐рдиреНрд╣, рдЪрд┐рдиреНрд╣
тЩИ => тЩИ, рдореЗрд╖, рд░рд╛рд╢реА
тЩЙ => тЩЙ, рд╡реГрд╖рдн, рд░рд╛рд╢реА
тЩК => тЩК, рдорд┐рдереВрди, рд░рд╛рд╢реА
тЩЛ => тЩЛ, рдХрд░реНрдХ, рд░рд╛рд╢реА
тЩМ => тЩМ, рд╕рд┐рдВрд╣ рд░рд╛рд╢реА
тЩН => тЩН, рдХрдиреНрдпрд╛, рд░рд╛рд╢реА
тЩО => тЩО, рддреВрд│, рд░рд╛рд╢реА
тЩП => тЩП, рд╡реГрд╢реНрдЪрд┐рдХ рд░рд╛рд╢реА
тЩР => тЩР, рдзрдиреБ, рд░рд╛рд╢реА
тЩС => тЩС, рдордХрд░, рд░рд╛рд╢реА
тЩТ => тЩТ, рдХреБрдВрдн, рд░рд╛рд╢реА
тЩУ => тЩУ, рдореАрди, рд░рд╛рд╢реА
тЫО => тЫО, рдирд╛рдЧрдореЛрдбреА, рд╕рд╛рдк, рд░рд╛рд╢реА
ЁЯФА => ЁЯФА, рдХреНрд░реЙрд╕ рдХрд░рдгрд╛рд░реЗ рдмрд╛рдг, рдХреНрд░реЙрд╕ рдХрд░рдгрд╛рд░реЗ рдЙрдЬрд╡реЗ рдмрд╛рдг, рдмрд╛рдг
ЁЯФБ => ЁЯФБ, рдШрдбреНрдпрд╛рд│рд╛рдЪреНрдпрд╛ рджрд┐рд╢реЗрдиреЗ рдмрд╛рдг, рдШрдбреНрдпрд╛рд│рд╛рдЪреНрдпрд╛ рджрд┐рд╢реЗрдиреЗ, рдмрд╛рдг
ЁЯФВ => ЁЯФВ, рдШрдбреНрдпрд╛рд│рд╛рдЪреНрдпрд╛ рджрд┐рд╢реЗрдиреЗ рдмрд╛рдг, 1 рдЕрдВрдХрд╛рд╕рд╣ рдШрдбреНрдпрд╛рд│рд╛рдЪреНрдпрд╛ рджрд┐рд╢реЗрдиреЗ, рдмрд╛рдг, рдШрдбреНрдпрд╛рд│рд╛рдЪреНрдпрд╛ рджрд┐рд╢реЗрдиреЗ, 1 рдЕрдВрдХ
тЦ╢ => тЦ╢, рдмрд╛рдг, рдкреНрд▓реЗ рдХрд░рд╛, рдЙрдЬрд╡рд╛, рддреНрд░рд┐рдХреЛрдг
тПй => тПй, рдлрд╛рд╕реНрдЯ рдлреЙрд░рд╡рд░реНрдб, рджреБрд╣реЗрд░реА рдЙрдЬрд╡рд╛ рдмрд╛рдг, рдЙрдЬрд╡рд╛, рдмрд╛рдг
тПн => тПн, рдмрд╛рдг, рдкреБрдвреАрд▓ рджреЗрдЦрд╛рд╡рд╛, рдкреБрдвреАрд▓ рдЯреНрд░реЕрдХ, рддреНрд░рд┐рдХреЛрдг
тПп => тПп, рдмрд╛рдг, рд╡рд┐рд░рд╛рдо рджреНрдпрд╛, рдкреНрд▓реЗ рдХрд░рд╛, рдЙрдЬрд╡рд╛, рддреНрд░рд┐рдХреЛрдг
тЧА => тЧА, рдмрд╛рдг, рдбрд╛рд╡рд╛, рдорд╛рдЧреЗ рдиреНрдпрд╛, рддреНрд░рд┐рдХреЛрдг
тПк => тПк, рд░рд┐рд╡рд╛рдЗрдВрдб, рджреБрд╣реЗрд░реА рдбрд╛рд╡рд╛ рдмрд╛рдг, рдбрд╛рд╡рд╛, рдмрд╛рдг
тПо => тПо, рдмрд╛рдг, рдорд╛рдЧреАрд▓ рд╕реАрди, рдорд╛рдЧреАрд▓ рдЯреНрд░реЕрдХ, рддреНрд░рд┐рдХреЛрдг
ЁЯФ╝ => ЁЯФ╝, рд╡рд░ рддреНрд░рд┐рдХреЛрдг, рд╡рд░ рддреНрд░рд┐рдХреЛрдг рдмрдЯрдг, рддреНрд░рд┐рдХреЛрдг, рдмрдЯрдг
тПл => тПл, рд╡рд░ рдмрд╛рдг, рджреБрд╣реЗрд░реА рд╡рд░ рдмрд╛рдг, рд╡рд░, рдмрд╛рдг
ЁЯФ╜ => ЁЯФ╜, рдЦрд╛рд▓реА рддреНрд░рд┐рдХреЛрдг, рдЦрд╛рд▓реА рддреНрд░рд┐рдХреЛрдг рдмрдЯрдг, рддреНрд░рд┐рдХреЛрдг, рдмрдЯрдг
тПм => тПм, рдЦрд╛рд▓реА рдмрд╛рдг, рджреБрд╣реЗрд░реА рдЦрд╛рд▓реА рдмрд╛рдг, рдЦрд╛рд▓реА, рдмрд╛рдг
тП╕ => тП╕, рдмрд╛рд░, рджреЛрдирджрд╛, рдЦрд╛рд▓реА
тП╣ => тП╣, рдЪреМрд░рд╕, рдерд╛рдВрдмрд╡рд╛
тП║ => тП║, рд╡рд░реНрддреГрд│, рд░реЗрдХреЙрд░реНрдб
тПП => тПП, рдмрд╛рд╣реЗрд░ рдХрд╛рдврд╛
ЁЯОж => ЁЯОж, рдЪрд┐рддреНрд░рдкрдЯ, рдЪрд┐рддреНрд░рдкрдЯ рдЪрд┐рдиреНрд╣, рдордиреЛрд░рдВрдЬрди
ЁЯФЕ => ЁЯФЕ, рдХрдореА рдЪрдордХ, рдХрдореА, рдордВрдж, рдХрдореА рдЪрдордХ рдЪрд┐рдиреНрд╣, рдЪрдордХ
ЁЯФЖ => ЁЯФЖ, рдЙрдЪреНрдЪ рдЪрдордХ, рддреЗрдЬрд╕реНрд╡реА, рдЙрдЪреНрдЪ рдЪрдордХ рдЪрд┐рдиреНрд╣, рдЪрдордХ
ЁЯУ╢ => ЁЯУ╢, рдореЛрдмрд╛рдЗрд▓ рд╕рд┐рдЧреНрдирд▓, рдмрд╛рд░ рд╕рд╣ рд╕реНрдкрд░реНрд╢рд╛, рдЕрдБрдЯреЗрдирд╛, рд╢рдХреНрддреА, рд╕рд┐рдЧреНрдирд▓, рд╕реНрдкрд░реНрд╢рд╛, рдореЛрдмрд╛рдИрд▓, рдлреЛрди рд╕рд┐рдЧреНрдирд▓
ЁЯУ╡ => ЁЯУ╡, рд╕реЗрд▓ рдлреЛрди рдирд┐рд╖рд┐рджреНрдз, рдХреЙрд▓ рдирд╛рд╣реА, рдореЛрдмрд╛рдИрд▓, рдлреЛрди
ЁЯУ│ => ЁЯУ│, рдХрдВрдк рдореЛрдб, рд╕реЗрд▓ рдлреЛрди, рдореЛрдмрд╛рдИрд▓, рдлреЛрди, рдореЛрдб
ЁЯУ┤ => ЁЯУ┤, рдлреЛрди рдмрдВрдж, рд╕реЗрд▓ рдлреЛрди рдмрдВрдж, рд╕реЗрд▓ рдлреЛрди, рдореЛрдмрд╛рдИрд▓, рдлреЛрди, рдмрдВрдж
#тГг => #тГг, рд╣реЕрд╢, рдкрд╛рдЙрдВрдб
*тГг => *тГг, рдЪрд╛рдВрджрдгреА
0тГг => 0тГг, рдХреАрдХреЕрдк рдЕрдВрдХ, рд╢реБрдиреНрдп
1тГг => 1тГг, 1, рдХреАрдХреЕрдк рдЕрдВрдХ, рдПрдХ
2тГг => 2тГг, 2, рдХреАрдХреЕрдк рдЕрдВрдХ, рджреЛрди
3тГг => 3тГг, 3, рдХреАрдХреЕрдк рдЕрдВрдХ, рддреАрди
4тГг => 4тГг, 4, рдХреАрдХреЕрдк рдЕрдВрдХ, рдЪрд╛рд░
5тГг => 5тГг, 5, рдХреАрдХреЕрдк рдЕрдВрдХ, рдкрд╛рдЪ
6тГг => 6тГг, 6, рдХреАрдХреЕрдк рдЕрдВрдХ, рд╕рд╣рд╛
7тГг => 7тГг, 7, рдХреАрдХреЕрдк рдЕрдВрдХ, рд╕рд╛рдд
8тГг => 8тГг, 8, рдХреАрдХреЕрдк рдЕрдВрдХ, рдЖрда
9тГг => 9тГг, 9
ЁЯФЯ => ЁЯФЯ, 10, рдХрд┐рдХреЕрдк, рджрд╣рд╛
ЁЯТп => ЁЯТп, рдкреВрд░реНрдг рдзрд╛рд╡рд╛, 100 рдЧреБрдг, 100, рдЧреБрдг
ЁЯФЮ => ЁЯФЮ, 18 рд╡рд░реНрд╖рд╛рдЦрд╛рд▓реАрд▓ рдкреНрд░рддрд┐рдмрдВрдзрд┐рдд, 18 рд╡рд░реНрд╖рд╛рдЦрд╛рд▓реАрд▓, 18
ЁЯФа => ЁЯФа, рдЕрдкреНрдкрд░рдХреЗрд╕ рд╡рд░реНрдг, рд▓реЕрдЯрд┐рди рдЕрдкреНрдкрд░рдХреЗрд╕ рдЗрдирдкреБрдЯ, рдЕрдкреНрдкрд░рдХреЗрд╕ рд▓реЕрдЯрд┐рди, рдЕрдкреНрдкрд░рдХреЗрд╕, рд▓реЕрдЯрд┐рди
ЁЯФб => ЁЯФб, рд▓реЛрдЕрд░рдХреЗрд╕ рдЕрдХреНрд╖рд░реЗ, рдЗрдирдкреБрдЯ рд▓реЛрдЕрд░рдХреЗрд╕ рд▓реЕрдЯрд┐рди, рд▓реЛрдЕрд░рдХреЗрд╕ рд▓реЕрдЯрд┐рди, рд▓реЛрдЕрд░рдХреЗрд╕, рд▓реЕрдЯрд┐рди
ЁЯФв => ЁЯФв, рдХреНрд░рдорд╛рдВрдХ, рдЗрдирдкреБрдЯ рдХреНрд░рдорд╛рдВрдХ
ЁЯФг => ЁЯФг, рдкреНрд░рддреАрдХ, рдЗрдирдкреБрдЯ рдкреНрд░рддреАрдХ
ЁЯФд => ЁЯФд, рд▓реЕрдЯрд┐рди рд╡рд░реНрдгрдорд╛рд▓рд╛, рдЗрдирдкреБрдЯ рд▓реЕрдЯрд┐рди рд╡рд░реНрдгрдорд╛рд▓рд╛, рд▓реЕрдЯрд┐рди, рдЗрдВрдЧреНрд░рдЬреА, ABC
ЁЯЕ░ => ЁЯЕ░, рд░рдХреНрддрд╛рдЪрд╛ рдкреНрд░рдХрд╛рд░ A, рдкреНрд░рдХрд╛рд░ A, рд░рдХреНрддрд╛рдЪрд╛ рдкреНрд░рдХрд╛рд░, рд░рдХреНрдд, A
ЁЯЖО => ЁЯЖО, рд░рдХреНрддрд╛рдЪрд╛ рдкреНрд░рдХрд╛рд░ AB, рдкреНрд░рдХрд╛рд░ AB, рд░рдХреНрддрд╛рдЪрд╛ рдкреНрд░рдХрд╛рд░, рд░рдХреНрдд, AB
ЁЯЕ▒ => ЁЯЕ▒, рд░рдХреНрддрд╛рдЪрд╛ рдкреНрд░рдХрд╛рд░ B, рдкреНрд░рдХрд╛рд░ B, рд░рдХреНрддрд╛рдЪрд╛ рдкреНрд░рдХрд╛рд░, рд░рдХреНрдд, B
ЁЯЖС => ЁЯЖС, CL, рд╕рд╛рдл рдХрд░рд╛, CL рдЪреЗ рдЪрд┐рдиреНрд╣
ЁЯЖТ => ЁЯЖТ, рдЫрд╛рди, рдЫрд╛рдирдЪреЗ рдЪрд┐рдиреНрд╣
ЁЯЖУ => ЁЯЖУ, рд╡рд┐рдирд╛рдореВрд▓реНрдп, рд╡рд┐рдирд╛рдореВрд▓реНрдп рдЪрд┐рдиреНрд╣, рдирд┐:рд╢реБрд▓реНрдХ, рдЪрд┐рдиреНрд╣, рдлреБрдХрдЯ
тД╣ => тД╣, рдорд╛рд╣рд┐рддреА
ЁЯЖФ => ЁЯЖФ, ID, ID рдЪрд┐рдиреНрд╣, рдУрд│рдЦ, рдЪрд┐рдиреНрд╣
тУВ => тУВ, рд╡рд░реНрддреБрд│, рдореЛрдареЗ рд╡рд░реНрддреБрд│
ЁЯЖХ => ЁЯЖХ, рдирд╡реАрди, рдирд╡реАрди рдЪрд┐рдиреНрд╣, рдЪрд┐рдиреНрд╣
ЁЯЖЦ => ЁЯЖЦ, NG, NG рдЪрд┐рдиреНрд╣, рдЪрд┐рдиреНрд╣
ЁЯЕ╛ => ЁЯЕ╛, рд░рдХреНрддрд╛рдЪрд╛ рдкреНрд░рдХрд╛рд░ O, рдкреНрд░рдХрд╛рд░ O, рд░рдХреНрддрд╛рдЪрд╛ рдкреНрд░рдХрд╛рд░, рд░рдХреНрдд, O
ЁЯЖЧ => ЁЯЖЧ, OK, OK рдЪрд┐рдиреНрд╣
ЁЯЕ┐ => ЁЯЕ┐, рдкрд╛рд░реНрдХрд┐рдВрдЧ, рдкрд╛рд░реНрдХрд┐рдВрдЧ рд╕реНрдерд╛рди
ЁЯЖШ => ЁЯЖШ, SOS, SOS рдЪрд┐рдиреНрд╣, рдорджрдд, рдЪрд┐рдиреНрд╣
ЁЯЖЩ => ЁЯЖЩ, UP!, UP! рдЪрд┐рдиреНрд╣, рдЪрд┐рдиреНрд╣
ЁЯЖЪ => ЁЯЖЪ, рд╡рд┐рд░реБрджреНрдз, рд╡рд┐, рд╡рд┐ рдЪрд┐рдиреНрд╣, рдЪрд┐рдиреНрд╣
ЁЯИБ => ЁЯИБ, рдЬрдкрд╛рдиреА рд╢рдмреНрдж
ЁЯИВ => ЁЯИВ, рдЬрдкрд╛рдиреА рд╢рдмреНрдж
ЁЯИ╖ => ЁЯИ╖, рдЬрдкрд╛рдиреА рд╢рдмреНрдж
ЁЯИ╢ => ЁЯИ╢, рдЬрдкрд╛рдиреА рд╢рдмреНрдж
ЁЯИп => ЁЯИп, рдЬрдкрд╛рдиреА рд╢рдмреНрдж
ЁЯЙР => ЁЯЙР, рдЬрдкрд╛рдиреА рд╢рдмреНрдж
ЁЯИ╣ => ЁЯИ╣, рдЬрдкрд╛рдиреА рд╢рдмреНрдж
ЁЯИЪ => ЁЯИЪ, рдЬрдкрд╛рдиреА рд╢рдмреНрдж
ЁЯИ▓ => ЁЯИ▓, рдЬрдкрд╛рдиреА рд╢рдмреНрдж
ЁЯЙС => ЁЯЙС, рдЪреАрдиреА рд╢рдмреНрдж
ЁЯИ╕ => ЁЯИ╕, рдЪреАрдиреА рд╢рдмреНрдж
ЁЯИ┤ => ЁЯИ┤, рдЪреАрдиреА рд╢рдмреНрдж
ЁЯИ│ => ЁЯИ│, рдЪреАрдиреА рд╢рдмреНрдж
уКЩ => уКЩ, рдЪреАрдиреА рд╢рдмреНрдж, рд╕рдВрдХреЗрдд, рдЧреБрдкрд┐рдд
ЁЯИ║ => ЁЯИ║, рдЪреАрдиреА рд╢рдмреНрдж
ЁЯИ╡ => ЁЯИ╡, рдЪреАрдиреА рд╢рдмреНрдж
тЦк => тЦк, рднреВрдорд┐рддреАрдп, рдЪреМрд░рд╕, рдЪреМрдХреЛрди
тЦл => тЦл, рднреВрдорд┐рддреАрдп, рдЪреМрд░рд╕, рдЪреМрдХреЛрди
тЧ╗ => тЧ╗, рднреВрдорд┐рддреАрдп, рдЪреМрд░рд╕, рдЪреМрдХреЛрди
тЧ╝ => тЧ╝, рднреВрдорд┐рддреАрдп, рдЪреМрд░рд╕, рдЪреМрдХреЛрди
тЧ╜ => тЧ╜, рднреВрдорд┐рддреАрдп, рдЪреМрд░рд╕, рдЪреМрдХреЛрди
тЧ╛ => тЧ╛, рднреВрдорд┐рддреАрдп, рдЪреМрд░рд╕, рдЪреМрдХреЛрди
тмЫ => тмЫ, рднреВрдорд┐рддреАрдп, рдЪреМрд░рд╕, рдЪреМрдХреЛрди
тмЬ => тмЬ, рднреВрдорд┐рддреАрдп, рдЪреМрд░рд╕, рдЪреМрдХреЛрди
ЁЯФ╢ => ЁЯФ╢, рдореЛрдард╛ рд╣рд┐рд░рд╛, рдореЛрдард╛ рдирд╛рд░рдВрдЧреА рд╣рд┐рд░рд╛, рдбрд╛рдпрдордВрдб, рдирд╛рд░рдВрдЧреА, рд╣рд┐рд░рд╛
ЁЯФ╖ => ЁЯФ╖, рдореЛрдард╛ рд╣рд┐рд░рд╛, рдореЛрдард╛ рдирд┐рд│рд╛ рд╣рд┐рд░рд╛, рдирд┐рд│рд╛, рд╣рд┐рд░рд╛
ЁЯФ╕ => ЁЯФ╕, рд▓рд╣рд╛рди рд╣рд┐рд░рд╛, рд▓рд╣рд╛рди рдирд╛рд░рдВрдЧреА рд╣рд┐рд░рд╛, рдбрд╛рдпрдордВрдб, рдирд╛рд░рдВрдЧреА, рд╣рд┐рд░рд╛
ЁЯФ╣ => ЁЯФ╣, рд▓рд╣рд╛рди рд╣рд┐рд░рд╛, рд▓рд╣рд╛рди рдмреНрд▓реНрдпреВ рдбрд╛рдпрдордВрдб, рдирд┐рд│рд╛, рд╣рд┐рд░рд╛
ЁЯФ║ => ЁЯФ║, рд╡рд░ рддреНрд░рд┐рдХреЛрдг, рд╡рд░ рд▓рд╛рд▓ рддреНрд░рд┐рдХреЛрдг, рд▓рд╛рд▓, рддреНрд░рд┐рдХреЛрдг
ЁЯФ╗ => ЁЯФ╗, рдЦрд╛рд▓реА рддреНрд░рд┐рдХреЛрдг, рдЦрд╛рд▓реА рд▓рд╛рд▓ рддреНрд░рд┐рдХреЛрдг, рд▓рд╛рд▓, рддреНрд░рд┐рдХреЛрдг
ЁЯТа => ЁЯТа, рдлреВрд▓ рдкрд╛рдХрд│реА, рдЧреЛрдВрдбрд╕, рдлреВрд▓, рд╣рд┐рд▒реНрдпрд╛рдЪрд╛ рдЖрдХрд╛рд░. рд╣рд┐рд░реЗ
ЁЯФШ => ЁЯФШ, рдмрдЯрдг, рд░реЗрдбрд┐рдУ
ЁЯФ▓ => ЁЯФ▓, рдЪреМрд░рд╕ рдмрдЯрдг, рдЪреМрд░рд╕, рдмрдЯрдг
ЁЯФ│ => ЁЯФ│, рдЪреМрд░рд╕ рдмрдЯрдг, рдЪреМрд░рд╕, рдмрдЯрдг
тЪк => тЪк, рд╡рд░реНрддреБрд│, рдореЛрдареЗ рд╡рд░реНрддреБрд│
тЪл => тЪл, рд╡рд░реНрддреБрд│, рдореЛрдареЗ рд╡рд░реНрддреБрд│
ЁЯФ┤ => ЁЯФ┤, рдореЛрдареЗ рд╡рд░реНрддреБрд│, рдореЛрдареЗ рд▓рд╛рд▓ рд╡рд░реНрддреБрд│, рд▓рд╛рд▓, рд╡рд░реНрддреБрд│
ЁЯФ╡ => ЁЯФ╡, рдореЛрдареЗ рд╡рд░реНрддреБрд│, рдореЛрдареЗ рдирд┐рд│реЗ рд╡рд░реНрддреБрд│, рдирд┐рд│реЗ, рд╡рд░реНрддреБрд│

ЁЯЗжЁЯЗи => ЁЯЗжЁЯЗи, рдЕтАНреЕрд╕реЗрдиреНрд╢рд┐рдпрди рдмреЗрдЯ
ЁЯЗжЁЯЗй => ЁЯЗжЁЯЗй, рдЕрдБрдбреЛрд░рд╛
ЁЯЗжЁЯЗк => ЁЯЗжЁЯЗк, рд╕рдВрдпреБрдХреНрдд рдЕрд░рдм рдЕрдореАрд░рд╛рдд
ЁЯЗжЁЯЗл => ЁЯЗжЁЯЗл, рдЕрдлрдЧрд╛рдгрд┐рд╕реНрддрд╛рди
ЁЯЗжЁЯЗм => ЁЯЗжЁЯЗм, рдЕрдБрдЯрд┐рдЧреНрд╡рд╛ рдЖрдгрд┐ рдмрд░реНрдмреБрдбрд╛
ЁЯЗжЁЯЗо => ЁЯЗжЁЯЗо, рдЕрдБрдЧреНрд╡рд┐рд▓рд╛
ЁЯЗжЁЯЗ▒ => ЁЯЗжЁЯЗ▒, рдЕрд▓реНрдмрд╛рдирд┐рдпрд╛
ЁЯЗжЁЯЗ▓ => ЁЯЗжЁЯЗ▓, рдЕрд░реНрдореЗрдирд┐рдпрд╛
ЁЯЗжЁЯЗ┤ => ЁЯЗжЁЯЗ┤, рдЕрдВрдЧреЛрд▓рд╛
ЁЯЗжЁЯЗ╢ => ЁЯЗжЁЯЗ╢, рдЕрдВрдЯрд╛рд░реНрдХреНрдЯрд┐рдХрд╛
ЁЯЗжЁЯЗ╖ => ЁЯЗжЁЯЗ╖, рдЕрд░реНрдЬреЗрдВрдЯрд┐рдирд╛
ЁЯЗжЁЯЗ╕ => ЁЯЗжЁЯЗ╕, рдЕрдореЗрд░рд┐рдХрди рд╕рд╛рдореЛрдЖ
ЁЯЗжЁЯЗ╣ => ЁЯЗжЁЯЗ╣, рдСрд╕реНрдЯреНрд░рд┐рдпрд╛
ЁЯЗжЁЯЗ║ => ЁЯЗжЁЯЗ║, рдСрд╕реНрдЯреНрд░реЗрд▓рд┐рдпрд╛
ЁЯЗжЁЯЗ╝ => ЁЯЗжЁЯЗ╝, рдЕрд░реБрдмрд╛
ЁЯЗжЁЯЗ╜ => ЁЯЗжЁЯЗ╜, рдЕтАНреЕрд▓рдБрдб рдмреЗрдЯреЗ
ЁЯЗжЁЯЗ┐ => ЁЯЗжЁЯЗ┐, рдЕрдЭрд░рдмреИрдЬрд╛рди
ЁЯЗзЁЯЗж => ЁЯЗзЁЯЗж, рдмреЛрд╕реНрдирд┐рдпрд╛ рдЕрдгрд┐ рд╣рд░реНрдЬреЗрдЧреЛрд╡рд┐рдирд╛
ЁЯЗзЁЯЗз => ЁЯЗзЁЯЗз, рдмрд╛рд░реНрдмрд╛рдбреЛрд╕
ЁЯЗзЁЯЗй => ЁЯЗзЁЯЗй, рдмрд╛рдВрдЧрд▓рд╛рджреЗрд╢
ЁЯЗзЁЯЗк => ЁЯЗзЁЯЗк, рдмреЗрд▓реНрдЬрд┐рдпрдо
ЁЯЗзЁЯЗл => ЁЯЗзЁЯЗл, рдмреБрд░реНрдХрд┐рдирд╛ рдлрд╛рд╕реЛ
ЁЯЗзЁЯЗм => ЁЯЗзЁЯЗм, рдмрд▓реНрдЧреЗрд░рд┐рдпрд╛
ЁЯЗзЁЯЗн => ЁЯЗзЁЯЗн, рдмрд╣рд╛рд░реАрди
ЁЯЗзЁЯЗо => ЁЯЗзЁЯЗо, рдмреБрд░реБрдВрдбреА
ЁЯЗзЁЯЗп => ЁЯЗзЁЯЗп, рдмреЗрдирд┐рди
ЁЯЗзЁЯЗ▒ => ЁЯЗзЁЯЗ▒, рд╕реЗрдВрдЯ рдмрд╛рд░реНрдереЗрд▓реЗрдореА
ЁЯЗзЁЯЗ▓ => ЁЯЗзЁЯЗ▓, рдмрд░реНрдореБрдбрд╛
ЁЯЗзЁЯЗ│ => ЁЯЗзЁЯЗ│, рдмреНрд░реБрдиреЗрдИ
ЁЯЗзЁЯЗ┤ => ЁЯЗзЁЯЗ┤, рдмреЛрд▓рд┐рд╡реНрд╣рд┐рдпрд╛
ЁЯЗзЁЯЗ╢ => ЁЯЗзЁЯЗ╢, рдХреЕрд░рд┐рдмрд┐рдпрди рдиреЗрджрд░рд▓рдБрдбреНрд╕
ЁЯЗзЁЯЗ╖ => ЁЯЗзЁЯЗ╖, рдмреНрд░рд╛рдЭрд┐рд▓
ЁЯЗзЁЯЗ╕ => ЁЯЗзЁЯЗ╕, рдмрд╣рд╛рдорд╛рдЬ
ЁЯЗзЁЯЗ╣ => ЁЯЗзЁЯЗ╣, рднреВрддрд╛рди
ЁЯЗзЁЯЗ╗ => ЁЯЗзЁЯЗ╗, рдмреЛрдЙрд╡реЗрдЯ рдмреЗрдЯ
ЁЯЗзЁЯЗ╝ => ЁЯЗзЁЯЗ╝, рдмреЛрдЯреНрд╕рд╡рд╛рдирд╛
ЁЯЗзЁЯЗ╛ => ЁЯЗзЁЯЗ╛, рдмреЗрд▓рд╛рд░реВрд╕
ЁЯЗзЁЯЗ┐ => ЁЯЗзЁЯЗ┐, рдмрд▓рд┐рдЭ
ЁЯЗиЁЯЗж => ЁЯЗиЁЯЗж, рдХреЕрдирдбрд╛
ЁЯЗиЁЯЗи => ЁЯЗиЁЯЗи, рдХреЛрдХреЛрд╕ (рдХреАрд▓рд┐рдВрдЧ) рдмреЗрдЯреЗ
ЁЯЗиЁЯЗй => ЁЯЗиЁЯЗй, рдХрд╛рдБрдЧреЛ - рдХрд┐рдВрд╢рд╛рд╕рд╛
ЁЯЗиЁЯЗл => ЁЯЗиЁЯЗл, рдХреЗрдВрджреНрд░реАрдп рдЕрдлреНрд░рд┐рдХреА рдкреНрд░рдЬрд╛рд╕рддреНрддрд╛рдХ
ЁЯЗиЁЯЗм => ЁЯЗиЁЯЗм, рдХрд╛рдБрдЧреЛ - рдмреНрд░рд╛рдЭрд╛рд╡рд┐рд▓реЗ
ЁЯЗиЁЯЗн => ЁЯЗиЁЯЗн, рд╕реНрд╡рд┐рддреНрдЭрд░реНрд▓рдВрдб
ЁЯЗиЁЯЗо => ЁЯЗиЁЯЗо, рдЖрдпрд╡реНрд╣рд░реА рдХреЛрд╕реНрдЯ
ЁЯЗиЁЯЗ░ => ЁЯЗиЁЯЗ░, рдХреБрдХ рдмреЗрдЯреЗ
ЁЯЗиЁЯЗ▒ => ЁЯЗиЁЯЗ▒, рдЪрд┐рд▓реА
ЁЯЗиЁЯЗ▓ => ЁЯЗиЁЯЗ▓, рдХреЕрдореЗрд░реВрди
ЁЯЗиЁЯЗ│ => ЁЯЗиЁЯЗ│, рдЪреАрди
ЁЯЗиЁЯЗ┤ => ЁЯЗиЁЯЗ┤, рдХреЛрд▓рдореНрдмрд┐рдпрд╛
ЁЯЗиЁЯЗ╡ => ЁЯЗиЁЯЗ╡, рдХреНрд▓рд┐рдкрд░рдЯреЛрди рдмреЗрдЯ
ЁЯЗиЁЯЗ╖ => ЁЯЗиЁЯЗ╖, рдХреЛрд╕реНрдЯрд╛ рд░рд┐рдХрд╛
ЁЯЗиЁЯЗ║ => ЁЯЗиЁЯЗ║, рдХреНрдпреВрдмрд╛
ЁЯЗиЁЯЗ╗ => ЁЯЗиЁЯЗ╗, рдХреЗрдк рд╡реНрд╣рд░реНрдбреЗ
ЁЯЗиЁЯЗ╝ => ЁЯЗиЁЯЗ╝, рдХреНрдпреБрд░рд╛рд╕рд╛рдУ
ЁЯЗиЁЯЗ╜ => ЁЯЗиЁЯЗ╜, рдЦреНрд░рд┐рд╕рдорд╕ рдмреЗрдЯ
ЁЯЗиЁЯЗ╛ => ЁЯЗиЁЯЗ╛, рд╕рд╛рдпрдкреНрд░рд╕
ЁЯЗиЁЯЗ┐ => ЁЯЗиЁЯЗ┐, рдЭреЗрдХ рдкреНрд░рдЬрд╛рд╕рддреНрддрд╛рдХ
ЁЯЗйЁЯЗк => ЁЯЗйЁЯЗк, рдЬрд░реНрдордиреА
ЁЯЗйЁЯЗм => ЁЯЗйЁЯЗм, рджрд┐рдПрдЧреЛ рдЧрд╛рд░реНрд╕рд┐рдпрд╛
ЁЯЗйЁЯЗп => ЁЯЗйЁЯЗп, рдЬрд┐рдмреМрдЯреА
ЁЯЗйЁЯЗ░ => ЁЯЗйЁЯЗ░, рдбреЗрдиреНрдорд╛рд░реНрдХ
ЁЯЗйЁЯЗ▓ => ЁЯЗйЁЯЗ▓, рдбреЛрдорд┐рдирд┐рдХрд╛
ЁЯЗйЁЯЗ┤ => ЁЯЗйЁЯЗ┤, рдбреЛрдорд┐рдирд┐рдХрди рдкреНрд░рдЬрд╛рд╕рддреНрддрд╛рдХ
ЁЯЗйЁЯЗ┐ => ЁЯЗйЁЯЗ┐, рдЕрд▓реНрдЬреАрд░рд┐рдпрд╛
ЁЯЗкЁЯЗж => ЁЯЗкЁЯЗж, рд╕реНрдпреВрдЯрд╛ рдЖрдгрд┐ рдореЗрд▓рд┐рд▓рд╛
ЁЯЗкЁЯЗи => ЁЯЗкЁЯЗи, рдЗрдХреНрд╡рд╛рдбреЛрд░
ЁЯЗкЁЯЗк => ЁЯЗкЁЯЗк, рдПрд╕реНрдЯреЛрдирд┐рдпрд╛
ЁЯЗкЁЯЗм => ЁЯЗкЁЯЗм, рдЗрдЬрд┐рдкреНрдд
ЁЯЗкЁЯЗн => ЁЯЗкЁЯЗн, рдкрд╢реНрдЪрд┐рдо рд╕рд╣рд╛рд░рд╛
ЁЯЗкЁЯЗ╖ => ЁЯЗкЁЯЗ╖, рдПрд░рд┐рдЯреНрд░рд┐рдпрд╛
ЁЯЗкЁЯЗ╕ => ЁЯЗкЁЯЗ╕, рд╕реНрдкреЗрди
ЁЯЗкЁЯЗ╣ => ЁЯЗкЁЯЗ╣, рдЗрдерд┐рдУрдкрд┐рдпрд╛
ЁЯЗкЁЯЗ║ => ЁЯЗкЁЯЗ║, рдпреБрд░реЛрдкреАрдп рд╕рдВрдШ
ЁЯЗлЁЯЗо => ЁЯЗлЁЯЗо, рдлрд┐рдирд▓рдВрдб
ЁЯЗлЁЯЗп => ЁЯЗлЁЯЗп, рдлрд┐рдЬреА
ЁЯЗлЁЯЗ░ => ЁЯЗлЁЯЗ░, рдлреЙрдХрд▓рдВрдб рдмреЗрдЯреЗ
ЁЯЗлЁЯЗ▓ => ЁЯЗлЁЯЗ▓, рдорд╛рдпрдХреНрд░реЛрдиреЗрд╢рд┐рдпрд╛
ЁЯЗлЁЯЗ┤ => ЁЯЗлЁЯЗ┤, рдлреЗрд░реЛ рдмреЗрдЯреЗ
ЁЯЗлЁЯЗ╖ => ЁЯЗлЁЯЗ╖, рдлреНрд░рд╛рдиреНрд╕
ЁЯЗмЁЯЗж => ЁЯЗмЁЯЗж, рдЧреЕрдмреЙрди
ЁЯЗмЁЯЗз => ЁЯЗмЁЯЗз, рдпреБрдирд╛рдпрдЯреЗрдб рдХрд┐рдВрдЧрдбрдо
ЁЯЗмЁЯЗй => ЁЯЗмЁЯЗй, рдЧреНрд░реЗрдиреЗрдбрд╛
ЁЯЗмЁЯЗк => ЁЯЗмЁЯЗк, рдЬреЙрд░реНрдЬрд┐рдпрд╛
ЁЯЗмЁЯЗл => ЁЯЗмЁЯЗл, рдлреНрд░реЗрдВрдЪ рдЧрдпрд╛рдирд╛
ЁЯЗмЁЯЗм => ЁЯЗмЁЯЗм, рдЧреНрд╡реЗрд░реНрдирд╕реЗ
ЁЯЗмЁЯЗн => ЁЯЗмЁЯЗн, рдШрд╛рдирд╛
ЁЯЗмЁЯЗо => ЁЯЗмЁЯЗо, рдЬрд┐рдмреНрд░рд╛рд▓реНрдЯрд░
ЁЯЗмЁЯЗ▒ => ЁЯЗмЁЯЗ▒, рдЧреНрд░реАрдирд▓рдВрдб
ЁЯЗмЁЯЗ▓ => ЁЯЗмЁЯЗ▓, рдЧрд╛рдореНрдмрд┐рдпрд╛
ЁЯЗмЁЯЗ│ => ЁЯЗмЁЯЗ│, рдЧрд┐рдиреА
ЁЯЗмЁЯЗ╡ => ЁЯЗмЁЯЗ╡, рдЧреНрд╡рд╛рдбреЗрд▓реЛрдЙрдкреЗ
ЁЯЗмЁЯЗ╢ => ЁЯЗмЁЯЗ╢, рдЗрдХреНрд╡реЗрдЯреЛрд░рд┐рдпрд▓ рдЧрд┐рдиреА
ЁЯЗмЁЯЗ╖ => ЁЯЗмЁЯЗ╖, рдЧреНрд░реАрд╕
ЁЯЗмЁЯЗ╕ => ЁЯЗмЁЯЗ╕, рджрдХреНрд╖рд┐рдг рдЬреЙрд░реНрдЬрд┐рдпрд╛ рдЖрдгрд┐ рджрдХреНрд╖рд┐рдг рд╕рдБрдбрд╡рд┐рдЪ рдмреЗрдЯреЗ
ЁЯЗмЁЯЗ╣ => ЁЯЗмЁЯЗ╣, рдЧреНрд╡рд╛рдЯреЗрдорд╛рд▓рд╛
ЁЯЗмЁЯЗ║ => ЁЯЗмЁЯЗ║, рдЧреБрдЖрдо
ЁЯЗмЁЯЗ╝ => ЁЯЗмЁЯЗ╝, рдЧрд┐рдиреА-рдмрд┐рд╕рд╛рдЙ
ЁЯЗмЁЯЗ╛ => ЁЯЗмЁЯЗ╛, рдЧрдпрд╛рдирд╛
ЁЯЗнЁЯЗ░ => ЁЯЗнЁЯЗ░, рд╣рд╛рдБрдЧрдХрд╛рдБрдЧ рдПрд╕рдПрдЖрд░ рдЪреАрди
ЁЯЗнЁЯЗ▓ => ЁЯЗнЁЯЗ▓, рд╣рд░реНрдб рдЖрдгрд┐ рдореЕрдХреНрдбреЛрдирд╛рд▓реНрдб рдмреЗрдЯреЗ
ЁЯЗнЁЯЗ│ => ЁЯЗнЁЯЗ│, рд╣реЛрдВрдбреБрд░рд╛рд╕
ЁЯЗнЁЯЗ╖ => ЁЯЗнЁЯЗ╖, рдХреНрд░реЛрдПрд╢рд┐рдпрд╛
ЁЯЗнЁЯЗ╣ => ЁЯЗнЁЯЗ╣, рд╣реИрддреА
ЁЯЗнЁЯЗ║ => ЁЯЗнЁЯЗ║, рд╣рдВрдЧреЗрд░реА
ЁЯЗоЁЯЗи => ЁЯЗоЁЯЗи, рдХреЕрдирд░реА рдмреЗрдЯреЗ
ЁЯЗоЁЯЗй => ЁЯЗоЁЯЗй, рдЗрдВрдбреЛрдиреЗрд╢рд┐рдпрд╛
ЁЯЗоЁЯЗк => ЁЯЗоЁЯЗк, рдЖрдпрд░реНрд▓рдВрдб
ЁЯЗоЁЯЗ▒ => ЁЯЗоЁЯЗ▒, рдЗрд╕реНрддреНрд░рд╛рдЗрд▓
ЁЯЗоЁЯЗ▓ => ЁЯЗоЁЯЗ▓, рдЗрд╕реНрд▓реЗ рдСрдл рдореЕрди
ЁЯЗоЁЯЗ│ => ЁЯЗоЁЯЗ│, рднрд╛рд░рдд
ЁЯЗоЁЯЗ┤ => ЁЯЗоЁЯЗ┤, рдмреНрд░рд┐рдЯрд┐рд╢ рд╣рд┐рдВрджреА рдорд╣рд╛рд╕рд╛рдЧрд░ рдХреНрд╖реЗрддреНрд░
ЁЯЗоЁЯЗ╢ => ЁЯЗоЁЯЗ╢, рдЗрд░рд╛рдХ
ЁЯЗоЁЯЗ╖ => ЁЯЗоЁЯЗ╖, рдЗрд░рд╛рдг
ЁЯЗоЁЯЗ╕ => ЁЯЗоЁЯЗ╕, рдЖрдЗрд╕рд▓рдБрдб
ЁЯЗоЁЯЗ╣ => ЁЯЗоЁЯЗ╣, рдЗрдЯрд▓реА
ЁЯЗпЁЯЗк => ЁЯЗпЁЯЗк, рдЬрд░реНрд╕реА
ЁЯЗпЁЯЗ▓ => ЁЯЗпЁЯЗ▓, рдЬрдореИрдХрд╛
ЁЯЗпЁЯЗ┤ => ЁЯЗпЁЯЗ┤, рдЬреЙрд░реНрдбрди
ЁЯЗпЁЯЗ╡ => ЁЯЗпЁЯЗ╡, рдЬрдкрд╛рди
ЁЯЗ░ЁЯЗк => ЁЯЗ░ЁЯЗк, рдХреЗрдирд┐рдпрд╛
ЁЯЗ░ЁЯЗм => ЁЯЗ░ЁЯЗм, рдХрд┐рд░рдЧрд┐рдЭрд╕реНрддрд╛рди
ЁЯЗ░ЁЯЗн => ЁЯЗ░ЁЯЗн, рдХрдВрдмреЛрдбрд┐рдпрд╛
ЁЯЗ░ЁЯЗо => ЁЯЗ░ЁЯЗо, рдХрд┐рд░реАрдмрд╛рдЯреА
ЁЯЗ░ЁЯЗ▓ => ЁЯЗ░ЁЯЗ▓, рдХреЛрдореЛрд░реЛрдЬ
ЁЯЗ░ЁЯЗ│ => ЁЯЗ░ЁЯЗ│, рд╕реЗрдВрдЯ рдХрд┐рдЯреНрд╕ рдЖрдгрд┐ рдиреЗрд╡реНрд╣рд┐рд╕
ЁЯЗ░ЁЯЗ╡ => ЁЯЗ░ЁЯЗ╡, рдЙрддреНрддрд░ рдХреЛрд░рд┐рдпрд╛
ЁЯЗ░ЁЯЗ╖ => ЁЯЗ░ЁЯЗ╖, рджрдХреНрд╖рд┐рдг рдХреЛрд░рд┐рдпрд╛
ЁЯЗ░ЁЯЗ╝ => ЁЯЗ░ЁЯЗ╝, рдХреБрд╡реЗрдд
ЁЯЗ░ЁЯЗ╛ => ЁЯЗ░ЁЯЗ╛, рдХреЗрдорди рдмреЗрдЯреЗ
ЁЯЗ░ЁЯЗ┐ => ЁЯЗ░ЁЯЗ┐, рдХрдЭрд╛рдХрд╕реНрддрд╛рди
ЁЯЗ▒ЁЯЗж => ЁЯЗ▒ЁЯЗж, рд▓рд╛рдУрд╕
ЁЯЗ▒ЁЯЗз => ЁЯЗ▒ЁЯЗз, рд▓реЗрдмрдиреЙрди
ЁЯЗ▒ЁЯЗи => ЁЯЗ▒ЁЯЗи, рд╕реЗрдВрдЯ рд▓реНрдпреВрд╕рд┐рдпрд╛
ЁЯЗ▒ЁЯЗо => ЁЯЗ▒ЁЯЗо, рд▓рд┐рдХреНрдЯреЗрдирд╕реНрдЯрд╛рдЗрди
ЁЯЗ▒ЁЯЗ░ => ЁЯЗ▒ЁЯЗ░, рд╢реНрд░реАрд▓рдВрдХрд╛
ЁЯЗ▒ЁЯЗ╖ => ЁЯЗ▒ЁЯЗ╖, рд▓рд╛рдпрдмреЗрд░рд┐рдпрд╛
ЁЯЗ▒ЁЯЗ╕ => ЁЯЗ▒ЁЯЗ╕, рд▓реЗрд╕реЛрдереЛ
ЁЯЗ▒ЁЯЗ╣ => ЁЯЗ▒ЁЯЗ╣, рд▓рд┐рдереБрдЖрдирд┐рдпрд╛
ЁЯЗ▒ЁЯЗ║ => ЁЯЗ▒ЁЯЗ║, рд▓рдХреНрдЭреЗрдВрдмрд░реНрдЧ
ЁЯЗ▒ЁЯЗ╗ => ЁЯЗ▒ЁЯЗ╗, рд▓рд╛рддреНрд╡рд┐рдпрд╛
ЁЯЗ▒ЁЯЗ╛ => ЁЯЗ▒ЁЯЗ╛, рд▓рд┐рдмрд┐рдпрд╛
ЁЯЗ▓ЁЯЗж => ЁЯЗ▓ЁЯЗж, рдореЛрд░реЛрдХреНрдХреЛ
ЁЯЗ▓ЁЯЗи => ЁЯЗ▓ЁЯЗи, рдореЛрдиреЕрдХреЛ
ЁЯЗ▓ЁЯЗй => ЁЯЗ▓ЁЯЗй, рдореЛрд▓реНрдбреЛрд╡реНрд╣рд╛
ЁЯЗ▓ЁЯЗк => ЁЯЗ▓ЁЯЗк, рдореЛрдВрдЯреЗрдиреЗрдЧреНрд░реЛ
ЁЯЗ▓ЁЯЗл => ЁЯЗ▓ЁЯЗл, рд╕реЗрдВрдЯ рдорд╛рд░реНрдЯрд┐рди
ЁЯЗ▓ЁЯЗм => ЁЯЗ▓ЁЯЗм, рдорд╛рджрд╛рдЧрд╛рд╕реНрдХрд░
ЁЯЗ▓ЁЯЗн => ЁЯЗ▓ЁЯЗн, рдорд╛рд░реНрд╢рд▓ рдмреЗрдЯреЗ
ЁЯЗ▓ЁЯЗ░ => ЁЯЗ▓ЁЯЗ░, рдореЕрд╕реЗрдбреЛрдирд┐рдпрд╛
ЁЯЗ▓ЁЯЗ▒ => ЁЯЗ▓ЁЯЗ▒, рдорд╛рд▓реА
ЁЯЗ▓ЁЯЗ▓ => ЁЯЗ▓ЁЯЗ▓, рдореНрдпрд╛рдирдорд╛рд░ (рдмрд░реНрдорд╛)
ЁЯЗ▓ЁЯЗ│ => ЁЯЗ▓ЁЯЗ│, рдордВрдЧреЛрд▓рд┐рдпрд╛
ЁЯЗ▓ЁЯЗ┤ => ЁЯЗ▓ЁЯЗ┤, рдордХрд╛рдУ рдПрд╕рдПрдЖрд░ рдЪреАрди
ЁЯЗ▓ЁЯЗ╡ => ЁЯЗ▓ЁЯЗ╡, рдЙрддреНрддрд░реА рдорд╛рд░рд┐рдпрд╛рдирд╛ рдмреЗрдЯреЗ
ЁЯЗ▓ЁЯЗ╢ => ЁЯЗ▓ЁЯЗ╢, рдорд╛рд░реНрдЯрд┐рдирд┐рдХ
ЁЯЗ▓ЁЯЗ╖ => ЁЯЗ▓ЁЯЗ╖, рдореЙрд░рд┐рдЯрд╛рдирд┐рдпрд╛
ЁЯЗ▓ЁЯЗ╕ => ЁЯЗ▓ЁЯЗ╕, рдореЙрдиреНрдЯреНрд╕реЗрд░рд╛рдЯ
ЁЯЗ▓ЁЯЗ╣ => ЁЯЗ▓ЁЯЗ╣, рдорд╛рд▓реНрдЯрд╛
ЁЯЗ▓ЁЯЗ║ => ЁЯЗ▓ЁЯЗ║, рдореЙрд░рд┐рд╢рд╕
ЁЯЗ▓ЁЯЗ╗ => ЁЯЗ▓ЁЯЗ╗, рдорд╛рд▓рджреАрд╡
ЁЯЗ▓ЁЯЗ╝ => ЁЯЗ▓ЁЯЗ╝, рдорд▓рд╛рд╡реА
ЁЯЗ▓ЁЯЗ╜ => ЁЯЗ▓ЁЯЗ╜, рдореЗрдХреНрд╕рд┐рдХреЛ
ЁЯЗ▓ЁЯЗ╛ => ЁЯЗ▓ЁЯЗ╛, рдорд▓реЗрд╢рд┐рдпрд╛
ЁЯЗ▓ЁЯЗ┐ => ЁЯЗ▓ЁЯЗ┐, рдореЛрдЭрд╛рдореНрдмрд┐рдХ
ЁЯЗ│ЁЯЗж => ЁЯЗ│ЁЯЗж, рдирд╛рдорд┐рдмрд┐рдпрд╛
ЁЯЗ│ЁЯЗи => ЁЯЗ│ЁЯЗи, рдиреНрдпреВ рдХреЕрд▓реЗрдбреЛрдирд┐рдпрд╛
ЁЯЗ│ЁЯЗк => ЁЯЗ│ЁЯЗк, рдирд╛рдЗрдЬрд░
ЁЯЗ│ЁЯЗл => ЁЯЗ│ЁЯЗл, рдиреЙрд░рдлреЙрдХ рдмреЗрдЯ
ЁЯЗ│ЁЯЗм => ЁЯЗ│ЁЯЗм, рдирд╛рдпрдЬреЗрд░рд┐рдпрд╛
ЁЯЗ│ЁЯЗо => ЁЯЗ│ЁЯЗо, рдирд┐рдХрд╛рд░рд╛рдЧреНрд╡рд╛
ЁЯЗ│ЁЯЗ▒ => ЁЯЗ│ЁЯЗ▒, рдиреЗрджрд░рд▓рдБрдб
ЁЯЗ│ЁЯЗ┤ => ЁЯЗ│ЁЯЗ┤, рдиреЙрд░реНрд╡реЗ
ЁЯЗ│ЁЯЗ╡ => ЁЯЗ│ЁЯЗ╡, рдиреЗрдкрд╛рд│
ЁЯЗ│ЁЯЗ╖ => ЁЯЗ│ЁЯЗ╖, рдирд╛рдЙрд░реВ
ЁЯЗ│ЁЯЗ║ => ЁЯЗ│ЁЯЗ║, рдиреАрдпреВ
ЁЯЗ│ЁЯЗ┐ => ЁЯЗ│ЁЯЗ┐, рдиреНрдпреВрдЭреАрд▓рдВрдб
ЁЯЗ┤ЁЯЗ▓ => ЁЯЗ┤ЁЯЗ▓, рдУрдорд╛рди
ЁЯЗ╡ЁЯЗж => ЁЯЗ╡ЁЯЗж, рдкрдирд╛рдорд╛
ЁЯЗ╡ЁЯЗк => ЁЯЗ╡ЁЯЗк, рдкреЗрд░реВ
ЁЯЗ╡ЁЯЗл => ЁЯЗ╡ЁЯЗл, рдлреНрд░реЗрдВрдЪ рдкреЙрд▓рд┐рдиреЗрд╢рд┐рдпрд╛
ЁЯЗ╡ЁЯЗм => ЁЯЗ╡ЁЯЗм, рдкрд╛рдкреБрдЖ рдиреНрдпреВ рдЧрд┐рдиреА
ЁЯЗ╡ЁЯЗн => ЁЯЗ╡ЁЯЗн, рдлрд┐рд▓рд┐рдкрд┐рдиреНрд╕
ЁЯЗ╡ЁЯЗ░ => ЁЯЗ╡ЁЯЗ░, рдкрд╛рдХрд┐рд╕реНрддрд╛рди
ЁЯЗ╡ЁЯЗ▒ => ЁЯЗ╡ЁЯЗ▒, рдкреЛрд▓рдВрдб
ЁЯЗ╡ЁЯЗ▓ => ЁЯЗ╡ЁЯЗ▓, рд╕реЗрдВрдЯ рдкрд┐рдпрд░реЗ рдЖрдгрд┐ рдорд┐рдХреНрд╡реЗрд▓реЛрди
ЁЯЗ╡ЁЯЗ│ => ЁЯЗ╡ЁЯЗ│, рдкрд┐рдЯрдХреИрд░реНрди рдмреЗрдЯреЗ
ЁЯЗ╡ЁЯЗ╖ => ЁЯЗ╡ЁЯЗ╖, рдкреНрдпреБрдПрд░реНрддреЛ рд░рд┐рдХреЛ
ЁЯЗ╡ЁЯЗ╕ => ЁЯЗ╡ЁЯЗ╕, рдкреЕрд▓реЗрд╕реНрдЯрд┐рдирд┐рдпрди рдкреНрд░рджреЗрд╢
ЁЯЗ╡ЁЯЗ╣ => ЁЯЗ╡ЁЯЗ╣, рдкреЛрд░реНрддреБрдЧрд╛рд▓
ЁЯЗ╡ЁЯЗ╝ => ЁЯЗ╡ЁЯЗ╝, рдкрд▓рд╛рдК
ЁЯЗ╡ЁЯЗ╛ => ЁЯЗ╡ЁЯЗ╛, рдкрд░рд╛рдЧреНрд╡реЗ
ЁЯЗ╢ЁЯЗж => ЁЯЗ╢ЁЯЗж, рдХрддрд╛рд░
ЁЯЗ╢ЁЯЗ┤ => ЁЯЗ╢ЁЯЗ┤, рдЖрдЙрдЯрд▓рд╛рдИрдВрдЧ рдУрд╢рдирд┐рдпрд╛
ЁЯЗ╖ЁЯЗк => ЁЯЗ╖ЁЯЗк, рд░рд┐рдпреБрдирд┐рдпрди
ЁЯЗ╖ЁЯЗ┤ => ЁЯЗ╖ЁЯЗ┤, рд░реЛрдорд╛рдирд┐рдпрд╛
ЁЯЗ╖ЁЯЗ╕ => ЁЯЗ╖ЁЯЗ╕, рд╕рд░реНрдмрд┐рдпрд╛
ЁЯЗ╖ЁЯЗ║ => ЁЯЗ╖ЁЯЗ║, рд░рд╢рд┐рдпрд╛
ЁЯЗ╖ЁЯЗ╝ => ЁЯЗ╖ЁЯЗ╝, рд░рд╡рд╛рдВрдбрд╛
ЁЯЗ╕ЁЯЗж => ЁЯЗ╕ЁЯЗж, рд╕реМрджреА рдЕрд░рдм
ЁЯЗ╕ЁЯЗз => ЁЯЗ╕ЁЯЗз, рд╕реЛрд▓реЛрдорди рдмреЗрдЯреЗ
ЁЯЗ╕ЁЯЗи => ЁЯЗ╕ЁЯЗи, рд╕реЗрд╢реЗрд▓реНрд╕
ЁЯЗ╕ЁЯЗй => ЁЯЗ╕ЁЯЗй, рд╕реБрджрд╛рди
ЁЯЗ╕ЁЯЗк => ЁЯЗ╕ЁЯЗк, рд╕реНрд╡реАрдбрди
ЁЯЗ╕ЁЯЗм => ЁЯЗ╕ЁЯЗм, рд╕рд┐рдВрдЧрд╛рдкреВрд░
ЁЯЗ╕ЁЯЗн => ЁЯЗ╕ЁЯЗн, рд╕реЗрдВрдЯ рд╣реЗрд▓реЗрдирд╛
ЁЯЗ╕ЁЯЗо => ЁЯЗ╕ЁЯЗо, рд╕реНрд▓реЛрд╡реНрд╣реЗрдирд┐рдпрд╛
ЁЯЗ╕ЁЯЗп => ЁЯЗ╕ЁЯЗп, рд╕реНрд╡рд╛рд▓рдмрд░реНрдб рдЖрдгрд┐ рдЬрд╛рди рдорд╛рдпреЗрди
ЁЯЗ╕ЁЯЗ░ => ЁЯЗ╕ЁЯЗ░, рд╕реНрд▓реЛрд╡реНрд╣рд╛рдХрд┐рдпрд╛
ЁЯЗ╕ЁЯЗ▒ => ЁЯЗ╕ЁЯЗ▒, рд╕рд┐рдПрд░рд╛ рд▓рд┐рдУрди
ЁЯЗ╕ЁЯЗ▓ => ЁЯЗ╕ЁЯЗ▓, рд╕реЕрди рдорд░реАрдиреЛ
ЁЯЗ╕ЁЯЗ│ => ЁЯЗ╕ЁЯЗ│, рд╕реЗрдиреЗрдЧрд▓
ЁЯЗ╕ЁЯЗ┤ => ЁЯЗ╕ЁЯЗ┤, рд╕реЛрдорд╛рд▓рд┐рдпрд╛
ЁЯЗ╕ЁЯЗ╖ => ЁЯЗ╕ЁЯЗ╖, рд╕реБрд░рд┐рдирд╛рдо
ЁЯЗ╕ЁЯЗ╕ => ЁЯЗ╕ЁЯЗ╕, рджрдХреНрд╖рд┐рдг рд╕реБрджрд╛рди
ЁЯЗ╕ЁЯЗ╣ => ЁЯЗ╕ЁЯЗ╣, рд╕рд╛рдУ рдЯреЛрдо рдЖрдгрд┐ рдкреНрд░рд┐рдВрд╕рд┐рдкреЗ
ЁЯЗ╕ЁЯЗ╗ => ЁЯЗ╕ЁЯЗ╗, рдЕрд▓ рд╕рд╛рд▓реНрд╡рд╛рдбреЛрд░
ЁЯЗ╕ЁЯЗ╜ => ЁЯЗ╕ЁЯЗ╜, рд╕рд┐рдВрдЯ рдорд╛рд░реНрдЯреЗрди
ЁЯЗ╕ЁЯЗ╛ => ЁЯЗ╕ЁЯЗ╛, рд╕реАрд░рд┐рдпрд╛
ЁЯЗ╕ЁЯЗ┐ => ЁЯЗ╕ЁЯЗ┐, рд╕реНрд╡рд╛рдЭрд┐рд▓рдБрдб
ЁЯЗ╣ЁЯЗж => ЁЯЗ╣ЁЯЗж, рдЯреНрд░рд┐рд╕реНрдЯрди рджрд╛ рдХреБрдиреНрд╣рд╛
ЁЯЗ╣ЁЯЗи => ЁЯЗ╣ЁЯЗи, рдЯрд░реНрдХреНрд╕ рдЖрдгрд┐ рдХреИрдХреЛрд╕ рдмреЗрдЯреЗ
ЁЯЗ╣ЁЯЗй => ЁЯЗ╣ЁЯЗй, рдЪрд╛рдб
ЁЯЗ╣ЁЯЗл => ЁЯЗ╣ЁЯЗл, рдлреНрд░реЗрдВрдЪ рджрд╛рдХреНрд╖рд┐рдгрд╛рддреНрдп рдкреНрд░рджреЗрд╢
ЁЯЗ╣ЁЯЗм => ЁЯЗ╣ЁЯЗм, рдЯреЛрдЧреЛ
ЁЯЗ╣ЁЯЗн => ЁЯЗ╣ЁЯЗн, рдерд╛рдпрд▓рдВрдб
ЁЯЗ╣ЁЯЗп => ЁЯЗ╣ЁЯЗп, рддрд╛рдЬрд┐рдХрд┐рд╕реНрддрд╛рди
ЁЯЗ╣ЁЯЗ░ => ЁЯЗ╣ЁЯЗ░, рддреЛрдХреЗрд▓рд╛рдЙ
ЁЯЗ╣ЁЯЗ▒ => ЁЯЗ╣ЁЯЗ▒, рдкреВрд░реНрд╡ рддрд┐рдореЛрд░
ЁЯЗ╣ЁЯЗ▓ => ЁЯЗ╣ЁЯЗ▓, рддреБрд░реНрдХрдореЗрдирд┐рд╕реНрддрд╛рди
ЁЯЗ╣ЁЯЗ│ => ЁЯЗ╣ЁЯЗ│, рдЯреНрдпреВрдирд┐рд╢рд┐рдпрд╛
ЁЯЗ╣ЁЯЗ┤ => ЁЯЗ╣ЁЯЗ┤, рдЯреЛрдВрдЧрд╛
ЁЯЗ╣ЁЯЗ╖ => ЁЯЗ╣ЁЯЗ╖, рддреБрд░реНрдХреА
ЁЯЗ╣ЁЯЗ╣ => ЁЯЗ╣ЁЯЗ╣, рддреНрд░рд┐рдирд┐рджрд╛рдж рдЖрдгрд┐ рдЯреЛрдмреЕрдЧреЛ
ЁЯЗ╣ЁЯЗ╗ => ЁЯЗ╣ЁЯЗ╗, рдЯреБрд╡рд╛рд▓реБ
ЁЯЗ╣ЁЯЗ╝ => ЁЯЗ╣ЁЯЗ╝, рддреИрд╡рд╛рди
ЁЯЗ╣ЁЯЗ┐ => ЁЯЗ╣ЁЯЗ┐, рдЯрд╛рдВрдЭрд╛рдирд┐рдпрд╛
ЁЯЗ║ЁЯЗж => ЁЯЗ║ЁЯЗж, рдпреБрдХреНрд░реЗрди
ЁЯЗ║ЁЯЗм => ЁЯЗ║ЁЯЗм, рдпреБрдЧрд╛рдВрдбрд╛
ЁЯЗ║ЁЯЗ▓ => ЁЯЗ║ЁЯЗ▓, рдпреВ.рдПрд╕. рдЖрдЙрдЯрд▓рд╛рдЗрдВрдЧ рдмреЗрдЯреЗ
ЁЯЗ║ЁЯЗ╕ => ЁЯЗ║ЁЯЗ╕, рдпреБрдирд╛рдпрдЯреЗрдб рд╕реНрдЯреЗрдЯреНрд╕
ЁЯЗ║ЁЯЗ╛ => ЁЯЗ║ЁЯЗ╛, рдЙрд░реБрдЧреНрд╡реЗ
ЁЯЗ║ЁЯЗ┐ => ЁЯЗ║ЁЯЗ┐, рдЙрдЭрдмреЗрдХрд┐рд╕реНрддрд╛рди
ЁЯЗ╗ЁЯЗж => ЁЯЗ╗ЁЯЗж, рд╡реНрд╣реЕрдЯрд┐рдХрди рд╕рд┐рдЯреА
ЁЯЗ╗ЁЯЗи => ЁЯЗ╗ЁЯЗи, рд╕реЗрдВрдЯ рд╡реНрд╣рд┐рдиреНрд╕реЗрдВрдЯ рдЖрдгрд┐ рдЧреНрд░реЗрдирдбрд╛рдЗрдиреНрд╕
ЁЯЗ╗ЁЯЗк => ЁЯЗ╗ЁЯЗк, рд╡реНрд╣реЗрдиреЗрдЭреБрдПрд▓рд╛
ЁЯЗ╗ЁЯЗм => ЁЯЗ╗ЁЯЗм, рдмреНрд░рд┐рдЯрд┐рд╢ рд╡реНрд╣рд░реНрдЬрд┐рди рдмреЗрдЯреЗ
ЁЯЗ╗ЁЯЗо => ЁЯЗ╗ЁЯЗо, рдпреВ.рдПрд╕. рд╡реНрд╣рд░реНрдЬрд┐рди рдмреЗрдЯреЗ
ЁЯЗ╗ЁЯЗ│ => ЁЯЗ╗ЁЯЗ│, рд╡реНрд╣рд┐рдПрддрдирд╛рдо
ЁЯЗ╗ЁЯЗ║ => ЁЯЗ╗ЁЯЗ║, рд╡рд╛рдиреБрдЖрддреБ
ЁЯЗ╝ЁЯЗл => ЁЯЗ╝ЁЯЗл, рд╡рд╛рд▓рд┐рд╕ рдЖрдгрд┐ рдлреНрдпреВрдЪреВрдирд╛
ЁЯЗ╝ЁЯЗ╕ => ЁЯЗ╝ЁЯЗ╕, рд╕рд╛рдореЛрдЖ
ЁЯЗ╜ЁЯЗ░ => ЁЯЗ╜ЁЯЗ░, рдХреЛрд╕реЛрд╡реНрд╣реЛ
ЁЯЗ╛ЁЯЗк => ЁЯЗ╛ЁЯЗк, рдпреЗрдореЗрди
ЁЯЗ╛ЁЯЗ╣ => ЁЯЗ╛ЁЯЗ╣, рдорд╛рдпреЛрдЯреНрдЯреЗ
ЁЯЗ┐ЁЯЗж => ЁЯЗ┐ЁЯЗж, рджрдХреНрд╖рд┐рдг рдЖрдлреНрд░рд┐рдХрд╛
ЁЯЗ┐ЁЯЗ▓ => ЁЯЗ┐ЁЯЗ▓, рдЭрд╛рдореНрдмрд┐рдпрд╛
ЁЯЗ┐ЁЯЗ╝ => ЁЯЗ┐ЁЯЗ╝, рдЭрд┐рдореНрдмрд╛рдмреНрд╡реЗ
ЁЯЗ┐ЁЯЗ┐ => ЁЯЗ┐ЁЯЗ┐, рдЕрдЬреНрдЮрд╛рдд рдкреНрд░рджреЗрд╢