ЁЯША => ЁЯША, рдЕрдиреБрд╣рд╛рд░, рд╣рдБрд╕рд┐рд▓реЛ
ЁЯШБ => ЁЯШБ, рдЖрдБрдЦрд╛, рдЕрдиреБрд╣рд╛рд░, рд╣рдБрд╕рд┐рд▓реЛ, рдореБрд╕реНрдХрд╛рди
ЁЯШВ => ЁЯШВ, рдЕрдиреБрд╣рд╛рд░, рдЦреБрд╢реА, рд╣рд╛рдБрд╕реЛ, рдЖрдБрд╕реБ
ЁЯШГ => ЁЯШГ, рдЕрдиреБрд╣рд╛рд░, рдореБрдЦ, рдЦреБрд▓рд╛, рдореБрд╕реНрдХрд╛рди
ЁЯШД => ЁЯШД, рдЖрдБрдЦрд╛, рдЕрдиреБрд╣рд╛рд░, рдореБрдЦ, рдЦреБрд▓рд╛, рдореБрд╕реНрдХрд╛рди
ЁЯШЕ => ЁЯШЕ, рдЪрд┐рд╕реЛ, рдЕрдиреБрд╣рд╛рд░, рдЦреБрд▓рд╛, рд╣рд╛рдБрд╕реЛ, рдкрд╕рд┐рдирд╛
ЁЯШЖ => ЁЯШЖ, рдЕрдиреБрд╣рд╛рд░, рд╣рдБрд╕рд╛рдИ, рдореБрдЦ, рдЦреБрд▓рд╛, рд╕рдиреНрддреБрд╖реНрдЯрд┐, рдореБрд╕реНрдХрд╛рди
ЁЯШЙ => ЁЯШЙ, рдЕрдиреБрд╣рд╛рд░, рдЖрдБрдЦрд╛ рдЭрд┐рдореНрдХрд╛рдПрдХреЛ
ЁЯШК => ЁЯШК, рд▓рдЬрд╛рдПрдХреЛ, рдЖрдБрдЦрд╛, рдЕрдиреБрд╣рд╛рд░, рдореБрд╕реНрдХрд╛рди
ЁЯШЛ => ЁЯШЛ, рд╕реНрд╡рд╛рджрд┐рд╖реНрдЯ, рдЕрдиреБрд╣рд╛рд░, рдорд┐рдареЛ, рд╣рд╛рдБрд╕реЛ, рд╕реНрд╡рд╛рджрд┐рд╕реНрдЯ, рдорд┐рд╕реНрдард╛рдиреНрди
ЁЯШО => ЁЯШО, рдЙрдЬреНрдпрд╛рд▓реЛ, рд░рд╛рдореНрд░реЛ, рдЖрдБрдЦрд╛, рдЖрдБрдЦрд╛рдорд╛ рд▓рдЧрд╛рдЙрдиреЗ, рдЕрдиреБрд╣рд╛рд░, рдЪрд╕реНрдорд╛, рд╣рд╛рдБрд╕реЛ, рд╕реВрд░реНрдп, рдШрд╛рдордмрд╛рдЯ рдмрдЪреНрди рд▓рдЧрд╛рдЙрдиреЗ рдЪрд╕реНрдорд╛, рдореМрд╕рдо
ЁЯШН => ЁЯШН, рдЖрдБрдЦрд╛, рдЕрдиреБрд╣рд╛рд░, рдореБрдЯреБ, рдорд╛рдпрд╛, рдореБрд╕реНрдХрд╛рди
ЁЯШШ => ЁЯШШ, рдЕрдиреБрд╣рд╛рд░, рдореБрдЯреБ, рдЪреБрдореНрдмрди
ЁЯШЧ => ЁЯШЧ, рдЕрдиреБрд╣рд╛рд░, рдЪреБрдореНрдмрди
ЁЯШЩ => ЁЯШЩ, рдЖрдБрдЦрд╛, рдЕрдиреБрд╣рд╛рд░, рдЪреБрдореНрдмрди, рдореБрд╕реНрдХрд╛рди
ЁЯШЪ => ЁЯШЪ, рдмрдиреНрдж рдЧрд░реЗрдХреЛ, рдЖрдБрдЦрд╛, рдЕрдиреБрд╣рд╛рд░, рдЪреБрдореНрдмрди
тШ║ => тШ║, рдЕрдиреБрд╣рд╛рд░, рдмрд╛рд╣рд┐рд░ рд░реЗрдЦрд╛ рдЧрд░реЗрдХреЛ, рддрдирд╛рдмрдореБрдХреНрдд, рдореБрд╕реНрдХрд╛рди
ЁЯЩВ => ЁЯЩВ, рдЕрдиреБрд╣рд╛рд░, рдореБрд╕реНрдХрд╛рди
ЁЯдЧ => ЁЯдЧ, рдЕрдиреБрд╣рд╛рд░, рдЕрдВрдЧрд╛рд▓реЛ, рдЕрдВрдЧрд╛рд▓реЛ рдорд╛рд░рд┐рд░рд╣реЗрдХреЛ
ЁЯШЗ => ЁЯШЗ, рдкрд░реА, рдЕрдиреБрд╣рд╛рд░, рдкрд░реАрдХреЛ рдХрдерд╛, рдЦреЗрд╕реНрд░рд╛ рдХрд▓реНрдкрдирд╛, рд╣реЗрд▓реЛ, рдирд┐рд░реНрджреЛрд╖, рдореБрд╕реНрдХрд╛рди
ЁЯдФ => ЁЯдФ, рдЕрдиреБрд╣рд╛рд░, рд╕реЛрдЪрд┐рд░рд╣реЗрдХреЛ
ЁЯШР => ЁЯШР, рднрд╛рд╡рд╣реАрди, рдЕрдиреБрд╣рд╛рд░, рддрдЯрд╕реНрде
ЁЯШС => ЁЯШС, рдЕрднрд┐рд╡реНрдпрдХреНрддрд┐ рдмрд┐рдирд╛, рдЕрдиреБрд╣рд╛рд░, рднрд╛рд╡рд╢реБрдиреНрдп, рднрд╛рд╡рдирднрдПрдХреЛ
ЁЯШ╢ => ЁЯШ╢, рдЕрдиреБрд╣рд╛рд░, рдореБрдЦ, рд╢рд╛рдиреНрдд, рдЪреБрдк
ЁЯЩД => ЁЯЩД, рдЖрдБрдЦрд╛, рдЕрдиреБрд╣рд╛рд░, рдШреБрдорд┐рд░рд╣реЗрдХреЛ
ЁЯШП => ЁЯШП, рдЕрдиреБрд╣рд╛рд░, рдмрдирд╛рд╡рдЯреА
ЁЯШг => ЁЯШг, рдЕрдиреБрд╣рд╛рд░, рджреГрдз
ЁЯШе => ЁЯШе, рдирд┐рд░рд╛рд╢ рднрдПрдХреЛ, рдЕрдиреБрд╣рд╛рд░, рдЪрд┐рдиреНрддрд╛ рдореБрдХреНрдд рднрдПрдХреЛ, рд╣реНрд╡рд┐рдЙ
ЁЯШо => ЁЯШо, рдЕрдиреБрд╣рд╛рд░, рдореБрдЦ, рдЦреБрд▓рд╛, рд╕рд╣рд╛рдиреБрднреВрддрд┐
ЁЯдР => ЁЯдР, рдЕрдиреБрд╣рд╛рд░, рдореБрдЦ, рдЬрд┐рдкрд░
ЁЯШп => ЁЯШп, рдЕрдиреБрд╣рд╛рд░, рд╢рд╛рдиреНрдд, рд╣реИрд░рд╛рди рднрдПрдХреЛ, рдЖрд╢реНрдЪрд░реНрдп рдЪрдХрд┐рдд рднрдПрдХреЛ
ЁЯШк => ЁЯШк, рдЕрдиреБрд╣рд╛рд░, рд╕реБрддреЗрдХреЛ
ЁЯШл => ЁЯШл, рдЕрдиреБрд╣рд╛рд░, рдерд╛рдХреЗрдХреЛ
ЁЯШ┤ => ЁЯШ┤, рдЕрдиреБрд╣рд╛рд░, рдирд┐рджреНрд░рд╛, рдирд┐рджрд╛рдПрдХреЛ
ЁЯШМ => ЁЯШМ, рдЕрдиреБрд╣рд╛рд░, рдЪрд┐рдиреНрддрд╛ рдореБрдХреНрдд
ЁЯдУ => ЁЯдУ, рдЕрдиреБрд╣рд╛рд░, рд╡рд┐рдЬреНрдЮ, рдХрд┐рддрд╛рдмрдХреЛ рдХрд┐рд░рд╛
ЁЯШЫ => ЁЯШЫ, рдЕрдиреБрд╣рд╛рд░, рдЬрд┐рдмреНрд░реЛ рдмрд╛рд╣рд┐рд░ рдирд┐рд╕реНрдХреЗрдХреЛ
ЁЯШЬ => ЁЯШЬ, рдЖрдБрдЦрд╛, рдЕрдиреБрд╣рд╛рд░, рд░рдорд╛рдЗрд▓реЛ, рдЬрд┐рдмреНрд░реЛ, рдЖрдБрдЦрд╛ рдЭрд┐рдореНрдХрд╛рдЙрдиреЗ
ЁЯШЭ => ЁЯШЭ, рдЖрдБрдЦрд╛, рдЕрдиреБрд╣рд╛рд░, рдбрд░рд▓рд╛рдЧреНрджреЛ, рд╕реНрд╡рд╛рдж, рдЬрд┐рдмреНрд░реЛ
тШ╣ => тШ╣, рдЕрдиреБрд╣рд╛рд░, рд░рд┐рд╕рд╛рдПрдХреЛ
ЁЯЩБ => ЁЯЩБ, рдЕрдиреБрд╣рд╛рд░, рд░рд┐рд╕рд╛рдПрдХреЛ
ЁЯШТ => ЁЯШТ, рдЕрдиреБрд╣рд╛рд░, рдЕрдкреНрд░рд╕рдиреНрди, рд╡реЗрдЦреБрд╢реА
ЁЯШУ => ЁЯШУ, рдЪрд┐рд╕реЛ, рдЕрдиреБрд╣рд╛рд░, рдкрд╕рд┐рдирд╛
ЁЯШФ => ЁЯШФ, рдЙрджрд╛рд╕, рдЕрдиреБрд╣рд╛рд░, рдЪрд┐рдиреНрддрд╛рдЧреНрд░рд╕реНрдд
ЁЯШХ => ЁЯШХ, рджреЛрдзрд╛рд░рдпреБрдХреНрдд, рдЕрдиреБрд╣рд╛рд░
ЁЯШЦ => ЁЯШЦ, рдЪрдХрд┐рдд, рдЕрдиреБрд╣рд╛рд░
ЁЯЩГ => ЁЯЩГ, рдЕрдиреБрд╣рд╛рд░, рдорд╛рдерд┐-рддрд▓ рднрдПрдХреЛ
ЁЯШ╖ => ЁЯШ╖, рдЪрд┐рд╕реЛ, рдбрд╛рдХреНрдЯрд░, рдЕрдиреБрд╣рд╛рд░, рдорд╛рдХреНрд╕, рдФрд╖рдзрд┐, рдмрд┐рдорд╛рд░реА
ЁЯдТ => ЁЯдТ, рдЕрдиреБрд╣рд╛рд░, рдЬреНрд╡рд░реЛ, рдмрд┐рдорд╛рд░реА, рдерд░реНрдореЛрдорд┐рдЯрд░
ЁЯдХ => ЁЯдХ, рдкрдЯреНрдЯрд┐, рдЕрдиреБрд╣рд╛рд░, рдЪреЛрдЯ, рдШрд╛рдЙ
ЁЯдС => ЁЯдС, рдЕрдиреБрд╣рд╛рд░, рдкреИрд╕рд╛, рдореБрдЦ
ЁЯШ▓ => ЁЯШ▓, рджрдВрдЧ рднрдПрдХреЛ, рдЕрдиреБрд╣рд╛рд░, рдЪрдХрд┐рдд, рдкреВрд░реИ
ЁЯШЮ => ЁЯШЮ, рдирд┐рд░рд╛рд╢ рднрдПрдХреЛ, рдЕрдиреБрд╣рд╛рд░
ЁЯШЯ => ЁЯШЯ, рдЕрдиреБрд╣рд╛рд░, рдЪрд┐рдиреНрддрд┐рдд
ЁЯШд => ЁЯШд, рдЕрдиреБрд╣рд╛рд░, рд╕рдлрд▓рддрд╛, рд╡рд┐рдЬрдпреА
ЁЯШв => ЁЯШв, рд░реЛрдПрдХреЛ, рдЕрдиреБрд╣рд╛рд░, рджреБрдГрдЦреА, рдЖрдБрд╢реБ
ЁЯШн => ЁЯШн, рд░реЛрдПрдХреЛ, рдЕрдиреБрд╣рд╛рд░, рджреБрдГрдЦреА, рд╕реБрдХреНрдХрд╕реБрдХреНрдХ, рдЖрдБрд╢реБ
ЁЯШж => ЁЯШж, рдЕрдиреБрд╣рд╛рд░, рддреЗрд╡рд░, рдореБрдЦ, рдЦреБрд▓рд╛
ЁЯШз => ЁЯШз, рджреБрдЦреА, рдЕрдиреБрд╣рд╛рд░
ЁЯШи => ЁЯШи, рдЕрдиреБрд╣рд╛рд░, рдбрд░рд╛рдПрдХреЛ, рдбрд░рд▓рд╛рдЧреНрджреЛ, рднрдпрд╡рд┐рдд
ЁЯШй => ЁЯШй, 
ЁЯШм => ЁЯШм, рдЕрдиреБрд╣рд╛рд░, рдореБрдЦ рдмрдирд╛рдПрдХреЛ
ЁЯШ░ => ЁЯШ░, рдиреАрд▓реЛ, рдЪрд┐рд╕реЛ, рдЕрдиреБрд╣рд╛рд░, рдореБрдЦ, рдЦреБрд▓рд╛, рд╣рддрд╛рд░рд┐рдПрдХреЛ, рдкрд╕рд┐рдирд╛
ЁЯШ▒ => ЁЯШ▒, рдЕрдиреБрд╣рд╛рд░, рдбрд░рд╛рдПрдХреЛ, рдбрд░рд▓рд╛рдЧреНрджреЛ, рдЪрдкрд╛рдЙрдиреЗ, рднрдпрд╡рд┐рдд, рдЪрд┐рдЪреНрдпрд╛рдЙрдиреЗ
ЁЯШ│ => ЁЯШ│, рд╕реНрддрдмреНрдз, рдЕрдиреБрд╣рд╛рд░, рд░рд╛рддреЛ рднрдПрдХреЛ
ЁЯШ╡ => ЁЯШ╡, рд░рд┐рдВрдЧрдЯрд╛ рд▓рд╛рдЧреЗрдХреЛ, рдЕрдиреБрд╣рд╛рд░
ЁЯШб => ЁЯШб, рд░рд┐рд╕рд╛рдПрдХреЛ, рдЕрдиреБрд╣рд╛рд░, рдкрд╛рдЧрд▓, рдореБрдЦ рдлреБрд▓рд╛рдПрдХреЛ, рдЙрдЧреНрд░, рд░рд╛рддреЛ
ЁЯШа => ЁЯШа, рд░рд┐рд╕рд╛рдПрдХреЛ, рдЕрдиреБрд╣рд╛рд░, рдкрд╛рдЧрд▓
ЁЯШИ => ЁЯШИ, рдЕрдиреБрд╣рд╛рд░, рдкрд░реАрдХреЛ рдХрдерд╛, рдЦреЗрд╕реНрд░рд╛ рдХрд▓реНрдкрдирд╛, рд╕рд┐рдВрдЩ, рд╣рд╛рдБрд╕реЛ
ЁЯС┐ => ЁЯС┐, рдкрд┐рд╢рд╛рдЪ, рд░рд╛рдХреНрд╖рд╖, рдЕрдиреБрд╣рд╛рд░, рдкрд░реАрдХреЛ рдХрдерд╛, рдЦреЗрд╕реНрд░рд╛ рдХрд▓реНрдкрдирд╛
ЁЯС╣ => ЁЯС╣, рдЬреАрд╡, рдЕрдиреБрд╣рд╛рд░, рдкрд░реАрдХреЛ рдХрдерд╛, рдЦреЗрд╕реНрд░рд╛ рдХрд▓реНрдкрдирд╛, рдЬрд╛рдкрд╛рдирд┐рдЬ
ЁЯС║ => ЁЯС║, рдЬреАрд╡, рдЕрдиреБрд╣рд╛рд░, рдкрд░реАрдХреЛ рдХрдерд╛, рдЦреЗрд╕реНрд░рд╛ рдХрд▓реНрдкрдирд╛, рдЬрд╛рдкрд╛рдирд┐рдЬ, рд░рд╛рдХреНрд╖рд╕
ЁЯТА => ЁЯТА, рд╢рд░реАрд░, рдореГрддреНрдпреБ, рдЕрдиреБрд╣рд╛рд░, рдЦреЗрд╕реНрд░рд╛ рдХрд▓реНрдкрдирд╛, рд░рд╛рдХреНрд╖рд╕
тШа => тШа, рд╢рд░реАрд░, рдЦреЛрдкрдбреА, рдореГрддреНрдпреБ, рдЕрдиреБрд╣рд╛рд░, рд░рд╛рдХреНрд╖рд╕, рдЦрдкреНрдкрд░
ЁЯС╗ => ЁЯС╗, рдЬреАрд╡, рдЕрдиреБрд╣рд╛рд░, рдкрд░реАрдХреЛ рдХрдерд╛, рдЦреЗрд╕реНрд░рд╛ рдХрд▓реНрдкрдирд╛, рд░рд╛рдХреНрд╖рд╕
ЁЯС╜ => ЁЯС╜, рдЬреАрд╡, рдЕрдВрддрд░рд┐рдХреНрд╖рд╡рд╛рд╕реА, рдЕрдиреБрд╣рд╛рд░, рдкрд░реАрдХреЛ рдХрдерд╛, рдЦреЗрд╕реНрд░рд╛ рдХрд▓реНрдкрдирд╛, рдЕрдВрддрд░рд┐рдХреНрд╖, рдЕрдЬреНрдЮрд╛рдд рдЙрдбреНрдиреЗ рд╡рд╕реНрддреБ
ЁЯС╛ => ЁЯС╛, рдЬреАрд╡, рдЕрдВрддрд░рд┐рдХреНрд╖рд╡рд╛рд╕реА, рдЕрдиреБрд╣рд╛рд░, рдкрд░реАрдХреЛ рдХрдерд╛, рдЦреЗрд╕реНрд░рд╛ рдХрд▓реНрдкрдирд╛, рд░рд╛рдХреНрд╖рд╕, рдЕрдВрддрд░рд┐рдХреНрд╖, рдЕрдЬреНрдЮрд╛рдд рдЙрдбреНрдиреЗ рд╡рд╕реНрддреБ
ЁЯдЦ => ЁЯдЦ, рдЕрдиреБрд╣рд╛рд░, рд░рд╛рдХреНрд╖рд╕, рд░реЛрдмреЛрдЯ
ЁЯТй => ЁЯТй, рд╣рд╛рд╕реНрдпрдкреНрд░рдж, рдЕрдВрдзрдХреБрдк, рдЕрдиреБрд╣рд╛рд░, рд░рд╛рдХреНрд╖рд╕, рдкреБ, рдкрдк
ЁЯШ║ => ЁЯШ║, рдмрд┐рд░рд╛рд▓реЛ, рдЕрдиреБрд╣рд╛рд░, рдореБрдЦ, рдЦреБрд▓рд╛, рдореБрд╕реНрдХрд╛рди
ЁЯШ╕ => ЁЯШ╕, рдмрд┐рд░рд╛рд▓реЛ, рдЖрдБрдЦрд╛, рдЕрдиреБрд╣рд╛рд░, рд╣рдБрд╕рд┐рд▓реЛ, рдореБрд╕реНрдХрд╛рди
ЁЯШ╣ => ЁЯШ╣, рдмрд┐рд░рд╛рд▓реЛ, рдЕрдиреБрд╣рд╛рд░, рд░рдорд╛рдПрдХреЛ, рдЖрдБрд╢реБ
ЁЯШ╗ => ЁЯШ╗, рдмрд┐рд░рд╛рд▓реЛ, рдЖрдБрдЦрд╛, рдЕрдиреБрд╣рд╛рд░, рдореБрдЯреБ, рдорд╛рдпрд╛, рдореБрд╕реНрдХрд╛рди
ЁЯШ╝ => ЁЯШ╝, рдмрд┐рд░рд╛рд▓реЛ, рдЕрдиреБрд╣рд╛рд░, рд╡реНрдпрдВрдЧрд╛рддреНрдордХ, рдореБрд╕реНрдХрд╛рди, рд╡реНрдпрдВрдЧреНрдпрдкреВрд░реНрдг рд╣рд╛рдБрд╕реЛ
ЁЯШ╜ => ЁЯШ╜, рдмрд┐рд░рд╛рд▓реЛ, рдЖрдБрдЦрд╛, рдЕрдиреБрд╣рд╛рд░, рдЪреБрдореНрдмрди
ЁЯЩА => ЁЯЩА, рдмрд┐рд░рд╛рд▓реЛ, рдЕрдирд╛рд╣рд╛рд░ рдЕрд╣реЛ, рдЖрд╢реНрдЪрд░реНрдпрдЪрдХрд┐рдд, рдерд╛рдХреЗрдХреЛ
ЁЯШ┐ => ЁЯШ┐, рдмрд┐рд░рд╛рд▓реЛ, рд░реЛрдЗрд░рд╣реЗрдХреЛ, рдЕрдиреБрд╣рд╛рд░, рджреБрдГрдЦреА, рдЖрдБрд╢реБ
ЁЯШ╛ => ЁЯШ╛, рдмрд┐рд░рд╛рд▓реЛ, рдЕрдиреБрд╣рд╛рд░, рдореБрдЦ рдлреБрд▓рд╛рдЗрд░рд╣реЗрдХреЛ
ЁЯЩИ => ЁЯЩИ, рджреБрд╖реНрдЯрддрд╛, рдЕрдиреБрд╣рд╛рд░, рдирд┐рд╖реЗрдз рдЧрд░рд┐рдПрдХреЛ, рдЗрд╢рд╛рд░рд╛, рдмрд╛рдБрджрд░, рд╣реЛрдЗрди, рдЫреИрди, рдирд┐рд╖реЗрдзрд┐рдд, рд╣реЗрд░реНрди
ЁЯЩЙ => ЁЯЩЙ, рджреБрд╖реНрдЯрддрд╛, рдЕрдиреБрд╣рд╛рд░, рдирд┐рд╖реЗрдз рдЧрд░рд┐рдПрдХреЛ, рдЗрд╢рд╛рд░рд╛, рд╕реБрдиреНрдиреЗ, рдмрд╛рдБрджрд░, рд╣реЛрдЗрди, рдЫреИрди, рдирд┐рд╖реЗрдзрд┐рдд
ЁЯЩК => ЁЯЩК, рджреБрд╖реНрдЯрддрд╛, рдЕрдиреБрд╣рд╛рд░, рдирд┐рд╖реЗрдз рдЧрд░рд┐рдПрдХреЛ, рдЗрд╢рд╛рд░рд╛, рдмрд╛рдБрджрд░, рд╣реЛрдЗрди, рдЫреИрди, рдирд┐рд╖реЗрдзрд┐рдд, рдмреЛрд▓реНрди
ЁЯСз => ЁЯСз, рдХреБрдорд╛рд░реА, рдХрдиреНрдпрд╛, рд░рд╛рд╢рд┐
ЁЯС┤ => ЁЯС┤, рдЫреЛрд░рд╛рдорд╛рдиреНрдЫреЗ, рдмреВрдвреЛ
ЁЯС╡ => ЁЯС╡, рдорд╣рд┐рд▓рд╛, рдмреВрдвреА
ЁЯС▒ => ЁЯС▒, рдлреБрд▓реЗрдХреЛ
ЁЯСо => ЁЯСо, рдЕрдлрд┐рд╕рд░, рдкреБрд▓рд┐рд╕
ЁЯС▓ => ЁЯС▓, рдЪрд┐рдирд┐рдпрд╛рдБ, рдЯреЛрдкреА, рдорд╛рдиреНрдЫреЗ
ЁЯС│ => ЁЯС│, рдорд╛рдиреНрдЫреЗ, рдлреЗрдЯрд╛
ЁЯС╖ => ЁЯС╖, рдирд┐рд░реНрдорд╛рдг, рдЯреЛрдкреА, рдХрд░реНрдордЪрд╛рд░реА
тЫС => тЫС, рд╕рд╛рдзрди, рдХреНрд░рд╕, рдЕрдиреБрд╣рд╛рд░, рдЯреЛрдкреА, рд╣реЗрд▓рдореЗрдЯ
ЁЯС╕ => ЁЯС╕, рдкрд░реАрдХреЛ рдХрдерд╛, рдЦреЗрд╕реНрд░рд╛ рдХрд▓реНрдкрдирд╛
ЁЯТВ => ЁЯТВ, рдвреЛрдХреЗрдкрд╛рд▓
ЁЯОЕ => ЁЯОЕ, рд╕рдорд╛рд░реЛрд╣, рдкрд░реАрдХреЛ рдХрдерд╛, рдЦреЗрд╕реНрд░рд╛ рдХрд▓реНрдкрдирд╛, рдмреБрдмрд╛, рд╕рд╛рдиреНрддрд╛
ЁЯС╝ => ЁЯС╝, рдкрд░реА, рдмрдЪреНрдЪрд╛, рдЕрдиреБрд╣рд╛рд░, рдкрд░реАрдХреЛ рдХрдерд╛, рдЦреЗрд╕реНрд░рд╛ рдХрд▓реНрдкрдирд╛
ЁЯТЖ => ЁЯТЖ, рдорд╕рд╛рдЬ, рд╕реИрд▓реБрди
ЁЯТЗ => ЁЯТЗ, рд╕реБрдиреНрджрд░, рдкрд╛рд░реНрд▓рд░
ЁЯС░ => ЁЯС░, рдмреЗрд╣реБрд▓реА, рдШреБрдореНрдЯреЛ, рдмрд┐рд╡рд╛рд╣
ЁЯЩН => ЁЯЩН, рднрд╛рд╡ рдкреНрд░рджрд░реНрд╢рди
ЁЯЩО => ЁЯЩО, рднрд╛рд╡ рдкреНрд░рджрд░реНрд╢рди
ЁЯЩЖ => ЁЯЩЖ, рднрд╛рд╡ рдкреНрд░рджрд░реНрд╢рди, рд╣рд╛рдд, рдареАрдХ
ЁЯТБ => ЁЯТБ, рд╣рд╛рдд, рдорджреНрджрдд рдЬрд╛рдирдХрд╛рд░реА, рд╕реЗрд╕реА
ЁЯЩЛ => ЁЯЩЛ, рднрд╛рд╡ рдкреНрд░рджрд░реНрд╢рди, рд╣рд╛рдд, рдЦреБрд╢реА, рдЙрдард╛рдПрдХреЛ
ЁЯЩЗ => ЁЯЩЗ, рдХреНрд╖рдорд╛, рдмреЛ, рднрд╛рд╡ рдкреНрд░рджрд░реНрд╢рди, рджреБ:рдЦреА
ЁЯЩМ => ЁЯЩМ, рд╢рд░реАрд░, рд╕рдорд╛рд░реЛрд╣, рднрд╛рд╡ рдкреНрд░рджрд░реНрд╢рди, рд╣рд╛рдд, рд╣реБрд░реНрд░реЗ, рдЙрдард╛рдПрдХреЛ
ЁЯЩП => ЁЯЩП, рд╕реЛрдзреНрди, рд╢рд░реАрд░, рдмреЛ, рджреЛрдмреНрд░реЗрдХреЛ, рднрд╛рд╡ рдкреНрд░рджрд░реНрд╢рди, рд╣рд╛рдд, рдХреГрдкрдпрд╛, рдкреНрд░рд╛рдердирд╛, рдзрдиреНрдпрд╡рд╛рдж
ЁЯСд => ЁЯСд, рдмрд╕реНрдЯ, рдЫрд╛рдпрд╛рдЪрд┐рддреНрд░
ЁЯСе => ЁЯСе, рдмрд╕реНрдЯ, рдЫрд╛рдпрд╛рдЪрд┐рддреНрд░
ЁЯЪ╢ => ЁЯЪ╢, рд╣рд╛рдЗрдХ, рд╣рд┐рдбреНрдиреЗ, рд╣рд┐рдБрдбрд┐рд░рд╣реЗрдХреЛ
ЁЯПГ => ЁЯПГ, рдореНрдпрд╛рд░рд╛рдереБрди
ЁЯСп => ЁЯСп, рдмрдиреА, рдирд░реНрддрдХреА, рдХрд╛рди, рдХреЗрдЯреА, рдорд╣рд┐рд▓рд╛
ЁЯХ┤ => ЁЯХ┤, рд╡реНрдпрд╡рд╕рд╛рдп, рдкреБрд░реБрд╖, рд╕реБрдЯ
ЁЯТП => ЁЯТП, рдЬреЛрдбреА, рдордиреЛрд░рдиреНрдЬрди
ЁЯТС => ЁЯТС, рдЬреЛрдбреА, рдореБрдЯреБ, рдорд╛рдпрд╛, рдордиреЛрд░рдиреНрдЬрди
ЁЯСк => ЁЯСк, рдмрдЪреНрдЪрд╛, рдмреБрдмрд╛, рдЖрдорд╛
ЁЯСл => ЁЯСл, рдЬреЛрдбреА, рд╣рд╛рдд, рд╕рдорд╛рддреЗрдХреЛ, рдкреБрд░реБрд╖, рдорд╣рд┐рд▓рд╛
ЁЯСм => ЁЯСм, рдЬреЛрдбреА, рдорд┐рдереБрди, рд╣рд╛рдд, рд╕рдорд╛рддреЗрдХреЛ, рдкреБрд░реБрд╖, рд░рд╛рд╢рд┐
ЁЯСн => ЁЯСн, рдЬреЛрдбреА, рд╣рд╛рдд, рд╕рдорд╛рддреЗрдХреЛ, рдорд╣рд┐рд▓рд╛
ЁЯП╗ => ЁЯП╗, рдЗрдореЛрдЬреА рдкрд░рд┐рдорд╛рд░реНрдЬрдХ, рдлрд┐рдЯрдкрд╛рдЯреНрд░рд┐рдХ, рдЫрд╛рд▓рд╛, рдЯреЛрди
ЁЯП╝ => ЁЯП╝, рдЗрдореЛрдЬреА рдкрд░рд┐рдорд╛рд░реНрдЬрдХ, рдлрд┐рдЯрдкрд╛рдЯреНрд░рд┐рдХ, рдЫрд╛рд▓рд╛, рдЯреЛрди
ЁЯП╜ => ЁЯП╜, рдЗрдореЛрдЬреА рдкрд░рд┐рдорд╛рд░реНрдЬрдХ, рдлрд┐рдЯрдкрд╛рдЯреНрд░рд┐рдХ, рдЫрд╛рд▓рд╛, рдЯреЛрди
ЁЯП╛ => ЁЯП╛, рдЗрдореЛрдЬреА рдкрд░рд┐рдорд╛рд░реНрдЬрдХ, рдлрд┐рдЯрдкрд╛рдЯреНрд░рд┐рдХ, рдЫрд╛рд▓рд╛, рдЯреЛрди
ЁЯП┐ => ЁЯП┐, рдЗрдореЛрдЬреА рдкрд░рд┐рдорд╛рд░реНрдЬрдХ, рдлрд┐рдЯрдкрд╛рдЯреНрд░рд┐рдХ, рдЫрд╛рд▓рд╛, рдЯреЛрди
ЁЯТк => ЁЯТк, рдмрд╛рдЗрд╕реЗрдкреНрд╕, рд╢рд░реАрд░, рд╣рдБрд╕рд╛рдЙрдиреЗ, рдлреНрд▓реЗрдХреНрд╕, рдорд╛рдВрд╢рдкреЗрд╢реА
ЁЯСИ => ЁЯСИ, рдкрдЫрд╛рдбрд┐рдХреЛ рд╣рд╛рдд, рд╢рд░реАрд░ рдФрдВрд▓рд╛, рд╣рд╛рдд, рд╕реВрдЪрдХ, рд╕рдВрдХреЗрдд
ЁЯСЙ => ЁЯСЙ, рдкрдЫрд╛рдбрд┐рдХреЛ рд╣рд╛рдд, рд╢рд░реАрд░, рдФрдВрд▓рд╛, рд╣рд╛рдд, рд╕реВрдЪрдХ, рд╕рдВрдХреЗрдд
тШЭ => тШЭ, рд╢рд░реАрд░, рдФрдВрд▓рд╛, рд╣рд╛рдд, рд╕реВрдЪрдХ, рд╕рдВрдХреЗрдд, рдорд╛рдерд┐
ЁЯСЖ => ЁЯСЖ, рдкрдЫрд╛рдбрд┐рдХреЛ рд╣рд╛рдд, рд╢рд░реАрд░, рдФрдВрд▓рд╛, рд╣рд╛рдд, рд╕реВрдЪрдХ, рд╕рдВрдХреЗрдд, рдорд╛рдерд┐
ЁЯЦХ => ЁЯЦХ, рд╢рд░реАрд░, рдФрдВрд▓рд╛, рд╣рд╛рдд
ЁЯСЗ => ЁЯСЗ, рдкрдЫрд╛рдбрд┐рдХреЛ рд╣рд╛рдд, рд╢рд░реАрд░, рддрд▓, рдФрдВрд▓рд╛, рд╣рд╛рдд, рд╕реВрдЪрдХ, рд╕рдВрдХреЗрдд
тЬМ => тЬМ, рд╢рд░реАрд░, рд╣рд╛рдд, рднреА, рд╡рд┐рдЬрдпреА
ЁЯЦЦ => ЁЯЦЦ, рд╢рд░реАрд░, рдФрдВрд▓рд╛, рд╣рд╛рдд, рд╕рд▓рд╛рдореА, рдмрд▓реНрдХрди
ЁЯдШ => ЁЯдШ, рд╢рд░реАрд░, рдФрдВрд▓рд╛, рд╣рд╛рдд, рд╕рд┐рдЩреН, рд░рдХ-рдЕрди
ЁЯЦР => ЁЯЦР, рд╢рд░реАрд░, рдФрдВрд▓рд╛, рд╣рд╛рдд, рдлреИрд▓рд╛рдПрдХреЛ
тЬЛ => тЬЛ, рд╢рд░реАрд░, рд╣рд╛рдд
ЁЯСМ => ЁЯСМ, рд╢рд░реАрд░, рд╣рд╛рдд, рдареАрдХ
ЁЯСО => ЁЯСО, рд╢рд░реАрд░, рддрд▓, рд╣рд╛рдд, рдмреБрдвреА рдФрдВрд▓рд╛
тЬК => тЬК, рд╢рд░реАрд░, рдХреНрд▓реЗрдиреНрдЪ рдЧрд░рд┐рдПрдХреЛ, рдореБрдареНрдареА, рд╣рд╛рдд, рдореБрдХреНрдХрд╛
ЁЯСК => ЁЯСК, рд╢рд░реАрд░, рдХреНрд▓реЗрдиреНрдЪ рдЧрд░рд┐рдПрдХреЛ, рдореБрдареНрдареА, рд╣рд╛рдд, рдореБрдХреНрдХрд╛
ЁЯСЛ => ЁЯСЛ, рд╢рд░реАрд░, рд╣рд╛рдд, рд╣рд▓реНрд▓реЗрдХреЛ, рд╣рд▓реНрд▓рд╛рдЗрд░рд╣реЗрдХреЛ
ЁЯСП => ЁЯСП, рд╢рд░реАрд░, рддрд╛рд▓реА, рд╣рд╛рдд
ЁЯСР => ЁЯСР, рд╢рд░реАрд░, рд╣рд╛рдд, рдЦреБрд▓рд╛
тЬН => тЬН, рд╢рд░реАрд░, рд╣рд╛рдд, рд▓реЗрдЦреНрдиреЗ
ЁЯТЕ => ЁЯТЕ, рд╢рд░реАрд░, рд╣реЗрд░рдЪрд╛рд╣, рд╢реНрд░реГрдЩреНрдЧрд╛рд░, рдореНрдпрд╛рдирд┐рдХреНрдпреБрд░, рдирдЩреН, рдкрд╛рд▓рд┐рд╕
ЁЯСВ => ЁЯСВ, рд╢рд░реАрд░
ЁЯСГ => ЁЯСГ, рд╢рд░реАрд░
ЁЯСг => ЁЯСг, рд╢рд░реАрд░, рдХрдкрдбрд╛, рдбреЛрдм
ЁЯСА => ЁЯСА, рд╢рд░реАрд░, рдЖрдБрдЦрд╛, рдЕрдиреБрд╣рд╛рд░
ЁЯСБ => ЁЯСБ, рд╢рд░реАрд░
ЁЯСЕ => ЁЯСЕ, рд╢рд░реАрд░
ЁЯСД => ЁЯСД, рд╢рд░реАрд░, рдУрда
ЁЯТЛ => ЁЯТЛ, рдореБрдЯреБ, рдЪреБрдореНрдмрди, рдУрда, рдЪрд┐рдиреНрд╣, рдордиреЛрд░рдиреНрдЬрди
ЁЯТШ => ЁЯТШ, рд╡рд╛рдг, рдХреБрдкрд┐рдб, рдореБрдЯреБ, рдордиреЛрд░рдиреНрдЬрди
ЁЯТУ => ЁЯТУ, рдзрдбреНрдХрд┐рд░рд╣реЗрдХреЛ, рдореБрдЯреБ, рдореБрдЯреБрдХреЛ рдзрдбреНрдХрди, рдкрд▓реНрд╕реЗрдЯрд┐рдЩ
ЁЯТФ => ЁЯТФ, рдЯреБрдЯреЗрдХреЛ, рдЯреБрдХреНрд░рд┐рдПрдХреЛ, рдореБрдЯреБ
ЁЯТХ => ЁЯТХ, рдореБрдЯреБ, рдорд╛рдпрд╛
ЁЯТЦ => ЁЯТЦ, рдЙрддреНрд╕рд╛рд╣рд┐рдд, рдореБрдЯреБ, рдЪрдордХрджрд╛рд░
ЁЯТЧ => ЁЯТЧ, рдЙрддреНрд╕рд╛рд╣рд┐рдд, рд╡рд┐рдХрд╕рд┐рдд, рдореБрдЯреБ, рд╣рд░реНрдЯрдкреНрд▓рд╕, рдЪрд┐рдиреНрддрд┐рдд
ЁЯТЩ => ЁЯТЩ, рдиреАрд▓реЛ, рдореБрдЯреБ
ЁЯТЪ => ЁЯТЪ, рд╣рд░рд┐рдпреЛ, рдореБрдЯреБ
ЁЯТЫ => ЁЯТЫ, рдореБрдЯреБ, рдкрд╣реЗрдБрд▓реЛ
ЁЯТЬ => ЁЯТЬ, рдореБрдЯреБ, рдкреНрдпрд╛рдЬреА
ЁЯТЭ => ЁЯТЭ, рдореБрдЯреБ, рд░рд┐рдмрди, рднреНрдпрд╛рд▓реЗрдиреНрдЯрд╛рдЗрди
ЁЯТЮ => ЁЯТЮ, рдореБрдЯреБ, рдШреБрдорд┐рд░рд╣реЗрдХреЛ
ЁЯТЯ => ЁЯТЯ, рдореБрдЯреБ
тЭг => тЭг, рд╡рд┐рд╕реНрдордпрд╛рдзрд┐рдмрдзрдХ рдЪрд┐рдиреНрд╣, рдореБрдЯреБ, рдЪрд┐рдиреНрд╣, рд╡рд┐рд░рд╛рдо рдЪрд┐рдиреНрд╣
ЁЯТМ => ЁЯТМ, рдореБрдЯреБ, рдЪрд┐рдареНрдареА, рдорд╛рдпрд╛, рдореЗрд▓, рдордиреЛрд░рдиреНрдЬрди
ЁЯТд => ЁЯТд, рд╣рдБрд╕рд╛рдЙрдиреЗ
ЁЯТв => ЁЯТв, рд░рд┐рд╕, рд╣рдБрд╕рд╛рдЙрдиреЗ, рдкрд╛рдЧрд▓
ЁЯТг => ЁЯТг, рд╣рдБрд╕рд╛рдЙрдиреЗ
ЁЯТе => ЁЯТе, рдмреБрдо, рд╣рдБрд╕рд╛рдЙрдиреЗ
ЁЯТж => ЁЯТж, рд╣рдБрд╕рд╛рдЙрдиреЗ, рд╕реНрдкреНрд▓реНрдпрд╛рд╕рд┐рдЩреН, рдкрд╕рд┐рдирд╛
ЁЯТи => ЁЯТи, рд╣рдБрд╕рд╛рдЙрдиреЗ, рдбреНрдпрд╛рд╢, рджреМрдбрд┐рд░рд╣реЗрдХреЛ
ЁЯТл => ЁЯТл, рд╣рдБрд╕рд╛рдЙрдиреЗ, рддрд╛рд░рд╛
ЁЯТм => ЁЯТм, рдмреЗрд▓реБрди, рдлреЛрдХрд╛, рд╣рдБрд╕рд╛рдЙрдиреЗ, рд╕рдВрд╡рд╛рдж, рд╡рд╛рдХреНрдп
ЁЯЧи => ЁЯЧи, рд╕рдореНрд╡рд╛рдж, рд╡рд╛рдХреНрдп
ЁЯЧп => ЁЯЧп, рд░рд┐рд╕, рдмреЗрд▓реБрди, рдлреЛрдХрд╛, рдкрд╛рдЧрд▓
ЁЯТн => ЁЯТн, рдмреЗрд▓реБрди, рдлреЛрдХрд╛, рд╣рдБрд╕рд╛рдЙрдиреЗ, рд╡рд┐рдЪрд╛рд░
ЁЯСУ => ЁЯСУ, рдХрдкрдбрд╛, рдЖрдБрдЦрд╛, рдЖрдБрдЦрд╛рдХреЛ рдЪрд╕реНрдорд╛, рдЖрдБрдЦрд╛рдорд╛ рд▓рдЧрд╛рдЙрдиреЗ
ЁЯХ╢ => ЁЯХ╢, рдЕрдБрдзреНрдпрд╛рд░реЛ, рдЖрдБрдЦрд╛, рдЖрдБрдЦрд╛рдорд╛ рд▓рдЧрд╛рдЙрдиреЗ, рдЪрд╕реНрдорд╛
ЁЯСФ => ЁЯСФ, рдХрдкрдбрд╛
ЁЯСХ => ЁЯСХ, рдХрдкрдбрд╛, рдЯрд┐рд╕рд░реНрдЯ
ЁЯСЦ => ЁЯСЦ, рдХрдкрдбрд╛, рдкреЗрдиреНрдЯ, рдЯреНрд░рд╛рдЙрдЬрд░
ЁЯСШ => ЁЯСШ, рдХрдкрдбрд╛
ЁЯСЩ => ЁЯСЩ, рдХрдкрдбрд╛, рдкреМрдбрд┐рдиреЗ
ЁЯСЪ => ЁЯСЪ, рдХрдкрдбрд╛, рдорд╣рд┐рд▓рд╛
ЁЯСЫ => ЁЯСЫ, рдХрдкрдбрд╛, рд╕рд┐рдХреНрдХрд╛
ЁЯСЬ => ЁЯСЬ, рдмреНрдпрд╛рдЧ, рдХрдкрдбрд╛
ЁЯСЭ => ЁЯСЭ, рдмреНрдпрд╛рдЧ, рдХрдкрдбрд╛
ЁЯСЮ => ЁЯСЮ, рдХрдкрдбрд╛, рдкреБрд░реБрд╖рдХреЛ, рдЬреБрддреНрддрд╛
ЁЯСС => ЁЯСС, рдХрдкрдбрд╛, рд░рд╛рдЬрд╛, рд░рд╛рдиреА
ЁЯСТ => ЁЯСТ, рдХрдкрдбрд╛, рдЯреЛрдкреА, рдорд╣рд┐рд▓рд╛
ЁЯОй => ЁЯОй, рдХрдкрдбрд╛, рдЯреЛрдкреА, рд╢реАрд░реНрд╖, рд╢реАрд░реНрд╖рдЯреЛрдкреА
ЁЯР╡ => ЁЯР╡, рдЕрдиреБрд╣рд╛рд░, рдмрд╛рдБрджрд░
ЁЯР╢ => ЁЯР╢, рдХреБрдХреБрд░, рдЕрдиреБрд╣рд╛рд░, рдкрд╛рд▓реНрддреБ
ЁЯРХ => ЁЯРХ, рдкрд╛рд▓реНрддреБ
ЁЯРй => ЁЯРй, рдХреБрдХреБрд░
ЁЯР▒ => ЁЯР▒, рдмрд┐рд░рд╛рд▓реЛ, рдЕрдиреБрд╣рд╛рд░, рдкрд╛рд▓реНрддреБ
ЁЯРИ => ЁЯРИ, рдкрд╛рд▓реНрддреБ
ЁЯжБ => ЁЯжБ, рдЕрдиреБрд╣рд╛рд░, рд╕рд┐рдВрд╣, рд░рд╛рд╢рд┐
ЁЯРп => ЁЯРп, рдЕрдиреБрд╣рд╛рд░, рдмрд╛рдШ
ЁЯР┤ => ЁЯР┤, рдЕрдиреБрд╣рд╛рд░, рдШреЛрдбрд╛
ЁЯРО => ЁЯРО, рджреМрдбрд┐рдиреЗрдШреЛрдбрд╛, рджреМрдбрд┐рдиреЗ
ЁЯжД => ЁЯжД, рдЕрдиреБрд╣рд╛рд░, рдЧреИрдБрдбрд╛
ЁЯРо => ЁЯРо, рдЧрд╛рдИ, рдЕрдиреБрд╣рд╛рд░
ЁЯР╖ => ЁЯР╖, рдЕрдиреБрд╣рд╛рд░, рд╕реБрдБрдЧреБрд░
ЁЯРЦ => ЁЯРЦ, рд╕реБрдБрдЧреБрд░
ЁЯРЧ => ЁЯРЧ, рд╕реБрдБрдЧреБрд░
ЁЯР╜ => ЁЯР╜, рдЕрдиреБрд╣рд╛рд░, рдирд╛рдХ, рд╕реБрдБрдЧреБрд░
ЁЯРП => ЁЯРП, рдореЗрд╖, рд░рд╛рд╢рд┐
ЁЯРС => ЁЯРС, рднреЗрдбрд╛
ЁЯРР => ЁЯРР, рд░рд╛рд╢рд┐
ЁЯРк => ЁЯРк, рдбреНрд░реЛрдореЗрдбрд░реА
ЁЯРл => ЁЯРл, рдмреНрдпрд╛рдХреНрдЯреНрд░рд┐рдпрди, рдКрдБрдЯ, рдЬреБрд░реЛ
ЁЯРн => ЁЯРн, рдЕрдиреБрд╣рд╛рд░, рдореБрд╕рд╛
ЁЯР╣ => ЁЯР╣, рдЕрдиреБрд╣рд╛рд░, рд╣реНрдпрд╛рдореНрд╕реНрдЯрд░, рдкрд╛рд▓реНрддреБ
ЁЯР░ => ЁЯР░, рдЦрд░рд╛рдпреЛ, рдЕрдиреБрд╣рд╛рд░, рдкрд╛рд▓реНрддреБ
ЁЯРЗ => ЁЯРЗ, рдкрд╛рд▓реНрддреБ
ЁЯР┐ => ЁЯР┐, рдЪреАрдкрдордХ
ЁЯР╗ => ЁЯР╗, рднрд╛рд▓реБ, рдЕрдиреБрд╣рд╛рд░
ЁЯР╝ => ЁЯР╝, рдЕрдиреБрд╣рд╛рд░, рдкрд╛рдгреНрдбрд╛
ЁЯР╛ => ЁЯР╛, рдк, рдбреЛрдм
ЁЯРг => ЁЯРг, рдмрдЪреНрдЪрд╛, рдЪрд▓реНрд▓рд╛, рдХреЛрд░рд▓рд┐рджреИ рдЧрд░реЗрдХреЛ
ЁЯРд => ЁЯРд, рдмрдЪреНрдЪрд╛, рдЪрд▓реНрд▓рд╛
ЁЯРе => ЁЯРе, рдмрдЪреНрдЪрд╛, рдЪрд▓реНрд▓рд╛
ЁЯХК => ЁЯХК, рдЪрд░рд╛, рдЙрдбреНрдиреЗ
ЁЯР╕ => ЁЯР╕, рдЕрдиреБрд╣рд╛рд░, рднреНрдпрд╛рдЧреБрддреЛ
ЁЯРН => ЁЯРН, рд░рд╛рд╢рд┐
ЁЯР▓ => ЁЯР▓, рдбреНрд░рдпрд╛рдЧрди, рдЕрдиреБрд╣рд╛рд░, рдкрд░реАрдХреЛ рдХрдерд╛
ЁЯРЙ => ЁЯРЙ, рдкрд░реАрдХреЛ рдХрдерд╛
ЁЯР│ => ЁЯР│, рдЕрдиреБрд╣рд╛рд░, рд╕реНрдкрд╛рдЙрдЯрд┐рдЩреН, рд╣реНрд╡реЗрд▓
ЁЯРЯ => ЁЯРЯ, рд░рд╛рд╢рд┐
ЁЯРа => ЁЯРа, рдорд╛рдЫрд╛, рдЙрд╖реНрдгрдкреНрд░рджреЗрд╢реАрдп
ЁЯРб => ЁЯРб, рдорд╛рдЫрд╛
ЁЯРЪ => ЁЯРЪ, рд╕реЗрд▓, рд╕реНрдкрд┐рд░рд▓
ЁЯжА => ЁЯжА, рдХреНрдпрд╛рдиреНрд╕рд░, рд░рд╛рд╢рд┐
ЁЯРМ => ЁЯРМ, рд╕реНрдиреЗрд▓
ЁЯРЭ => ЁЯРЭ, рдХрдорд┐рд▓рд╛
ЁЯРЮ => ЁЯРЮ, рдХрдорд┐рд▓рд╛
ЁЯХ╖ => ЁЯХ╖, рдХрдорд┐рд▓рд╛
ЁЯХ╕ => ЁЯХ╕, рдорд╛рдХреБрд░рд╛, рдЬрд╛рд▓реЛ
ЁЯжВ => ЁЯжВ, рд░рд╛рд╢рд┐
ЁЯТР => ЁЯТР, рдлреВрд▓, рдмрд┐рд░реВрд╡рд╛, рдордиреЛрд░рдиреНрдЬрди
ЁЯМ╕ => ЁЯМ╕, рдлреБрд▓реНрдиреЗ, рдЪреЗрд░реА, рдлреВрд▓, рдмрд┐рд░реВрд╡рд╛
ЁЯТо => ЁЯТо, рдлреБрд▓
ЁЯП╡ => ЁЯП╡, рдмрд┐рд░реВрд╡рд╛
ЁЯМ╣ => ЁЯМ╣, рдлреВрд▓, рдмрд┐рд░реВрд╡рд╛
ЁЯМ║ => ЁЯМ║, рдлреВрд▓, рдмрд┐рд░реВрд╡рд╛
ЁЯМ╗ => ЁЯМ╗, рдлреВрд▓, рдмрд┐рд░реВрд╡рд╛, рд╕реВрд░реНрдп
ЁЯМ╝ => ЁЯМ╝, рдлреВрд▓, рдмрд┐рд░реВрд╡рд╛
ЁЯМ╖ => ЁЯМ╖, рдлреВрд▓, рдмрд┐рд░реВрд╡рд╛
ЁЯМ▒ => ЁЯМ▒, рдмрд┐рд░реВрд╡рд╛, рднрд░реНрдЦрд░рдХреЛ
ЁЯМ▓ => ЁЯМ▓, рдмрд┐рд░реВрд╡рд╛, рд░реВрдЦ
ЁЯМ│ => ЁЯМ│, рдкрд░реНрдгрдкрд╛рддреА рд░реВрдЦ
ЁЯМ╡ => ЁЯМ╡, рдмрд┐рд░реВрд╡рд╛
ЁЯМ╛ => ЁЯМ╛, рдХрд╛рди, рдмрд┐рд░реВрд╡рд╛, рдЪрд╛рдорд▓
ЁЯМ┐ => ЁЯМ┐, рдкрд╛рдд, рдмрд┐рд░реВрд╡рд╛
тШШ => тШШ, рдмрд┐рд░реВрд╡рд╛
ЁЯНА => ЁЯНА, 4, рдХреНрд▓реЛрднрд░, рдЪрд╛рд░, рдкрд╛рдд, рдмрд┐рд░реВрд╡рд╛
ЁЯНБ => ЁЯНБ, рдЭрд░реЗрдХреЛ, рдкрд╛рдд, рдореЗрдкрд▓, рдмрд┐рд░реВрд╡рд╛
ЁЯНВ => ЁЯНВ, рдЭрд░реЗрдХреЛ, рдкрд╛рдд, рдмрд┐рд░реВрд╡рд╛
ЁЯНГ => ЁЯНГ, рдлрд░рдлрд░рд╛рдПрдХреЛ, рдлреНрд▓рдЯрд░, рдкрд╛рдд, рдмрд┐рд░реВрд╡рд╛, рд╣рд╛рд╡рд╛
ЁЯНЗ => ЁЯНЗ, рдлрд▓рдлреВрд▓, рдмрд┐рд░реВрд╡рд╛
ЁЯНИ => ЁЯНИ, рдлрд▓рдлреВрд▓
ЁЯНЙ => ЁЯНЙ, рдлрд▓рдлреВрд▓
ЁЯНК => ЁЯНК, рдлрд▓рдлреВрд▓, рд╕реБрдиреНрдирддрд▓рд╛, рдмрд┐рд░реВрд╡рд╛
ЁЯНЛ => ЁЯНЛ, рдлрд▓рдлреВрд▓, рдмрд┐рд░реВрд╡рд╛
ЁЯНМ => ЁЯНМ, рдлрд▓рдлреВрд▓, рдмрд┐рд░реВрд╡рд╛
ЁЯНН => ЁЯНН, рдлрд▓рдлреВрд▓
ЁЯНО => ЁЯНО, рд╕реНрдпрд╛рдЙ, рдлрд▓рдлреВрд▓, рдмрд┐рд░реВрд╡рд╛, рд░рд╛рддреЛ
ЁЯНП => ЁЯНП, рд╕реНрдпрд╛рдЙ, рдлрд▓рдлреВрд▓, рд╣рд░рд┐рдпреЛ, рдмрд┐рд░реВрд╡рд╛
ЁЯНР => ЁЯНР, рдлрд▓рдлреВрд▓
ЁЯНС => ЁЯНС, рдлрд▓рдлреВрд▓, рдмрд┐рд░реВрд╡рд╛
ЁЯНТ => ЁЯНТ, рдлрд▓рдлреВрд▓, рдмрд┐рд░реВрд╡рд╛
ЁЯНУ => ЁЯНУ, рдмреЗрд░реА, рдлрд▓рдлреВрд▓, рдмрд┐рд░реВрд╡рд╛
ЁЯНЕ => ЁЯНЕ, рдмрд┐рд░реВрд╡рд╛, рд╕рд╛рдЧрдкрд╛рдд
ЁЯНЖ => ЁЯНЖ, рдмрд┐рд░реВрд╡рд╛, рд╕рд╛рдЧрдкрд╛рдд
ЁЯМ╜ => ЁЯМ╜, рдордХреИ, рдХрд╛рди, рдмрд┐рд░реВрд╡рд╛
ЁЯМ╢ => ЁЯМ╢, рдХрд╛рд▓реЛ, рдорд░рд┐рдЪ, рдмрд┐рд░реВрд╡рд╛
ЁЯНД => ЁЯНД, рдмрд┐рд░реВрд╡рд╛
ЁЯМ░ => ЁЯМ░, рдмрд┐рд░реВрд╡рд╛
ЁЯзА => ЁЯзА, рдкрдирд┐рд░
ЁЯНЦ => ЁЯНЦ, рд╣рдбреНрдбреА, рдорд╛рд╕реБ
ЁЯНЯ => ЁЯНЯ, рдлреНрд░реЗрдиреНрдЪ, рдлреНрд░рд╛рдЗрд╕
ЁЯНХ => ЁЯНХ, рд╕реНрд▓рд╛рдЗрд╕
ЁЯМн => ЁЯМн, рдлреНрд░реНрдпрд╛рдЩреНрдХрдлреБрд░реНрдЯрд░, рд╣рдбрдбрдЧ, рд╕рд╕реЗрд╕
ЁЯМо => ЁЯМо, рдореЗрдХреНрд╕рд┐рдХрди
ЁЯМп => ЁЯМп, рдореЗрдХреНрд╕рд┐рдХрди
ЁЯН▓ => ЁЯН▓, рднрд╛рдБрдбреЛ, рдЦрд╛рдирд╛ рдЦрд╛рдиреЗ
ЁЯН▒ => ЁЯН▒, рдмреЗрдиреНрдЯреЛ, рдмрдХреНрд╕
ЁЯНШ => ЁЯНШ, рдХреНрд░реНрдпрд╛рдХрд░, рд░рд╛рдЗрд╕
ЁЯНЩ => ЁЯНЩ, рдмрд▓, рдЬрд╛рдкрд╛рдирд┐рдЬ, рд░рд╛рдЗрд╕
ЁЯНЪ => ЁЯНЪ, рдкрдХрд╛рдПрдХреЛ, рдЦрд╛рдирд╛
ЁЯНЫ => ЁЯНЫ, рддрд░рдХрд╛рд░реА, рднрд╛рдд
ЁЯНа => ЁЯНа, рд░реЛрд╕реНрдЯ рдЧрд░рд┐рдПрдХреЛ рдореАрдареЛ рдЖрд▓реБ
ЁЯНд => ЁЯНд, рдлреНрд░рд╛рдЗ рдЧрд░реЗрдХреЛ, рдкреНрд░рд╛рдЙрди, рд╕реНрд░рд┐рдореНрдк, рдЯреЗрдореНрдкреБрд░рд╛
ЁЯНе => ЁЯНе, рдХреЗрдХ, рдорд╛рдЫрд╛, рдкреЗрд╕реНрдЯреНрд░реА, рд╕реНрд░реНрд╡рд┐рд▓
ЁЯНб => ЁЯНб, рдорд┐рдард╛рдИ, рдЬрд╛рдкрд╛рдирд┐рдЬ, рд╕реНрдХреЗрд╡реЗрдпрд░, рд╕реНрдЯрд┐рдХ, рдорд┐рдареЛ
ЁЯНж => ЁЯНж, рдХреНрд░рд┐рдо, рдорд┐рдард╛рдИ, рдЖрдИрд╕, рдЖрдЗрд╕рдХреНрд░рд┐рдо, рд╕рдлреНрдЯ, рдорд┐рдареЛ
ЁЯНз => ЁЯНз, рдорд┐рдард╛рдИ, рдЖрдИрд╕, рдореЛрдбрд┐рдПрдХреЛ, рдорд┐рдареЛ
ЁЯНи => ЁЯНи, рдХреНрд░рд┐рдо, рдорд┐рдард╛рдИ, рдЖрдЗрд╕, рдорд┐рдареЛ
ЁЯНй => ЁЯНй, рдорд┐рдард╛рдИ, рдорд┐рдареЛ
ЁЯНк => ЁЯНк, рдорд┐рдард╛рдИ
ЁЯОВ => ЁЯОВ, рдЬрдиреНрдо рджрд┐рди, рдХреЗрдХ, рд╕рдорд╛рд░реЛрд╣, рдорд┐рдард╛рдИ, рдкреЗрд╕реНрдЯреНрд░реА, рдорд┐рдареЛ
ЁЯН░ => ЁЯН░, рдХреЗрдХ, рдорд┐рдард╛рдИ, рдкреЗрд╕реНрдЯреНрд░реА, рд╕реНрд▓рд╛рдЗрд╕рд▓, рдорд┐рдареЛ
ЁЯНл => ЁЯНл, рдмрд╛рд░, рдЪрдХрд▓реЗрдЯ, рдорд┐рдард╛рдИ, рдорд┐рдареЛ
ЁЯНм => ЁЯНм, рдорд┐рдард╛рдИ, рдорд┐рдареЛ
ЁЯНн => ЁЯНн, рдХреНрдпрд╛рдиреНрдбреА, рдорд┐рдард╛рдИ, рдорд┐рдареЛ
ЁЯНо => ЁЯНо, рдорд┐рдард╛рдИ, рдкрдбрд┐рдЩреН, рдорд┐рдареЛ
ЁЯНп => ЁЯНп, рдорд╣, рднрд╛рдБрдбреЛ, рдорд┐рдареЛ
ЁЯН╝ => ЁЯН╝, рдмрдЪреНрдЪрд╛, рдмреЛрддрд▓, рдкрд┐рдЙрдиреЗ, рджреВрдз
тШХ => тШХ, рдмреЗрднрд░реЗрдЬ, рдХрдлреА, рдкрд┐рдЙрдиреЗ, рддрд╛рддреЛ, рддрд╛рддреЗрдХреЛ, рдЪрд┐рдпрд╛
ЁЯН╡ => ЁЯН╡, рдмреЗрднрд░реЗрдЬ, рдХрдк, рдкрд┐рдЙрдиреЗ, рдЪрд┐рдпрд╛, рдЪрд┐рдпрд╛рдХрдк
ЁЯН╢ => ЁЯН╢, рдмрд╛рд░, рдмреЗрднрд░реЗрдЬ, рдмреЛрддрд▓, рдХрдк, рдкрд┐рдЙрдиреЗ
ЁЯН╛ => ЁЯН╛, рдмрд╛рд░, рдмреЛрддрд▓, рдХрд░реНрдХ, рдкрд┐рдЙрдиреЗ, рдкрдкрд┐рдЩреН
ЁЯН╖ => ЁЯН╖, рдмрд╛рд░, рдмреЗрднрд░реЗрдЬ, рдкрд┐рдЙрдиреЗ, рдЧрд┐рд▓рд╛рд╕, рд╡рд╛рдЗрди
ЁЯН╕ => ЁЯН╕, рдмрд╛рд░, рдХрдХрдЯреЗрд▓, рдкрд┐рдЙрдиреЗ, рдЧрд┐рд▓рд╛рд╕
ЁЯН╣ => ЁЯН╣, рдмрд╛рд░, рдкрд┐рдЙрдиреЗ, рдЙрд╖реНрдгрдкреНрд░рджреЗрд╢реАрдп
ЁЯН║ => ЁЯН║, рдмрд╛рд░, рдмрд┐рдпрд░, рдкрд┐рдЙрдиреЗ, рдордЧ
ЁЯН╗ => ЁЯН╗, рдмрд╛рд░, рдмрд┐рдпрд░, рдмрдЬреНрдиреЗ, рдордЧ
ЁЯН╜ => ЁЯН╜, рдЦрд╛рдирд╛ рдмрдирд╛рдЙрдиреЗ, рдХрд╛рдБрдЯрд╛, рдЪрдХреНрдХреБ, рдкреНрд▓реЗрдЯ
ЁЯН┤ => ЁЯН┤, рдЦрд╛рдирд╛ рдмрдирд╛рдЙрдиреЗ, рдХрд╛рдБрдЯрд╛, рдЪрдХреНрдХреБ
ЁЯН│ => ЁЯН│, рдЕрдгреНрдбрд╛, рдлреНрд░рд╛рдИ рдЧрд░реНрдиреЗ, рдкреНрдпрд╛рди
ЁЯМН => ЁЯМН, рдЕрдлреНрд░рд┐рдХрд╛, рдкреГрдереНрд╡реА, рдпреВрд░реЛрдк, рд╡рд┐рд╢реНрд╡, рд╕рдВрд╕рд╛рд░
ЁЯМО => ЁЯМО, рдЕрдореЗрд░рд┐рдХрд╛, рдкреГрдереНрд╡реА, рд╡рд┐рд╢реНрд╡, рд╕рдВрд╕рд╛рд░
ЁЯМП => ЁЯМП, рдПрд╕рд┐рдпрд╛, рдЕрд╕реНрдЯреНрд░реЗрд▓рд┐рдпрд╛, рдкреГрдереНрд╡реА, рд╡рд┐рд╢реНрд╡, рд╕рдВрд╕рд╛рд░
ЁЯМР => ЁЯМР, рдкреГрдереНрд╡реА, рд╡рд┐рд╢реНрд╡, рднреВрдордзреНрдп рд░реЗрдЦрд╛
ЁЯЧ║ => ЁЯЧ║, рдирдХреНрд╕рд╛, рд╡рд┐рд╢реНрд╡
ЁЯПФ => ЁЯПФ, рдЪрд┐рд╕реЛ, рдкрд░реНрд╡рдд, рд╣рд┐рдЙрдБ
ЁЯПЦ => ЁЯПЦ, рд╕рдореБрджреНрд░реА рдХрд┐рдирд╛рд░рд╛, рдЫрд╛рддрд╛
ЁЯПЭ => ЁЯПЭ, рдорд░реВрднреВрдорд┐, рдЯрд╛рдкреВ
ЁЯПЮ => ЁЯПЮ, рдкрд╛рд░реНрдХ
ЁЯПЫ => ЁЯПЫ, рдирд┐рд░реНрдорд╛рдг, рд╢рд╛рд╕реНрддреНрд░реАрдп
ЁЯПЧ => ЁЯПЧ, рдирд┐рд░реНрдорд╛рдг, рд╕рдВрд░рдЪрдирд╛
ЁЯПШ => ЁЯПШ, рдШрд░, рдирд┐рд░реНрдорд╛рдгрд╣рд░реВ
ЁЯПЩ => ЁЯПЩ, рдирд┐рд░реНрдорд╛рдг, рд╕рд╣рд░
ЁЯПа => ЁЯПа, рдирд┐рд░реНрдорд╛рдг, рдЧреГрд╣, рдШрд░
ЁЯПб => ЁЯПб, рдирд┐рд░реНрдорд╛рдг, рдмрдЧреИрдБрдЪрд╛, рдЧреГрд╣, рдШрд░
тЫк => тЫк, рдирд┐рд░реНрдорд╛рдг, рдХреНрд░рд┐рд╕реНрдЪрд┐рдпрди, рдХреНрд░рд╕, рдзрд░реНрдо
ЁЯХЛ => ЁЯХЛ, рдЗрд╕реНрд▓рд╛рдо, рдореБрд╕реНрд▓рд┐рдо, рдзрд░реНрдо
ЁЯХМ => ЁЯХМ, рдЗрд╕реНрд▓рд╛рдо, рдореБрд╕реНрд▓рд┐рдо, рдзрд░реНрдо
ЁЯХН => ЁЯХН, рдкреБрдЬрдирд┐рдп рд╕реНрдерд▓, рдзрд░реНрдо, рдордиреНрджрд┐рд░
тЫй => тЫй, рдШрд░реНрдо, рд╢рд┐рдиреНрддреЛ, рддреАрд░реНрде
ЁЯПв => ЁЯПв, рдирд┐рд░реНрдорд╛рдг
ЁЯПг => ЁЯПг, рдирд┐рд░реНрдорд╛рдг, рдЬрд╛рдкрд╛рдирд┐рд╕, рд╣реБрд▓рд╛рдХ
ЁЯПд => ЁЯПд, рдирд┐рд░реНрдорд╛рдг, рдпреВрд░реЛрдкрд┐рдпрди
ЁЯПе => ЁЯПе, рдирд┐рд░реНрдорд╛рдг, рдбрдХреНрдЯрд░, рдФрд╖рдзрд┐
ЁЯПж => ЁЯПж, рдирд┐рд░реНрдорд╛рдг
ЁЯПи => ЁЯПи, рдирд┐рд░реНрдорд╛рдг
ЁЯПй => ЁЯПй, рдирд┐рд░реНрдорд╛рдг, рд╣реЛрдЯреЗрд▓, рд▓рдн
ЁЯПк => ЁЯПк, рдирд┐рд░реНрдорд╛рдг, рд╕реБрд╡рд┐рдзрд╛рдЬрдирдХ, рд╕реНрдЯреЛрд░
ЁЯПл => ЁЯПл, рдирд┐рд░реНрдорд╛рдг
ЁЯПм => ЁЯПм, рдирд┐рд░реНрдорд╛рдг, рдбрд┐рдкрд╛рд░реНрдЯрдореЗрдиреНрдЯрд▓, рд╕реНрдЯреЛрд░
ЁЯПн => ЁЯПн, рдирд┐рд░реНрдорд╛рдг
ЁЯПп => ЁЯПп, рдирд┐рд░реНрдорд╛рдг, рдХреНрдпрд╛рд╕реНрдЯрд▓, рдЬрд╛рдкрд╛рдиреА
ЁЯП░ => ЁЯП░, рдирд┐рд░реНрдорд╛рдг
ЁЯТТ => ЁЯТТ, рдХреЗрдкрд▓, рдордиреЛрд░рдиреНрдЬрди
ЁЯЧ╝ => ЁЯЧ╝, рдЯреЛрдХрд┐рдпреЛ, рдЯрд╛рд╡рд░
ЁЯЧ╜ => ЁЯЧ╜, рд╕реНрд╡рддрдиреНрддреНрд░рддрд╛, рдкреНрд░рддрд┐рдорд╛
ЁЯЧ╛ => ЁЯЧ╛, рдЬрд╛рдкрд╛рди, рдирдХреНрд╕рд╛
тЫ║ => тЫ║, рдХреНрдпрд╛рдореНрдкрд┐рдЩ
ЁЯМБ => ЁЯМБ, рдзрдорд┐рд▓реЛ, рдореМрд╕рдо
ЁЯМГ => ЁЯМГ, рд░рд╛рдд, рддрд╛рд░рд╛, рдореМрд╕рдо
ЁЯМД => ЁЯМД, рдмрд┐рд╣рд╛рдиреА, рдкрд░реНрд╡рдд, рд╕реВрд░реНрдп, рд╕реВрд░реНрдпреЛрджрдп, рдореМрд╕рдо
ЁЯМЕ => ЁЯМЕ, рдмрд┐рд╣рд╛рдиреА, рд╕реВрд░реНрдп, рдореМрд╕рдо
ЁЯМЖ => ЁЯМЖ, рд╕рд┐рдЯрд┐рд╕реНрдХреЗрдкрдХреЛ рдЧреЛрдзреВрд▓реА рд╕рдордп
ЁЯМЗ => ЁЯМЗ, рдирд┐рд░реНрдорд╛рдг, рдбрд╕реНрдХ, рд╕реВрд░реНрдп, рдореМрд╕рдо
ЁЯМЙ => ЁЯМЙ, рджреБрд▓рд╣реА, рд░рд╛рдд, рдореМрд╕рдо
тЩи => тЩи, рддрд╛рддреЛ, рддрд╛рддреЛрд╕реНрдкреНрд░рд┐рдЩреН, рд╕реНрдкреНрд░рд┐рдЩреН, рддрд╛рддреЗрдХреЛ
ЁЯММ => ЁЯММ, рдореМрд╕рдо
ЁЯЪГ => ЁЯЪГ, рд░реЗрдХрд╡реЗ рдХрд╛рд░
ЁЯЪИ => ЁЯЪИ, рд░реЗрд▓рд╡реЗ, рдЧрд╛рдбреА
ЁЯЪЙ => ЁЯЪЙ, рд░реЗрд▓рд╡реЗ, рдЯреНрд░реЗрди, рдЧрд╛рдбреА
ЁЯЪК => ЁЯЪК, рдЯреНрд░рд▓рд┐рдмрд╕, рдЧрд╛рдбреА
ЁЯЪЭ => ЁЯЪЭ, рдЧрд╛рдбреА
ЁЯЪЮ => ЁЯЪЮ, рдХрд╛рд░, рдкрд░реНрд╡рддреАрдп, рд░реЗрд▓рд╡реЗ, рдЧрд╛рдбреА
ЁЯЪЛ => ЁЯЪЛ, рдХрд╛рд░, рдЯреНрд░рд╛рдо, рдЯреНрд░рд▓рд┐рдмрд╕, рдЧрд╛рдбреА
ЁЯЪМ => ЁЯЪМ, рдЧрд╛рдбреА
ЁЯЪН => ЁЯЪН, рдмрд╕, рдЖрдЙрдБрджреИ рдЧрд░реЗрдХреЛ, рдЧрд╛рдбреА
ЁЯЪО => ЁЯЪО, рдмрд╕, рдЯреНрд░рд╛рдо, рдЯреНрд░рд▓рд┐, рдЧрд╛рдбреА
ЁЯЪП => ЁЯЪП, рдмрд╕, рдмрд╕рд░реЛрдХреНрдиреЗ, рд░реЛрдХреНрди
ЁЯЪР => ЁЯЪР, рдмрд╕, рдЧрд╛рдбреА
ЁЯЪС => ЁЯЪС, рдЧрд╛рдбреА
ЁЯЪТ => ЁЯЪТ, рдЗрдиреНрдЬрд┐рди, рдЖрдЧреЛ, рдЯреНрд░рдХ, рдЧрд╛рдбреА
ЁЯЪУ => ЁЯЪУ, рдХрд╛рд░, рдкреЗрдЯреНрд░реЛрд▓, рдкреБрд▓рд┐рд╕, рдЧрд╛рдбреА
ЁЯЪФ => ЁЯЪФ, рдХрд╛рд░, рдЖрдЙрдБрджреИ рдЧрд░реЗрдХреЛ, рдкреБрд▓рд┐рд╕, рдЧрд╛рдбреА
ЁЯЪЧ => ЁЯЪЧ, рдХрд╛рд░, рдЧрд╛рдбреА
ЁЯЪШ => ЁЯЪШ, рдЕрдЯреЛрдореЛрдмрд╛рдЗрд▓, рдХрд╛рд░, рдЖрдЗрд░рд╣реЗрдХреЛ, рдЧрд╛рдбреА
ЁЯЪЩ => ЁЯЪЩ, рдкреБрдирдГ рдмрдирд╛рдЙрдиреЗ, рдкреБрдирдГрдмрдирд╛рдЙрдиреЗ рдЧрд╛рдбреА, рдЧрд╛рдбреА
ЁЯЪЪ => ЁЯЪЪ, рдбрд┐рд▓рд┐рд╡рд░реА, рдЯреНрд░рдХ, рдЧрд╛рдбреА
ЁЯЪЫ => ЁЯЪЫ, рдЕрд░реНрдз, рдЯреНрд░рдХ, рдЧрд╛рдбреА
ЁЯЪЬ => ЁЯЪЬ, рдЧрд╛рдбреА
ЁЯЪ▓ => ЁЯЪ▓, рдмрд╛рдЗрдХ, рдЧрд╛рдбреА
тЫ╜ => тЫ╜, рдЗрдиреНрдзрди, рдЗрдиреНрдзрдирдкрдореНрдк, рдЧреНрдпрд╛рдБрд╕, рдкрдореНрдк, рд╕реНрдЯреЗрд╢рди
ЁЯЫг => ЁЯЫг, рд░рд╛рдЬрдорд╛рд░реНрдЧ, рд╕рдбрдХ
ЁЯЫд => ЁЯЫд, рд░реЗрд▓рд╡реЗ, рдЯреНрд░реЗрди
ЁЯЪе => ЁЯЪе, рдкреНрд░рдХрд╛рд╢, рд╕рдВрдХреЗрдд, рдЯреНрд░рд╛рдлрд┐рдХ
ЁЯЪж => ЁЯЪж, рдкреНрд░рдХрд╛рд╢, рд╕рдВрдХреЗрдд, рдЯреНрд░рд╛рдлрд┐рдХ
тЪУ => тЪУ, рдЬрд╣рд╛рдб, рд╕рд╛рдзрди
тЫ╡ => тЫ╡, рдбреБрдЩреНрдЧрд╛, рд░реЗрд╕реЛрд░реНрдЯ, рдЦреЛрд▓рд╛, рдЧрд╛рдбреА, рдпрд╛рдЪреНрдЯ
ЁЯЪг => ЁЯЪг, рдбреБрдЩреНрдЧрд╛, рдЧрд╛рдбреА
ЁЯЪд => ЁЯЪд, рдбреБрдЩреНрдЧрд╛, рдЧрд╛рдбреА
ЁЯЫ│ => ЁЯЫ│, рдпрд╛рддреНрд░реА, рдЬрд╣рд╛рдЬ, рдЧрд╛рдбреА
тЫ┤ => тЫ┤, рдбреБрдЩреНрдЧрд╛
ЁЯЫе => ЁЯЫе, рдбреБрдЩреНрдЧрд╛, рдореЛрдЯрд░рдмреЛрдЯ, рдЧрд╛рдбреА
тЬИ => тЬИ, рдЧрд╛рдбреА
ЁЯЫй => ЁЯЫй, рд╣рд╡рд╛рдЗрдЬрд╣рд╛рдЬ, рдЧрд╛рдбреА
ЁЯЪБ => ЁЯЪБ, рдЧрд╛рдбреА
ЁЯЪЯ => ЁЯЪЯ, рд░реЗрд▓рд╡реЗ, рдирд┐рд▓рдореНрдмрди, рдЧрд╛рдбреА
ЁЯЪа => ЁЯЪа, рдХреЗрдмрд▓, рдЧреЛрдиреНрдбреЛрд▓рд╛, рдкрд░реНрд╡рддреАрдп, рдЧрд╛рдбреА
ЁЯЪб => ЁЯЪб, рдПрд░рд┐рдпрд▓, рдХреЗрдмрд▓, рдХрд╛рд░, рдЧреЛрдиреНрдбреЛрд▓рд╛, рд░реЛрдкрд╡реЗ, рдЯреНрд░рд╛рдорд╡реЗ, рдЧрд╛рдбреА
ЁЯЫМ => ЁЯЫМ, рд╣реЛрдЯреЗрд▓, рд╕реБрддреНрдиреЗ
ЁЯЫП => ЁЯЫП, рд╣реЛрдЯреЗрд▓, рд╕реБрддреНрдиреЗ
ЁЯЫЛ => ЁЯЫЛ, рдХрдЙрдЪ, рд╣реЛрдЯреЗрд▓, рдмрддреНрддреА
ЁЯЪ┐ => ЁЯЪ┐, рдкрд╛рдиреА
ЁЯЫА => ЁЯЫА, рдмрд╛рдердЯрдм:рдмрд╛рде
ЁЯЫБ => ЁЯЫБ, рдмрд╛рде
тМЫ => тМЫ, рд░реЗрдд, рдЯрд╛рдЗрдорд░
тП│ => тП│, рдмрд╛рд▓реБрд╡рд╛рдХреЛ рдкреНрд░рд╡рд╛рд╣, рд░реЗрдд, рдЯрд╛рдЗрдорд░
тП░ => тП░, рдШрдбреА, рдЕрд░реНрд▓рд╛рдо
тП▒ => тП▒, рдШрдбреА
тП▓ => тП▓, рдШрдбреА, рдЯрд╛рдЗрдорд░
ЁЯХ░ => ЁЯХ░, рдШрдбреА
ЁЯХЫ => ЁЯХЫ, режреж, резреи, резреи:режреж
ЁЯХз => ЁЯХз, резреи, резреи:рейреж, рейреж
ЁЯХР => ЁЯХР, режреж, рез, рез:режреж
ЁЯХЬ => ЁЯХЬ, рез, рез:рейреж, рейреж, рдПрдХ, рддреАрд╕
ЁЯХС => ЁЯХС, режреж, реи, реи:режреж
ЁЯХЭ => ЁЯХЭ, реи, реи:рейреж, рейреж
ЁЯХТ => ЁЯХТ, режреж, рей:рей:рейреж
ЁЯХЮ => ЁЯХЮ, рей, рей:рейреж, рейреж
ЁЯХУ => ЁЯХУ, режреж, рек, рек:режреж
ЁЯХЯ => ЁЯХЯ, рейреж, рек, рек:рейреж
ЁЯХФ => ЁЯХФ, режреж, рел, рел:режреж
ЁЯХа => ЁЯХа, рейреж, рел, рел:рейреж
ЁЯХХ => ЁЯХХ, режреж, рем
ЁЯХб => ЁЯХб, рейреж, рем, рем:рейреж
ЁЯХЦ => ЁЯХЦ, режреж, рен, рен:режреж
ЁЯХв => ЁЯХв, рейреж, рен, рен:рейреж
ЁЯХЧ => ЁЯХЧ, режреж, рео, рео:режреж
ЁЯХг => ЁЯХг, рейреж, рео, рео:рейреж
ЁЯХШ => ЁЯХШ, режреж, реп, реп:режреж
ЁЯХд => ЁЯХд, рейреж, реп, реп:рейреж
ЁЯХЩ => ЁЯХЩ, режреж, резреж, резреж:режреж
ЁЯХе => ЁЯХе, резреж, резреж:рейреж, рейреж
ЁЯХЪ => ЁЯХЪ, режреж, резрез, резрез:режреж
ЁЯХж => ЁЯХж, резрез:резрез:рейреж:рейреж
ЁЯМС => ЁЯМС, рдЕрдБрдзреНрдпрд╛рд░реЛ, рдЪрдиреНрджреНрд░рдорд╛, рдЖрдХрд╛рд╢рдЧрдВрдЧрд╛, рдореМрд╕рдо
ЁЯМХ => ЁЯМХ, рдкреВрд░рд╛, рдЖрдХрд╛рд╢рдЧрдВрдЧрд╛, рдореМрд╕рдо
ЁЯМЪ => ЁЯМЪ, рдЪрдиреНрджреНрд░рдорд╛рдХреЛ рд╕реНрд╡рд░реВрдк
ЁЯМб => ЁЯМб, рдореМрд╕рдо
тША => тША, рдЙрдЬреНрдпрд╛рд▓реЛ, рдХрд┐рд░рдг, рдЖрдХрд╛рд╢рдЧрдВрдЧрд╛рд▓, рддреЗрдЬрд┐рд▓реЛ, рдореМрд╕рдо
ЁЯМЭ => ЁЯМЭ, рдЙрдЬреНрдпрд╛рд▓реЛ, рдЕрдиреБрд╣рд╛рд░, рдкреВрд░реНрдг рдЪрдиреНрджреНрд░, рдЖрдХрд╛рд╢рдЧрдВрдЧрд╛рд▓, рд╕реВрд░реНрдп, рдореМрд╕рдо
ЁЯМЮ => ЁЯМЮ, рдЙрдЬреНрдпрд╛рд▓реЛ, рдЕрдиреБрд╣рд╛рд░, рдЖрдХрд╛рд╢рдЧрдВрдЧрд╛рд▓, рд╕реВрд░реНрдп, рдореМрд╕рдо
тнР => тнР, рддрд╛рд░рд╛
ЁЯМЯ => ЁЯМЯ, рдЧреНрд▓рд┐рдЯрд░рд┐рдЩреН, рдЙрдЬреНрдпрд╛рд▓реЛ, рдЪрдореНрдХреЗрдХреЛ, рдЪрдореНрдорд┐рдХрд░рд╣реЗрдХреЛ, рддрд╛рд░рд╛
ЁЯМа => ЁЯМа, рдЭрд░рд┐рд░рд╣реЗрдХреЛ, рд╢реВрдЯрд┐рдЩреНрдЧ, рдЖрдХрд╛рд╢рдЧрдВрдЧрд╛, рддрд╛рд░рд╛
тШБ => тШБ, рдореМрд╕рдо
тЫЕ => тЫЕ, рдмрд╛рджрд▓, рд╕реВрд░реНрдп, рдореМрд╕рдо
тЫИ => тЫИ, рдмрд╛рджрд▓, рд╡рд░реНрд╖рд╛, рдЧрд░реНрдЬрд┐рдиреЗ, рдореМрд╕рдо
ЁЯМд => ЁЯМд, рдмрд╛рджрд▓, рд╕реВрд░реНрдп, рдореМрд╕рдо
ЁЯМе => ЁЯМе, рдмрд╛рджрд▓, рд╕реВрд░реНрдп, рдореМрд╕рдо
ЁЯМи => ЁЯМи, рдмрд╛рджрд▓, рдЪрд┐рд╕реЛ, рд╣рд┐рдЙрдБ, рдореМрд╕рдо
ЁЯМй => ЁЯМй, рдмрд╛рджрд▓, рдмрд┐рдЬреБрд▓реА рдЪрдореНрдХрд┐рд░рд╣реЗрдХреЛ, рдореМрд╕рдо
ЁЯМк => ЁЯМк, рдмрд╛рджрд▓, рдореМрд╕рдо, рдЪрдХреНрд░рд╡рд╛рдд
ЁЯМл => ЁЯМл, рдмрд╛рджрд▓, рдореМрд╕рдо
ЁЯМм => ЁЯМм, рдкреНрд░рд╡рд╛рд╣, рдмрд╛рджрд▓, рдЕрдиреБрд╣рд╛рд░, рдореМрд╕рдо, рд╣рд╛рд╡рд╛
ЁЯМИ => ЁЯМИ, рд╡рд░реНрд╖рд╛
ЁЯМВ => ЁЯМВ, рдХрдкрдбрд╛, рд╡рд░реНрд╖рд╛, рдЫрд╛рддрд╛, рдореМрд╕рдо
тШВ => тШВ, рдХрдкрдбрд╛, рд╡рд░реНрд╖рд╛, рдореМрд╕рдо
тШФ => тШФ, рдХрдкрдбрд╛, рдереЛрдкрд╛, рд╡рд░реНрд╖рд╛, рдЫрд╛рддрд╛, рдореМрд╕рдо
тЫ▒ => тЫ▒, рд╕рддрд╣рдХреЛ рдЫрд╛рддрд╛
тЭД => тЭД, рд╣рд┐рдордкрд╛рддрдХреЛ рдПрдХ рдЦрдгреНрдб
тШГ => тШГ, рдЪрд┐рд╕реЛ, рд╣рд┐рдЙрдБ, рдореМрд╕рдо
тЫД => тЫД, рдЪрд┐рд╕реЛ, рд╣рд┐рдЙрдБ, рд╣рд┐рдордорд╛рдирд╡, рдореМрд╕рдо
тШД => тШД, рдЖрдХрд╛рд╢рдЧрдВрдЧрд╛
ЁЯФе => ЁЯФе, рдЬреНрд╡рд╛рд▓рд╛, рд╕рд╛рдзрди
ЁЯТз => ЁЯТз, рдЪрд┐рд╕реЛ, рд╣рдБрд╕рд╛рдЙрдиреЗ, рдкрд╕рд┐рдирд╛, рдореМрд╕рдо
ЁЯМК => ЁЯМК, рд╕рдореБрджреНрд░, рдкрд╛рдиреА, рддрд░рдВрдЧ, рдореМрд╕рдо
ЁЯОГ => ЁЯОГ, рд╕рдорд╛рд░реЛрд╣, рд╣рд▓реЛрд╡рди, рдЬреНрдпрд╛рдХ, рд▓рд╛рд▓рдЯрд┐рди
ЁЯОД => ЁЯОД, рд╕рдорд╛рд░реЛрд╣, рдХреНрд░рд┐рд╕рдорд╕, рд░реВрдЦ
ЁЯОЖ => ЁЯОЖ, рд╕рдорд╛рд░реЛрд╣
ЁЯОЗ => ЁЯОЗ, рд╕рдорд╛рд░реЛрд╣, рдЖрддрд┐рд╢рдмрд╛рдЬреА, рдЪрдордХ
тЬи => тЬи, рддрд╛рд░рд╛
ЁЯОИ => ЁЯОИ, рд╕рдорд╛рд░реЛрд╣
ЁЯОЙ => ЁЯОЙ, рд╕рдорд╛рд░реЛрд╣, рдкрд╛рд░реНрдЯреА, рдкрдкрд░, рдЯрд╛рдбрд╛
ЁЯОК => ЁЯОК, рдмрд▓, рд╕рдорд╛рд░реЛрд╣, рдХрдирдлреЗрдЯреА
ЁЯОЛ => ЁЯОЛ, рдмреНрдпрд╛рдирд░, рд╕рдорд╛рд░реЛрд╣, рдЬрд╛рдкрд╛рдирд┐рдЬ рд░реВрдЦ
ЁЯОМ => ЁЯОМ, рд╕рдорд╛рд░реЛрд╣, рдХреНрд░рд╕, рдХреНрд░рд╕ рдЧрд░рд┐рдПрдХреЛ, рдЭрдгреНрдбрд╛рд╣рд░реВ
ЁЯОН => ЁЯОН, рдмрдореНрдмреЛ, рд╕рдорд╛рд░реЛрд╣, рдЬрд╛рдкрд╛рдирд┐рдЬ, рдкрд┐рди, рдмрд▓
ЁЯОО => ЁЯОО, рд╕рдорд╛рд░реЛрд╣, рдкреБрддрд▓рд┐, рдЪрд╛рдб, рдЬрд╛рдкрд╛рдирд┐рдЬ
ЁЯОП => ЁЯОП, рдХрд╛рд░реНрдк, рд╕рдорд╛рд░реЛрд╣, рд╕реНрдЯреНрд░рд┐рдорд░
ЁЯОР => ЁЯОР, рдШрдгреНрдЯреА, рд╕рдорд╛рд░реЛрд╣, рд╕рд┐рдиреЗрдорд╛, рд╡рд┐рдиреНрдб
ЁЯОС => ЁЯОС, рд╕рдорд╛рд░реЛрд╣, рдЙрддреНрд╕рд╡, рдЪрдиреНрджреНрд░рдорд╛
ЁЯОА => ЁЯОА, рд╕рдорд╛рд░реЛрд╣
ЁЯОБ => ЁЯОБ, рдмрдХреНрд╕, рд╕рдорд╛рд░реЛрд╣, рдЙрдкрд╣рд╛рд░
ЁЯОЦ => ЁЯОЦ, рд╕рдорд╛рд░реЛрд╣, рдкрджрдХ, рд╕реИрдиреНрдп
ЁЯОЧ => ЁЯОЧ, рд╕рдорд╛рд░реЛрд╣, рд╕рдореНрдЭрд╛рдЙрдиреА, рд░рд┐рдмрди
ЁЯОЮ => ЁЯОЮ, рд╕рд┐рдиреЗрдорд╛, рдлрд┐рд▓реНрдо, рдлреНрд░реЗрдорд╣рд░реВ, рдЪрд▓рдЪрд┐рддреНрд░
ЁЯОЯ => ЁЯОЯ, рднрд░реНрдирд╛, рдЯрд┐рдХреЗрдЯрд╣рд░реВ
ЁЯОл => ЁЯОл, рднрд░реНрдирд╛
тЪ╜ => тЪ╜, рдмрд▓, рд╕реБрдХрд░
тЪ╛ => тЪ╛, рдмрд▓
ЁЯПА => ЁЯПА, рдмрд▓, рд╣реБрдк
ЁЯПИ => ЁЯПИ, рдЕрдореЗрд░рд┐рдХрди, рдмрд▓, рдлреБрдЯрдмрд▓
ЁЯПЙ => ЁЯПЙ, рдмрд▓, рдлреБрдЯрдмрд▓, рд░рдЧреНрдмреА
ЁЯО╛ => ЁЯО╛, рдмрд▓, рд░реНрдпрд╛рдХреЗрдЯ
ЁЯО▒ => ЁЯО▒, рео, рео рдмрд▓, рдмрд▓, рдЖрда, рдЦреЗрд▓
ЁЯО│ => ЁЯО│, рдмрд▓, рдЦреЗрд▓
тЫ│ => тЫ│, рдЧреЛрд▓реНрдл, рдкреНрд╡рд╛рд▓
ЁЯПМ => ЁЯПМ, рдмрд▓, рдЧреЛрд▓реНрдл
тЫ╕ => тЫ╕, рдЖрдИрд╕, рд╕реНрдХреЗрдЯ
ЁЯОг => ЁЯОг, рдорд╛рдЫрд╛, рдкреЛрд▓
ЁЯО╜ => ЁЯО╜, рджреМрдбрд┐рдиреЗ, рд╕реНрдпрд╛рд╕, рд╕рд░реНрдЯ
ЁЯО┐ => ЁЯО┐, рд╣рд┐рдЙрдБ
тЫ╖ => тЫ╖, рд╕реНрдХреА, рд╣рд┐рдЙрдБ
ЁЯПВ => ЁЯПВ, рд╕реНрдХреА, рд╣рд┐рдЙрдБ
ЁЯПД => ЁЯПД, рд╕рд░реНрдлрд┐рдЩреН
ЁЯПЗ => ЁЯПЗ, рдШреЛрдбрд╛, рдШреЛрдбрд╛рд╕рд╡рд╛рд░, рджреМрдбрд┐рдиреЗрдШреЛрдбрд╛, рджреМрдбрд┐рдиреЗ
ЁЯПК => ЁЯПК, рдкреМрдбреА
тЫ╣ => тЫ╣, рдмрд▓
ЁЯПЛ => ЁЯПЛ, рдлрд┐рд▓реНрдЯрд░, рддреМрд▓
ЁЯЪ┤ => ЁЯЪ┤, рд╕рд╛рдЗрдХрд▓, рдмрд╛рдЗрдХ, рд╕рд╛рдЗрдХрд▓ рдЪрд▓рд╛рдЙрдиреЗ
ЁЯЪ╡ => ЁЯЪ╡, рд╕рд╛рдЗрдХрд▓, рд╕рд╛рдЗрдХрд▓ рдЪрд▓рд╛рдЙрдиреЗ, рдмрд╛рдЗрдХ, рдорд╛рдЙрдиреНрдЯреЗрди
ЁЯПЖ => ЁЯПЖ, рдЙрдкрд╣рд╛рд░
ЁЯПП => ЁЯПП, рдмрд▓, рдмреНрдпрд╛рдЯ, рдЦреЗрд▓
ЁЯПР => ЁЯПР, рдмрд▓, рдЦреЗрд▓
ЁЯПС => ЁЯПС, рдмрд▓, рдХреНрд╖реЗрддреНрд░, рдЦреЗрд▓, рд╣рдХрд┐, рд╕реНрдЯрд┐рдХ
ЁЯПТ => ЁЯПТ, рдЦреЗрд▓, рд╣рдХрд┐, рдЖрдИрд╕, рдкрдХ, рд╕реНрдЯрд┐рдХ
ЁЯПУ => ЁЯПУ, рдмрд▓, рдмреНрдпрд╛рдЯ, рдЦреЗрд▓, рдкреНрдпрд╛рдбрд▓, рдЯреЗрдмрд▓ рдЯреЗрдирд┐рд╕
ЁЯОп => ЁЯОп, рдбрд╛рдпрд░реЗрдХреНрдЯ рд╣рд┐рдЯ
ЁЯОо => ЁЯОо, рдирд┐рдпрдиреНрддреНрд░рдХ, рдЦреЗрд▓
ЁЯХ╣ => ЁЯХ╣, рдЦреЗрд▓, рднрд┐рдбреАрдпреЛ рдЧреЗрдо
ЁЯО▓ => ЁЯО▓, рдкрд╛рд╕рд╛рд╣рд░реВ, рдорд░реНрдиреЗ, рдЦреЗрд▓
тЩа => тЩа, рдХрд╛рд░реНрдб, рдЦреЗрд▓, рд╕реНрдкреЗрдб, рд╕реВрдЯ
тЩе => тЩе, рдХрд╛рд░реНрдб, рдЦреЗрд▓, рдореБрдЯреБ, рдореБрдЯреБрд╣рд░реВ, рд╕реВрдЯ
тЩж => тЩж, рдХрд╛рд░реНрдб, рд╣рд┐рд░рд╛, рд╣рд┐рд░рд╛рд╣рд░реВ, рдЦреЗрд▓, рд╕реВрдЯ
тЩг => тЩг, рдХрд╛рд░реНрдб, рдХреНрд▓рдм, рдХреНрд▓рдмрд╣рд░, рдЦреЗрд▓, рд╕реВрдЯ
ЁЯГП => ЁЯГП, рдХрд╛рд░реНрдб, рдЦреЗрд▓, рдЦреЗрд▓реНрджреИ
ЁЯФЙ => ЁЯФЙ, рдареВрд▓реЛ, рд╕реНрдкрд┐рдХрд░, рднреЛрд▓реНрдпреВрдо, рддрд░рдВрдЧ
ЁЯФК => ЁЯФК, 3, рдмрдвреА, рдареВрд▓реЛ, рд╕реНрдкрд┐рдХрд░, рддреАрди, рднреЛрд▓реНрдпреВрдо
ЁЯУв => ЁЯУв, рдареВрд▓реЛ, рд╕рд╛рд░реНрдмрдЬрдирд┐рдХ рдареЗрдЧрд╛рдирд╛
ЁЯУг => ЁЯУг, рдЙрддреНрд╕рд╛рд╣рд╡рд░реНрдзрдХ
ЁЯУп => ЁЯУп, рд╕рд┐рдЩреН, рдкреЛрд╕реНрдЯ, рдкреЛрд╕реНрдЯрд▓
ЁЯФХ => ЁЯФХ, рдШрдгреНрдЯреА, рд░реЛрдХрд┐рдПрдХреЛ, рдЪреБрдк, рдЫреИрди, рд╣реЛрдЗрди, рдирд┐рд╖реЗрдзрд┐рдд, рдЪреБрдкрдЪрд╛рдк, рд╢рд╛рдиреНрдд
ЁЯО╝ => ЁЯО╝, рд╕рд╛рдВрдЧреАрддрд┐рдХ, рд╕реНрдХреЛрд░
ЁЯО╡ => ЁЯО╡, рд╕рд╛рдВрдЧреАрддрд┐рдХ, рдиреЛрдЯ
ЁЯО╢ => ЁЯО╢, рд╕рд╛рдВрдЧреАрддрд┐рдХ, рдиреЛрдЯ, рдиреЛрдЯрд╣рд░реВ
ЁЯОЩ => ЁЯОЩ, рдорд╛рдЗрдХреНрд░реЛрдлреЛрди, рд╕рдВрдЧреАрдд, рд╕реНрдЯреБрдбрд┐рдпреЛ
ЁЯОЪ => ЁЯОЪ, рд╕реНрддрд░, рд╕рдВрдЧреАрдд, рд╕реНрд▓рд╛рдЗрдбрд░
ЁЯОЫ => ЁЯОЫ, рдирд┐рдпрдиреНрддреНрд░рдг, рдирдмрд╣рд░реВ, рд╕рдВрдЧреАрдд
ЁЯОд => ЁЯОд, рдХрд╛рд░рд╛рд╡реЛрдХреЗ
ЁЯО╖ => ЁЯО╖, рдЙрдкрдХрд░рдг, рд╕рдВрдЧреАрдд, рд╕рд╛рдХреНрд╕реЛрдлреЛрди
ЁЯО╕ => ЁЯО╕, рдЙрдкрдХрд░рдг, рд╕рдВрдЧреАрдд
ЁЯО╣ => ЁЯО╣, рдЙрдкрдХрд░рдг, рдХреЛрдмреЛрд░реНрдб, рд╕рдВрдЧреАрдд, рдкрд┐рдпрд╛рдиреЛ
ЁЯО║ => ЁЯО║, рдЙрдкрдХрд░рдг, рд╕рдВрдЧреАрдд
ЁЯО╗ => ЁЯО╗, рдЙрдкрдХрд░рдг, рд╕рдВрдЧреАрдд
ЁЯУ╗ => ЁЯУ╗, рднрд┐рдбреЛрдпреЛ
ЁЯУ▒ => ЁЯУ▒, рдХрд▓, рдореЛрдмрд╛рдЗрд▓, рдлреЛрди, рдЯреЗрд▓рд┐рдлреЛрди
ЁЯУ▓ => ЁЯУ▓, рд╡рд╛рдг, рдХрд▓, рд╕реЗрд▓, рдореЛрдмрд╛рдЗрд▓, рдлреЛрди, рдкреНрд░рд╛рдкреНрдд, рдЯреЗрд▓рд┐рдлреЛрди
тШО => тШО, рдлреЛрди
ЁЯУЮ => ЁЯУЮ, рдлреЛрди, рд░рд┐рд╕рд┐рднрд░, рдЯреЗрд▓рд┐рдлреЛрди
ЁЯУа => ЁЯУа, рдлреНрдпрд╛рдХреНрд╕
ЁЯЦе => ЁЯЦе, рдХрдореНрдкреНрдпреБрдЯрд░, рдбреЗрд╕реНрдХрдЯрдк
ЁЯЦи => ЁЯЦи, рдХрдореНрдкреНрдпреБрдЯрд░
тМи => тМи, рдХрдореНрдкреНрдпреБрдЯрд░
ЁЯЦ▒ => ЁЯЦ▒, рей, рдмрдЯрди, рдХрдореНрдкреНрдпреБрдЯрд░, рдорд╛рдЙрд╕, рддреАрди
ЁЯЦ▓ => ЁЯЦ▓, рдХрдореНрдкреНрдпреБрдЯрд░
ЁЯТ╜ => ЁЯТ╜, рдХрдореНрдкреНрдпреБрдЯрд░, рдбрд┐рд╕реНрдХ, рдЕрдкреНрдЯрд┐рдХрд▓
ЁЯТ╛ => ЁЯТ╛, рдХрдореНрдкреНрдпреБрдЯрд░, рдбрд┐рд╕реНрдХ, рдлреНрд▓рдкрд┐
ЁЯТ┐ => ЁЯТ┐, рдбрд┐рднреАрдбреА, рдирд┐рд▓реЛ-рдХрд┐рд░рдг, рд╕рд┐рдбреА, рдХрдореНрдкреНрдпреБрдЯрд░, рдбрд┐рд╕реНрдХ рдЕрдкреНрдЯрд┐рдХрд▓
ЁЯУ║ => ЁЯУ║, рдЯрд┐рднреА, рднрд┐рдбреАрдпреЛ
ЁЯУ╖ => ЁЯУ╖, рднрд┐рдбреАрдпреЛ
ЁЯУ╕ => ЁЯУ╕, рдХреНрдпрд╛рдореЗрд░рд╛, рдлреНрд▓реНрдпрд╛рд╢, рднрд┐рдбреАрдпреЛ
ЁЯУ╣ => ЁЯУ╣, рдХреНрдпрд╛рдореЗрд░рд╛, рднрд┐рдбрд┐рдпреЛ
ЁЯУ╝ => ЁЯУ╝, рдЯреЗрдк, рднрд┐рдПрдЪрдПрд╕, рднрд┐рдбрд┐рдпреЛ
ЁЯФН => ЁЯФН, рдЧреНрд▓рд╛рд╕, рдореНрдпрд╛рдЧреНрдирд┐рдлрд╛рдЗрдЩ, рдЦреЛрдЬреНрдиреЗ, рд╕рд╛рдзрди
ЁЯФО => ЁЯФО, рдЧреНрд▓рд╛рд╕, рдореНрдпрд╛рдЧреНрдирд┐рдлрд╛рдЗрдЩ, рдЦреЛрдЬреНрдиреЗ, рд╕рд╛рдзрди
ЁЯФм => ЁЯФм, рд╕рд╛рдзрди
ЁЯФн => ЁЯФн, рд╕рд╛рдзрди
ЁЯУб => ЁЯУб, рдПрдиреНрдЯреЗрдирд╛, рдбрд┐рд╕реН, рд╕реНрдпрд╛рдЯрд▓рд╛рдЗрдЯ
ЁЯХп => ЁЯХп, рдмрддреНрддреА
ЁЯТб => ЁЯТб, рдмрддреНрддрд┐, рд░рдорд╛рдЗрд▓реЛ, рд╡рд┐рджреНрдпреБрддрд┐рдп, рд╡рд┐рдЪрд╛рд░, рдмрддреНрддреА
ЁЯФж => ЁЯФж, рд╡рд┐рджреНрдпреБрддрд┐рдп, рдмрддреНрддреА, рд╕рд╛рдзрди, рдЯрд░реНрдЪ
ЁЯПо => ЁЯПо, рдкрдЯреНрдЯреА, рдЬрд╛рдкрд╛рдирд┐рдЬ, рд▓рд╛рдирдЯрд┐рди, рдмрддреНрддреА, рд░рд╛рддреЛ
ЁЯУФ => ЁЯУФ, рдкреБрд╕реНрддрдХ, рдХрднрд░, рд╕рдЬрд┐рдПрдХреЛ, рдиреЛрдЯрдмреБрдХ
ЁЯУХ => ЁЯУХ, рдкреБрд╕реНрддрдХ, рдмрдиреНрдж рдЧрд░реЗрдХреЛ
ЁЯУЦ => ЁЯУЦ, рдкреБрд╕реНрддрдХ, рдЦреБрд▓рд╛
ЁЯУЧ => ЁЯУЧ, рдкреБрд╕реНрддрдХ, рд╣рд░рд┐рдпреЛ
ЁЯУШ => ЁЯУШ, рдиреАрд▓реЛ, рдкреБрд╕реНрддрдХ
ЁЯУЩ => ЁЯУЩ, рдкреБрд╕реНрддрдХ, рд╕реБрдиреНрддрд▓рд╛
ЁЯУЪ => ЁЯУЪ, рдкреБрд╕реНрддрдХ
ЁЯУТ => ЁЯУТ, рдиреЛрдЯрдмреБрдХ
ЁЯУЬ => ЁЯУЬ, рдкрд╛рдирд╛
ЁЯУД => ЁЯУД, рдХрд╛рдЧрдЬрд╛рдд, рдкрд╛рдирд╛
ЁЯУ░ => ЁЯУ░, рд╕рдорд╛рдЪрд╛рд░, рдкрддреНрд░
ЁЯЧЮ => ЁЯЧЮ, рд╕рдорд╛рдЪрд╛рд░, рд╕рдорд╛рдЪрд╛рд░рдкрддреНрд░, рдкрддреНрд░, рд░реЛрд▓ рдЧрд░рд┐рдПрдХреЛ
ЁЯУС => ЁЯУС, рдмреБрдХрдорд╛рд░реНрдХ, рдЪрд┐рдиреНрд╣, рдорд╛рд░реНрдХрд░, рдЯреНрдпрд╛рдмрд╣рд░реВ
ЁЯФЦ => ЁЯФЦ, рдЪрд┐рдиреНрд╣
ЁЯТ░ => ЁЯТ░, рдЭреЛрд▓рд╛, рдбрд▓рд░, рдкреИрд╕рд╛, рдкреИрд╕рд╛рдХреЛрдЭреЛрд▓рд╛
ЁЯТ┤ => ЁЯТ┤, рдмреИрдЩреНрдХ, рдмреИрдЩреНрдХрдиреЛрдЯ, рдмрд┐рд▓, рдореБрджреНрд░рд╛, рдкреИрд╕рд╛, рдиреЛрдЯ, рдпрд╛рди
ЁЯТ╡ => ЁЯТ╡, рдмреИрдЩреНрдХ, рдмреИрдЩреНрдХрдиреЛрдЯ, рдмрд┐рд▓, рдореБрджреНрд░рд╛, рдбрд▓рд░, рдкреИрд╕рд╛, рдиреЛрдЯ
ЁЯТ╢ => ЁЯТ╢, рдмреИрдЩреНрдХ, рдмреИрдЩреНрдХрдиреЛрдЯ, рдмрд┐рд▓, рдореБрджреНрд░рд╛, рдпреВрд░реЛ, рдкреИрд╕рд╛ рдиреЛрдЯ
ЁЯТ╖ => ЁЯТ╖, рдмреИрдЩреНрдХ, рдмреИрдЩреНрдХрдиреЛрдЯ, рдмрд┐рд▓, рдореБрджреНрд░рд╛, рдкреИрд╕рд╛, рдиреЛрдЯ, рдкрд╛рдЙрдгреНрдб
ЁЯТ╕ => ЁЯТ╕, рдмреИрдЩреНрдХ, рдмреИрдЩреНрдХрдиреЛрдЯ, рдмрд┐рд▓, рдбрд▓рд░, рдЙрдбреНрдиреЗ, рдкреИрд╕рд╛, рдиреЛрдЯ, рдкрдЦреЗрдЯрд╛
ЁЯТ│ => ЁЯТ│, рдмреИрдЩреНрдХ, рдХрд╛рд░реНрдб, рдХреНрд░реЗрдбрд┐рдЯ, рдкреИрд╕рд╛
ЁЯТ╣ => ЁЯТ╣, рдпреЗрди рдмрдврд┐рд░рд╣реЗрдХреЛ рдЪрд╛рд░реНрдЯ
тЬЙ => тЬЙ, рдЗрдореЗреЗрд▓:рдЗрдореЗрд▓
ЁЯУз => ЁЯУз, рдЗрдореЗрд▓, рдЪрд┐рдареНрдареА, рдореЗрд▓
ЁЯУи => ЁЯУи, рдЗрдореЗрд▓, рдЦрд╛рдо, рдЖрдЗрд░рд╣реЗрдХреЛ, рдЪрд┐рдареНрдареА, рдореЗрд▓, рдкреНрд░рд╛рдкреНрдд
ЁЯУй => ЁЯУй, рд╡рд╛рдг, рддрд▓, рдЗрдореЗрд▓, рдЦрд╛рдо, рдЪрд┐рдареНрдареА, рдореЗрд▓, рдмрд╛рд╣рд┐рд░ рдЧрдЗрд░рд╣реЗрдХреЛ, рдкрдард╛рдПрдХреЛ
ЁЯУд => ЁЯУд, рдмрдХреНрд╕, рдЪрд┐рдареНрдареА, рдореЗрд▓, рдЖрдЙрдЯрдмрдХреНрд╕, рдкрдард╛рдПрдХреЛ, рдЯреНрд░реЗ
ЁЯУж => ЁЯУж, рдмрдХреНрд╕, рдкрд╛рд░реНрд╕рд▓
ЁЯУл => ЁЯУл, рдмрдиреНрдж рднрдПрдХреЛ, рдореЗрд▓, рдореЗрд▓рдмрдХреНрд╕, рдЦреБрд▓рд╛, рдкреЛрд╕реНрдЯрдмрдХреНрд╕
ЁЯУк => ЁЯУк, рдмрдиреНрдж рднрдПрдХреЛ, рддрд▓реНрд▓реЛ рдЕрдХреНрд╖рд░рдХреЛ, рдореЗрд▓, рдореЗрд▓рдмрдХреНрд╕, рдкреЛрд╕реНрдЯрдмрдХреНрд╕
ЁЯУм => ЁЯУм, рдореЗрд▓, рдореЗрд▓рдмрдХреНрд╕, рдЦреБрд▓рд╛, рдкреЛрд╕реНрдЯрдмрдХреНрд╕
ЁЯУн => ЁЯУн, рддрд▓реНрд▓реЛ рдЕрдХреНрд╖рд░рдХреЛ, рдореЗрд▓, рдореЗрд▓рдмрдХреНрд╕, рдЦреБрд▓рд╛, рдкреЛрд╕реНрдЯрдмрдХреНрд╕
ЁЯУо => ЁЯУо, рдореЗрд▓, рдореЗрд▓рдмрдХреНрд╕
ЁЯЧ│ => ЁЯЧ│, рдорддрджрд╛рди, рдмрдХреНрд╕
тЬТ => тЬТ, рдирд┐рдм, рдХрд▓рдо
ЁЯЦЛ => ЁЯЦЛ, рдлрд╛рдЙрдиреНрдЯреЗрди, рдХрд▓рдо
ЁЯЦК => ЁЯЦК, рдмрд▓рдкреЛрдЗрдиреНрдЯ
ЁЯЦМ => ЁЯЦМ, рдкреЗрдиреНрдЯрд┐рдЩреН
ЁЯЦН => ЁЯЦН, рдХреНрд░реНрдпреЛрди
ЁЯУЭ => ЁЯУЭ, рдкреЗрдиреНрд╕рд┐рд▓
ЁЯУБ => ЁЯУБ, рдлрд╛рдЗрд▓, рдлреЛрд▓реНрдбрд░
ЁЯУВ => ЁЯУВ, рдлрд╛рдЗрд▓, рдлреЛрд▓реНрдбрд░, рдЦреЛрд▓реНрди
ЁЯЧВ => ЁЯЧВ, рдХрд╛рд░реНрдб, рдбреНрд░рд╛рдЗрднрд░рд╣рд░реВ, рд╕реВрдЪрдХ
ЁЯУЕ => ЁЯУЕ, рдорд┐рддрд┐
ЁЯУЖ => ЁЯУЖ, рдкрд╛рддреНрд░реЛ
ЁЯЧТ => ЁЯЧТ, рдиреЛрдЯ, рдкреНрдпрд╛рдб, рд╕реНрдкрд╛рдЗрд░рд▓
ЁЯУЗ => ЁЯУЗ, рдХрд╛рд░реНрдб, рд╕реВрдЪрдХ, рд░реЛрд▓реЛрдбреЗрдХреНрд╕
ЁЯУИ => ЁЯУИ, рдЪрд╛рд░реНрдЯ, рдЧреНрд░рд╛рдл, рд╡рд┐рдХрд╛рд╕, рдЯреНрд░реЗрдиреНрдЯ, рдорд╛рдерд┐
ЁЯУЙ => ЁЯУЙ, рдЪрд╛рд░реНрдЯ рдШрдЯреНрджреЛ
ЁЯУМ => ЁЯУМ, рдкрдЬрдкрд┐рди
ЁЯУН => ЁЯУН, рдкрд┐рди, рдкрдЬрдкрд┐рди
ЁЯЦЗ => ЁЯЦЗ, рд▓рд┐рдЩреНрдХ, рдкреЗрдкрд░рдХреНрд▓рд┐рдкрд╣рд░реВ
ЁЯУП => ЁЯУП, рд╕реНрдХреЗрд▓, рд╕рд┐рдзрд╛ рдХрд┐рдирд╛рд░рд╛
ЁЯУР => ЁЯУР, рд╕реНрдХреЗрд▓, рд╕реЗрдЯ, рддреНрд░рд┐рдХреЛрдг
тЬВ => тЬВ, рд╕рд╛рдзрди
ЁЯЧГ => ЁЯЧГ, рдмрдХреНрд╕, рдХрд╛рд░реНрдб, рдлрд╛рдЗрд▓
ЁЯЧД => ЁЯЧД, рдХреНрдпрд╛рдмрд┐рдиреЗрдЯ, рдлрд╛рдЗрд▓
ЁЯФТ => ЁЯФТ, рдмрдиреНрдж рдЧрд░реЗрдХреЛ
ЁЯФУ => ЁЯФУ, рддрд╛рд▓реНрдЪрд╛, рдЦреБрд▓рд╛, рддрд╛рд▓реНрдЪрд╛ рдЦреЛрд▓реНрди
ЁЯФП => ЁЯФП, рдкреЗрди рд╕рд╣рд┐рддрдХреЛ рд▓рдХ
ЁЯФС => ЁЯФС, рддрд╛рд▓реНрдЪрд╛, рдкрд╛рд╕рд╡рд░реНрдб
ЁЯЧЭ => ЁЯЧЭ, рд╕рдВрдХреЗрдд, рд╕рд╛рдБрдЪреЛ, рддрд╛рд▓реНрдЪрд╛, рдкреБрд░рд╛рдиреЛ
ЁЯФи => ЁЯФи, рд╕рд╛рдзрди
тЫП => тЫП, рд╕рд╛рдзрди
тЪТ => тЪТ, рдШрди, рдЙрдард╛рдЙрдиреЗ, рд╕рд╛рдзрди
ЁЯЫа => ЁЯЫа, рдШрди, рд╕рд╛рдзрди, рд░рд┐рдиреНрдЪ
ЁЯФз => ЁЯФз, рд╕рд╛рдзрди
ЁЯФй => ЁЯФй, рдмреЛрд▓реНрдЯ, рдирдЯ, рд╕рд╛рдзрди
тЪЩ => тЪЩ, рд╕рд╛рдзрди
ЁЯЧЬ => ЁЯЧЬ, рд╕рд╛рдзрди, рднрд╛рдЗрд╕
тЪЧ => тЪЧ, рдХреЗрдореЗрд╕реНрдЯреНрд░рд┐, рд╕рд╛рдзрди
тЪЦ => тЪЦ, рд╕рдиреНрддреБрд▓рди, рдиреНрдпрд╛рдп, рддреБрд▓рд╛, рд╕реНрдХреЗрд▓, рд╕рд╛рдзрди, рддреМрд▓, рд░рд╛рд╢рд┐
ЁЯТЙ => ЁЯТЙ, рдбрдХреНрдЯрд░, рдФрд╖рдзрд┐, рд╕реБрдИ, рд╕рдЯ, рдмрд┐рдорд╛рд░реА, рд╕рд╛рдзрди
ЁЯТК => ЁЯТК, рдбрд╛реНрдХреНрдЯрд░: рдФрд╖рдзрд┐, рдмрд┐рд░рд╛рдореА
ЁЯЧб => ЁЯЧб, рдЪрдХреНрдХреБ, рд╣рддрд┐рдпрд╛рд░
тЪФ => тЪФ, рдХреНрд░рд╕, рддрд░рд╡рд╛рд░, рд╣рддрд┐рдпрд╛рд░
ЁЯФл => ЁЯФл, рдмрдиреНрджреБрдХ, рд░рд┐рднрд▓реНрдмрд░, рд╕рд╛рдзрди, рд╣рддрд┐рдпрд╛рд░
ЁЯЫб => ЁЯЫб, рд╣рддрд┐рдпрд╛рд░
ЁЯП│ => ЁЯП│, рд╣рд▓реНрд▓рд┐рд░рд╣реЗрдХреЛ
ЁЯП┤ => ЁЯП┤, рд╣рд▓реНрд▓рд┐рд░рд╣реЗрдХреЛ
ЁЯЪй => ЁЯЪй, рдкреЛрд╕реНрдЯ
тЪ░ => тЪ░, рдореГрддреНрдпреБ
ЁЯЧ┐ => ЁЯЧ┐, рдЕрдиреБрд╣рд╛рд░, рдореВрд░реНрддрд┐
ЁЯЫв => ЁЯЫв, рдбреНрд░рдо, рддреЗрд▓
ЁЯФо => ЁЯФо, рдмрд▓, рдХреНрд░рд┐рд╕реНрдЯрд▓, рдкрд░реАрдХреЛ рдХрдерд╛, рдЦреЗрд╕реНрд░рд╛ рдХрд▓реНрдкрдирд╛, рднрд╛рдЧреНрдп, рд╕рд╛рдзрди
ЁЯПз => ЁЯПз, рдПрдЯрд┐рдПрдо, рдЕрдЯреЛрдореЗрдЯреЗрдб, рд░рд┐рдХреНрдд, рдЯреЗрд▓рд░
ЁЯЪо => ЁЯЪо, рдмрд┐рди рд╕рд╛рдЗрдирдХреЛ рд▓рд┐рдЯрд░
ЁЯЪ░ => ЁЯЪ░, рдкрд┐рдЙрдиреЗ: рдкрд┐рдЙрдирдпреЛрдЧреНрдп, рдкрд╛рдиреА
тЩ┐ => тЩ┐, рдкрд╣реБрдБрдЪ
ЁЯЪ╣ => ЁЯЪ╣, рдЖрд░рд╛рдордЧреГрд╣, рдкреБрд░реБрд╖, рдЖрд░рд╛рдо рдЧрд░реНрдиреЗ рдХреЛрдард╛, рдкрд╛рдиреАрдХреЛ рд╢реМрдЪрдШрд░
ЁЯЪ║ => ЁЯЪ║, рдЖрд░рд╛рдордЧреГрд╣, рд╡рд┐рд╢реНрд░рд╛рдо рдЧреГрд╣, рдкрд╛рдиреАрдХреЛ рд╢реМрдЪрдШрд░, рдорд╣рд┐рд▓рд╛
ЁЯЪ╗ => ЁЯЪ╗, рдЖрд░рд╛рдордЧреГрд╣, рдкрд╛рдиреАрдХреЛ рд╢реМрдЪрдШрд░
ЁЯЪ╝ => ЁЯЪ╝, рдмрдЪреНрдЪрд╛, рдкрд░рд┐рд╡рд░реНрддрди рдЧрд░рд┐рд░рд╣реЗрдХреЛ
ЁЯЪ╛ => ЁЯЪ╛, рд╢реМрдЪрдШрд░, рд╢реМрдЪрд╛рд▓рдп, рдЖрд░рд╛рдордЧреГрд╣, рдкрд╛рдиреА, рдкрд╛рдиреАрдХреЛ рд╢реМрдЪрдШрд░
ЁЯЫВ => ЁЯЫВ, рдЪреЗрдХрдЬрд╛рдБрдЪ: рдкрд╛рд╕рдкреЛрд░реНрдЯ
ЁЯЫГ => ЁЯЫГ, рд░реАрддрд┐рд░рд┐рд╡рд╛рдЬ
ЁЯЫД => ЁЯЫД, рдмреНрдпрд╛рдЧреЗрдЬ, рджрд╛рд╡реА
ЁЯЫЕ => ЁЯЫЕ, рдмреНрдпрд╛рдЧреЗрдЬ, рд▓рдХрд░, рд▓рдЧреЗрдЬ
ЁЯЪ╕ => ЁЯЪ╕, рдмрдЪреНрдЪрд╛, рдХреНрд░рд╕ рдЧрд░реНрджреИ, рдкрджрдпрд╛рддреНрд░реА, рдЯреНрд░рд╛рдлрд┐рдХ
тЫФ => тЫФ, рдкреНрд░рд╡реЗрд╢, рд░реЛрдХрд┐рдПрдХреЛ, рдЫреИрди, рд╣реЛрдЗрди, рдирд┐рд╖реЗрдзрд┐рдд, рдЯреНрд░рд╛рдлрд┐рдХ
ЁЯЪл => ЁЯЪл, рдкреНрд░рд╡реЗрд╢, рд░реЛрдХрд┐рдПрдХреЛ, рдЫреИрди, рд╣реЛрдЗрди
ЁЯЪ│ => ЁЯЪ│, рд╕рд╛рдЗрдХрд▓, рдмрд╛рдЗрдХ, рд░реЛрдХрд┐рдПрдХреЛ, рдЫреИрди, рд╣реЛрдЗрди, рдирд┐рд╖реЗрдзрд┐рдд, рд╕рд╡рд╛рд░реА
ЁЯЪн => ЁЯЪн, рд░реЛрдХрд┐рдПрдХреЛ, рдЫреИрди, рд╣реЛрдЗрди, рдирд┐рд╖реЗрдзрд┐рдд, рдзреБрдореНрд░рдкрд╛рди
ЁЯЪп => ЁЯЪп, рд░реЛрдХрд┐рдПрдХреЛ, рд▓рд┐рдЯрд░, рдЫреИрди, рд╣реЛрдЗрди, рдирд┐рд╖реЗрдзрд┐рдд
ЁЯЪ▒ => ЁЯЪ▒, рдкрд┐рдЙрди, рд░реЛрдХрд┐рдПрдХреЛ, рдЫреИрди, рд╣реЛрдЗрди, рдкреАрдЙрдирдпреЛрдЧреНрдп рдкрджрдпрд╛рддреНрд░реА, рдкрд╛рдиреА
ЁЯЪ╖ => ЁЯЪ╖, рд░реЛрдХрд┐рдПрдХреЛ, рдЫреИрди, рд╣реЛрдЗрди, рдкрджрдпрд╛рддреНрд░реА, рдирд┐рд╖реЗрдзрд┐рдд
тмЖ => тмЖ, рд╡рд╛рдг, рдХрд╛рд░реНрдбрд┐рдирд▓, рджрд┐рд╢рд╛, рдЙрддреНрддрд░
тЖЧ => тЖЧ, рд╡рд╛рдг, рджрд┐рд╢рд╛, рдХрд╛рд░реНрдбрд┐рдирд▓ рд╡рд┐рдкрд░рд┐рдд, рдЙрддреНрддрд░рджрдХреНрд╖реАрдг
тЖХ => тЖХ, рд╡рд╛рдг
тЖФ => тЖФ, рд╡рд╛рдг
тЖй => тЖй, рд╡рд╛рдг
тЖк => тЖк, рд╡рд╛рдг
тд┤ => тд┤, рд╡рд╛рдг
тд╡ => тд╡, рд╡рд╛рдг, рддрд▓
ЁЯФГ => ЁЯФГ, рд╡рд╛рдг, рдШрдбреАрдХреЛ рджрд┐рд╢рд╛ рддрд┐рд░, рдкреБрдирдГ рд▓реЛрдб
ЁЯФД => ЁЯФД, рдШрдбреАрдХреЛ рджрд┐рд╢рд╛ рд╡рд┐рдкрд░реАрдд рддрд┐рд░, рд╡рд╛рдг, рдШрдбреАрдХреЛ рджрд┐рд╢рд╛ рддрд┐рд░, рд╡рд┐рдерд░рд╕рд┐рдиреНрди
ЁЯФЩ => ЁЯФЩ, рд╡рд╛рдг, рдкрдЫрд╛рдбрд┐ рдЬрд╛рдиреЗ
ЁЯФЪ => ЁЯФЪ, рд╡рд╛рдг, рдЕрдиреНрддрд┐рдо
ЁЯФЫ => ЁЯФЫ, рд╡рд╛рдг, рдЪрд┐рдиреНрд╣, рдорд╛
ЁЯФЬ => ЁЯФЬ, рд╡рд╛рдг, рдЖрдЙрдиреЗ
ЁЯФЭ => ЁЯФЭ, рд╡рд╛рдг, рд╢реАрд░реНрд╖, рдорд╛рдерд┐
ЁЯЫР => ЁЯЫР, рдзрд░реНрдо, рдкреВрдЬрд╛ рдЧрд░реНрдиреЗ
тЪЫ => тЪЫ, рдирд╛рд╕реНрддрд┐рдХ, рдкрд░рдорд╛рдгреБ
ЁЯХЙ => ЁЯХЙ, рд╣рд┐рдиреНрджреБ, рдзрд░реНрдо
тЬб => тЬб, рдбреЗрднрд┐рдб, рдпрд╣реВрджреА, рдзрд░реНрдо, рддрд╛рд░рд╛
тШ╕ => тШ╕, рдмреБрджреНрдзрд┐рд╕реНрдЯ, рдзрд░реНрдорд╛, рдзрд░реНрдо, рдкрд╛рдЩреНрдЧреНрд░рд╛
тШп => тШп, рдзрд░реНрдо, рдЯрд╛рд╡реЛ, рдЯрд╛рд╡рд┐рд╕реНрдЯ, рдпрд╛рдЩреНрдЧ, рдпрд┐рди
тЬЭ => тЬЭ, рдХреНрд░рд┐рд╕реНрдЪрд┐рдпрди, рдХреНрд░рд╕, рдзрд░реНрдо
тШж => тШж, рдХреНрд░рд┐рд╕реНрдЪрд┐рдпрди, рдХреНрд░рд╕, рдзрд░реНрдо
тШк => тШк, рдЗрд╕реНрд▓рд╛рдо, рдореБрд╕реНрд▓рд┐рдо, рдзрд░реНрдо
тШо => тШо, рд╢рд╛рдиреНрддрд┐
ЁЯХО => ЁЯХО, рдХреНрдпрд╛рдиреНрдбреЗрд▓рд╛рдмреНрд░рдо: рдХреНрдпрд╛рдиреНрдбреЗрд▓рд╕реНрдЯрд┐рдХ, рдзрд░реНрдо
ЁЯФп => ЁЯФп, рднрд╛рдЧреНрдп, рддрд╛рд░рд╛
тЩ╗ => тЩ╗, рд░рд┐рд╕рд╛рдЗрдХрд▓
ЁЯУЫ => ЁЯУЫ, рдмреНрдпрд╛рдбреНрдЬ, рдирд╛рдо
ЁЯФ░ => ЁЯФ░, рд╕реБрд░реБрд╡рд╛рдд рдЧрд░реНрдиреЗ, рдЪреЗрднрд░реЛрди, рдЬрд╛рдкрд╛рдирд┐рдЬ, рдкрд╛рдд, рд╕рд╛рдзрди, рдкрд╣реЗрдБрд▓реЛ
ЁЯФ▒ => ЁЯФ▒, рдЙрджреНрдШреЛрд╖рдХ, рдкреНрд░рддрд┐рдХ, рдбреБрдЩреНрдЧрд╛, рд╕рд╛рдзрди, рдЯреНрд░рд┐рдбреЗрдиреНрдЯ
тнХ => тнХ, рд╡реГрддреНрдд, o
тЬЕ => тЬЕ, рдЬрд╛рдБрдЪ, рдЪрд┐рдиреНрд╣
тШС => тШС, рдорддрджрд╛рди, рдмрдХреНрд╕, рдЬрд╛рдБрдЪ
тЬФ => тЬФ, рдЬрд╛рдБрдЪ, рдЪрд┐рдиреНрд╣
тЬЦ => тЬЦ, рд░рджреНрдж, рдЧреБрдгрд╛рдЩреНрдХ, рдЧреБрдгрд╛рди, рдПрдХреНрд╕
тЭМ => тЭМ, рд░рджреНрдж, рдЪрд┐рдиреНрд╣, рдЧреБрдгрд╛рдЩреНрдХ, рдЧреБрдгрд╛рди, рдПрдХреНрд╕
тЭО => тЭО, рдЪрд┐рдиреНрд╣, рд╡рд░реНрдЧ
тЮХ => тЮХ, рд╣рд┐рд╕рд╛рдм, рдЬреЛрдб
тЮЦ => тЮЦ, рдШрдЯрд╛рдЙ, рд╣рд┐рд╕рд╛рдм
тЮЧ => тЮЧ, рднрд╛рдЧ, рд╣рд┐рд╕рд╛рдм
тЮ░ => тЮ░, рдХрд░реНрд▓реА, рд▓реБрдк
тЮ┐ => тЮ┐, рдХрд░реНрд▓реА, рджреЛрд╣реЛрд░реЛ, рд▓реБрдк
уА╜ => уА╜, рдЪрд┐рдиреНрд╣, рднрд╛рдЧ
тЬ│ => тЬ│, рддрд╛рд░рд╛рдВрдХрди рдЪрд┐рдиреНрд╣
тЬ┤ => тЬ┤, рддрд╛рд░рд╛
ЁЯТ▒ => ЁЯТ▒, рдмреИрдЩреНрдХ, рдореБрджреНрд░рд╛, рдмрд┐рдирд┐рдордп, рдкреИрд╕рд╛
ЁЯТ▓ => ЁЯТ▓, рдореБрджреНрд░рд╛, рдбрд▓рд░, рдкреИрд╕рд╛
тА╝ => тА╝, рдмреНрдпрд╛рдЩреНрдмреНрдпрд╛рдЩреН, рд╡рд┐рд╕реНрдордпрд╛рдзрд┐рдмреЛрдзрдХ рдЪрд┐рдиреНрд╣, рдЪрд┐рдиреНрд╣, рд╡рд┐рд░рд╛рдо рдЪрд┐рдиреНрд╣
тБЙ => тБЙ, рд╡рд┐рд╕реНрдордпрд╛рдзрд┐рдмреЛрдзрдХ, рдЗрдиреНрдЯреНрд░реЛрдмреНрдпрд╛рдЩреНрдЧ, рдЪрд┐рдиреНрд╣, рд╡рд┐рд░рд╛рдо рдЪрд┐рдиреНрд╣, рдкреНрд░рд╢реНрди
тЭУ => тЭУ, рдЪрд┐рдиреНрд╣, рд╡рд┐рд░рд╛рдо рдЪрд┐рдиреНрд╣, рдкреНрд░рд╢реНрди
тЭФ => тЭФ, рдЪрд┐рдиреНрд╣, рдмрд╛рд╣рд┐рд░рд┐ рд░реЗрдЦрд╛, рд╡рд┐рд░рд╛рдо рдЪрд┐рдиреНрд╣, рдкреНрд░рд╢реНрди
тЭХ => тЭХ, рд╡рд┐рд╕реНрдордпрд╛рдзрд┐рдмреЛрдзрдХ, рдЪрд┐рдиреНрд╣, рдмрд╛рд╣рд┐рд░рд┐ рд░реЗрдЦрд╛, рд╡рд┐рд░рд╛рдо рдЪрд┐рдиреНрд╣
тЭЧ => тЭЧ, рд╡рд┐рд╕реНрдордпрд╛рдзрд┐рдмреЛрдзрдХ, рдЪрд┐рдиреНрд╣, рд╡рд┐рд░рд╛рдо рдЪрд┐рдиреНрд╣
уА░ => уА░, рдбреНрдпрд╛рд╢, рд╡рд┐рд░рд╛рдо рдЪрд┐рдиреНрд╣, рдЭреБрдиреНрдбрд┐рдПрдХреЛ
тДв => тДв, рдЪрд┐рдиреНрд╣, рдЯрд┐рдПрдо
тЩИ => тЩИ, рд░рд╛рдо, рд░рд╛рд╢рд┐
тЩЙ => тЩЙ, рдЧреЛрд░реВ, рд░рд╛рд╢рд┐
тЩК => тЩК, рд╕рдорд╛рди, рд░рд╛рд╢рд┐
тЩЛ => тЩЛ, рд░рд╛рд╢рд┐
тЩМ => тЩМ, рд░рд╛рд╢рд┐
тЩН => тЩН, рдХреБрдорд╛рд░реА, рд░рд╛рд╢рд┐
тЩО => тЩО, рд╕рдиреНрддреБрд▓рди, рдиреНрдпрд╛рдп, рд╕реНрдХреЗрд▓, рд░рд╛рд╢рд┐
тЩП => тЩП, рд╡рд┐рдЪреНрдЫреБ, рд░рд╛рд╢рд┐
тЩР => тЩР, рд░рд╛рд╢рд┐
тЩС => тЩС, рдмрд╛рдЦреНрд░рд╛, рд░рд╛рд╢рд┐
тЩТ => тЩТ, рдзрд╛рд░рдХ, рдкрд╛рдиреА, рд░рд╛рд╢рд┐
тЩУ => тЩУ, рдорд╛рдЫрд╛, рд░рд╛рд╢рд┐
тЫО => тЫО, рдзрд╛рд░рдХ, рдирд╛рдЧ, рд╕рд░реНрдк, рд░рд╛рд╢рд┐
ЁЯФА => ЁЯФА, рд╡рд╛рдг, рдХреНрд░рд╕ рдЧрд░реЗрдХреЛ
ЁЯФБ => ЁЯФБ, рд╡рд╛рдг, рдШрдбреАрдХреЛ рджрд┐рд╢рд╛рддрд┐рд░, рджреЛрд╣реЛрд░реНрдпрд╛рдЙрди
ЁЯФВ => ЁЯФВ, рд╡рд╛рдг, рдШрдбреАрдХреЛ рджрд┐рд╢рд╛рддрд┐рд░, рдПрдХ рдкрдЯрдХ
тЦ╢ => тЦ╢, рд╡рд╛рдг, рдмрдЬрд╛рдЙрди, рджрд╛рдпрд╛рдБ, рддреНрд░рд┐рдХреЛрдг
тПй => тПй, рд╡рд╛рдг, рджреЛрд╣реЛрд░реЛ, рдЫрд┐рдЯреЛ, рдлрд░реНрд╡рд╛рдб
тПн => тПн, рд╡рд╛рдг, рдЕрд░реНрдХреЛ рджреГрд╢реНрдп, рдЕрд░реНрдХреЛ рдЯреНрд░рдпрд╛рдХ, рддреНрд░рд┐рдХреЛрдг
тПп => тПп, рд╡рд╛рдг, рд░реЛрдХреНрдиреЗ, рдмрдЬрд╛рдЙрдиреЗ, рджрд╛рдпрд╛рдБ, рддреНрд░рд┐рдХреЛрдг
тЧА => тЧА, рд╡рд╛рдг, рдмрд╛рдпрд╛рдБ, рдЙрд▓реНрдЯреНрдпрд╛рдЙрди, рддреНрд░рд┐рдХреЛрдг
тПк => тПк, рд╡рд╛рдг, рджреЛрд╣реЛрд░реЛ, рджреЛрд╣реЛрд░реНрдпрд╛рдЙрди
тПо => тПо, рд╡рд╛рдг, рдЕрдШрд┐рд▓реНрд▓реЛ рджреГрд╢реНрдп, рдЕрдШрд┐рд▓реНрд▓реЛ рдЯреНрд░рдпрд╛рдХ, рддреНрд░рд┐рдХреЛрдг
ЁЯФ╝ => ЁЯФ╝, рд╡рд╛рдг, рдмрдЯрди, рд░рд╛рддреЛ
тПл => тПл, рд╡рд╛рдг, рджреЛрд╣реЛрд░реЛ
ЁЯФ╜ => ЁЯФ╜, рд╡рд╛рдг, рдмрдЯрди, рддрд▓, рд░рд╛рддреЛ
тПм => тПм, рд╡рд╛рдг, рджреЛрд╣реЛрд░реЛ, рддрд▓
тП╕ => тП╕, рдкрдЯреНрдЯреА, рджреЛрд╣реЛрд░реЛ, рд░реЛрдХреНрдиреЗ, рдард╛рдбреЛ
тПП => тПП, рдмрд╛рд╣рд┐рд░ рдирд┐рд╕реНрдХрдиреЗ
ЁЯОж => ЁЯОж, рдХреНрдпрд╛рдореЗрд░рд╛, рдлрд┐рд▓реНрдо
ЁЯФЕ => ЁЯФЕ, рдЪрдореНрдХрд┐рд▓реЛ, рдордзреБрд░реЛ, рдХрдо
ЁЯФЖ => ЁЯФЖ, рдЪрдордХ, рдЪрдореНрдХрд┐рд▓реЛ
ЁЯУ╡ => ЁЯУ╡, рд╕реЗрд▓, рд░реЛрдХрд┐рдПрдХреЛ, рдореЛрдмрд╛рдЗрд▓, рдЫреИрди, рд╣реЛрдЗрди, рдлреЛрди, рдирд┐рд╢реЗрд╖рд┐рдз, рдЯреЗрд▓рд┐рдлреЛрди
ЁЯУ│ => ЁЯУ│, рд╕реЗрд▓, рдореЛрдмрд╛рдЗрд▓, рдореЛрдб, рдлреЛрди, рдЯреЗрд▓рд┐рдлреЛрди, рднрд╛рдЗрдмреНрд░реЗрд╕рди
ЁЯУ┤ => ЁЯУ┤, рд╕реЗрд▓, рдореЛрдмрд╛рдЗрд▓, рдмрдиреНрдж, рдлреЛрди, рдЯреЗрд▓рд┐рдлреЛрди
#тГг => #тГг, рд╣реНрдпрд╛рд╢, рдХрд┐рдХреНрдпрд╛рдк, рдкрд╛рдЙрдгреНрдб
*тГг => *тГг, рдЕрдпрд╛рд╕реНрдЯреНрд░рд┐рдХ, рдХрд┐рдХреНрдпрд╛рдк, рддрд╛рд░рд╛
0тГг => 0тГг, реж, рдХрд┐рдХреНрдпрд╛рдк, рдЕрдВрдХ рд╢реБрдиреНрдп
1тГг => 1тГг, рез, рдХрд┐рдХреНрдпрд╛рдк, рдЕрдВрдХ рдПрдХ
2тГг => 2тГг, реи, рдХрд┐рдХреНрдпрд╛рдк, рдЕрдВрдХ рджреБрдИ
3тГг => 3тГг, рей, рдХрд┐рдХреНрдпрд╛рдк, рдЕрдВрдХ рддреАрди
4тГг => 4тГг, рек, рдХрд┐рдХреНрдпрд╛рдк, рдЕрдВрдХ рдЪрд╛рд░
5тГг => 5тГг, рел, рдХрд┐рдХреНрдпрд╛рдк, рдЕрдВрдХ рдкрд╛рдБрдЪ
6тГг => 6тГг, рем, рдХрд┐рдХреНрдпрд╛рдк, рдЕрдВрдХ рдЫ
7тГг => 7тГг, рен, рдХрд┐рдХреНрдпрд╛рдк, рдЕрдВрдХ рд╕рд╛рдд
8тГг => 8тГг, рео, рдХрд┐рдХреНрдпрд╛рдк, рдЕрдВрдХ рдЖрда
9тГг => 9тГг, реп, рдХрд┐рдХреНрдпрд╛рдк, рдЕрдВрдХ рдиреМ
ЁЯФЯ => ЁЯФЯ, резреж, рдХрд┐рдХреНрдпрд╛рдк, рдЕрдВрдХ рджрд╢
ЁЯТп => ЁЯТп, резрежреж:рдкреВрд░рд╛:рд╕рдп: рдЕрдВрдХ
ЁЯФЮ => ЁЯФЮ, резрео рдЙрдореЗрд░ рдкреНрд░рддрд┐рдмрдиреНрдз, рдЕрдард╛рд░, рд░реЛрдХрд┐рдПрдХреЛ, рдЫреИрди, рд╣реЛрдЗрди, рдирд┐рд╖реЗрдзрд┐рдд, рдХрдо рдЙрдореЗрд░
ЁЯФа => ЁЯФа, рд░рд╛рдЦреНрди, рд▓реНрдпрд╛рдЯрд┐рди, рдЕрдХреНрд╖рд░рд╣рд░реВ, рдареВрд▓реЛ рдЕрдХреНрд╖рд░
ЁЯФб => ЁЯФб, рдПрдмреАрд╕реАрдбреА, рд░рд╛рдЦреНрди, рд▓реНрдпрд╛рдЯрд┐рди, рдЕрдХреНрд╖рд░рд╣рд░реВ, рд╕рд╛рдиреЛ рдЕрдХреНрд╖рд░
ЁЯФв => ЁЯФв, резреирейрек, рд░рд╛рдЦреНрди: рд╕рдВрдЦреНрдпрд╛рд╣рд░реВ
ЁЯФг => ЁЯФг, рд░рд╛рдЦреНрди
ЁЯФд => ЁЯФд, рдПрдмреАрд╕реА, рдЕрдХреНрд╖рд░, рд░рд╛рдЦреНрди, рд▓реНрдпрд╛рдЯрд┐рди, рдЕрдХреНрд╖рд░рд╣рд░реВ
ЁЯЕ░ => ЁЯЕ░, рдП, рд░рдЧрдд
ЁЯЖО => ЁЯЖО, рдПрдмреА, рд░рдЧрдд
ЁЯЕ▒ => ЁЯЕ▒, рдмрд┐, рд░рдЧрдд
ЁЯЖС => ЁЯЖС, рд╕рд┐рдПрд▓
ЁЯЖТ => ЁЯЖТ, рдХреВрд▓
ЁЯЖУ => ЁЯЖУ, рдирд┐рдГрд╢реБрд▓реНрдХ
тД╣ => тД╣, рдЖрдИ, рдЬрд╛рдирдХрд╛рд░реА
ЁЯЖФ => ЁЯЖФ, рдЖрдИрдбреА, рдкрд╣рд┐рдЪрд╛рди
тУВ => тУВ, рдЧреЛрд▓реЛ, рдПрдо
ЁЯЖХ => ЁЯЖХ, рдирдпрд╛рдБ
ЁЯЖЦ => ЁЯЖЦ, рдПрдирдЬреА
ЁЯЕ╛ => ЁЯЕ╛, рд░рдЧрдд
ЁЯЖЧ => ЁЯЖЧ, рдареАрдХ
ЁЯЕ┐ => ЁЯЕ┐, рдкрд╛рд░реНрдХрд┐рдЩреН
ЁЯЖШ => ЁЯЖШ, рдорджрдд, рдПрд╕рдУрдПрд╕
ЁЯЖЩ => ЁЯЖЩ, рдЪрд┐рдиреНрд╣, рдорд╛рдерд┐
ЁЯЖЪ => ЁЯЖЪ, рдЙрд▓реНрдЯреЛ, рд╡рд┐рдкрд░реАрдд
ЁЯИБ => ЁЯИБ, рдЬрд╛рдкрд╛рдирд┐рдЬ
ЁЯИВ => ЁЯИВ, рдЬрд╛рдкрд╛рдирд┐рдЬ
ЁЯИ╖ => ЁЯИ╖, рдЬрд╛рдкрд╛рдирд┐рдЬ
ЁЯИ╢ => ЁЯИ╢, рдЬрд╛рдкрд╛рдирд┐рдЬ
ЁЯИп => ЁЯИп, рдЬрд╛рдкрд╛рдирд┐рдЬ
ЁЯЙР => ЁЯЙР, рдЬрд╛рдкрд╛рдирд┐рдЬ
ЁЯИ╣ => ЁЯИ╣, рдЬрд╛рдкрд╛рдирд┐рдЬ
ЁЯИЪ => ЁЯИЪ, рдЬрд╛рдкрд╛рдирд┐рдЬ
ЁЯИ▓ => ЁЯИ▓, рдЬрд╛рдкрд╛рдирд┐рдЬ
ЁЯЙС => ЁЯЙС, рдЪрд┐рдирд┐рдпрд╛рдБ
ЁЯИ╕ => ЁЯИ╕, рдЪрд┐рдирд┐рдпрд╛рдБ
ЁЯИ┤ => ЁЯИ┤, рдЪрд┐рдирд┐рдпрд╛рдБ
ЁЯИ│ => ЁЯИ│, рдЪрд┐рдирд┐рдпрд╛рдБ
уКЧ => уКЧ, рдЪрд┐рдирд┐рдпрд╛рдБ, рдмрдзрд╛рдИ, рдмрдзрд╛рдИрд╣рд░реВ рдЖрдЗрдбрд┐рдпреЛрдЧреНрд░рд╛рдл
уКЩ => уКЩ, рдЪрд┐рдирд┐рдпрд╛рдБ, рдЖрдЗрдбрд┐рдпреЛрдЧреНрд░рд╛рдл, рдЧреЛрдкреНрдп
ЁЯИ║ => ЁЯИ║, рдЪрд┐рдирд┐рдпрд╛рдБ
ЁЯИ╡ => ЁЯИ╡, рдЪрд┐рдирд┐рдпрд╛рдБ
тЦк => тЦк, рдЬреНрдпрд╛рдорд┐рддреАрдп, рд╡рд░реНрдЧ
тЦл => тЦл, рдЬреНрдпрд╛рдорд┐рддреАрдп, рд╡рд░реНрдЧ
тЧ╗ => тЧ╗, рдЬреНрдпрд╛рдорд┐рддреАрдп, рд╡рд░реНрдЧ
тЧ╝ => тЧ╝, рдЬреНрдпрд╛рдорд┐рддреАрдп, рд╡рд░реНрдЧ
тЧ╜ => тЧ╜, рдЬреНрдпрд╛рдорд┐рддреАрдп, рд╡рд░реНрдЧ
тЧ╛ => тЧ╛, рдЬреНрдпрд╛рдорд┐рддреАрдп, рд╡рд░реНрдЧ
тмЫ => тмЫ, рдЬреНрдпрд╛рдорд┐рддреАрдп, рд╡рд░реНрдЧ
тмЬ => тмЬ, рдЬреНрдпрд╛рдорд┐рддреАрдп, рд╡рд░реНрдЧ
ЁЯФ╢ => ЁЯФ╢, рд╣рд┐рд░рд╛, рдЬреНрдпрд╛рдорд┐рддреАрдп, рд╕реБрдиреНрддрд▓рд╛
ЁЯФ╖ => ЁЯФ╖, рдиреАрд▓реЛ, рд╣рд┐рд░рд╛, рдЬреНрдпрд╛рдорд┐рддреАрдп
ЁЯФ╕ => ЁЯФ╕, рд╣рд┐рд░рд╛, рдЬреНрдпрд╛рдорд┐рддреАрдп, рд╕реБрдиреНрддрд▓рд╛
ЁЯФ╣ => ЁЯФ╣, рдиреАрд▓реЛ, рд╣рд┐рд░рд╛, рдЬреНрдпрд╛рдорд┐рддреАрдп
ЁЯФ║ => ЁЯФ║, рдЬреНрдпрд╛рдорд┐рддреАрдп, рд░рд╛рддреЛ
ЁЯФ╗ => ЁЯФ╗, рддрд▓, рдЬреНрдпрд╛рдорд┐рддреАрдп, рд░рд╛рддреЛ
ЁЯТа => ЁЯТа, рд╣рдБрд╕рд╛рдЙрдиреЗ, рд╣рд┐рд░рд╛, рдЬреНрдпрд╛рдорд┐рддреАрдп, рднрд┐рддреНрд░
ЁЯФШ => ЁЯФШ, рдмрдЯрди, рдЬреНрдпрд╛рдорд┐рддреАрдп, рд░реЗрдбрд┐рдпреЛ
ЁЯФ▓ => ЁЯФ▓, рдмрдЯрди, рдЬреНрдпрд╛рдорд┐рддреАрдп, рд╡рд░реНрдЧ
ЁЯФ│ => ЁЯФ│, рдмрдЯрди, рдЬреНрдпрд╛рдорд┐рддреАрдп, рдЫреЗрдЙрдХреЛ рд░реЗрдЦрд╛, рд╡рд░реНрдЧ
тЪк => тЪк, рдШреЗрд░рд╛, рдЬреНрдпрд╛рдорд┐рддреАрдп
тЪл => тЪл, рдШреЗрд░рд╛, рдЬреНрдпрд╛рдорд┐рддреАрдп
ЁЯФ┤ => ЁЯФ┤, рдШреЗрд░рд╛, рдЬреНрдпрд╛рдорд┐рддреАрдп, рд░рд╛рддреЛ
ЁЯФ╡ => ЁЯФ╡, рдиреАрд▓реЛ, рдШреЗрд░рд╛, рдЬреНрдпрд╛рдорд┐рддреАрдп
