ЁЯША => ЁЯША, рж╣рж╛ржБрж╣рж┐, рж╣рж╛ржБрж╣рж┐ ржержХрж╛, рж╣рж╛ржБрж╣рж┐ ржержХрж╛ ржорзБржЦ, рж╣рж╛ржБрж╣рж┐ржорзБржЦрзА, ржорзБржЦ, ржорж┐ржЪрж┐ржХрж┐рзЯрж╛, ржХрзМрждрзБржХ
ЁЯШБ => ЁЯШБ, рж╣рж╛ржБрж╣рж┐, ржорж┐ржЪрж┐ржХрж┐рзЯрж╛ ржорзБржЦ, ржорж┐ржЪрж┐ржХрж┐рзЯрж╛, ржорж┐ржЪрж┐ржХрж┐рзЯрж╛ ржЪржХрзБ рж╕рж╣ рж╣рж╛ржБрж╣рж┐ ржержХрж╛ ржорзБржЦ, рж╣ржБрж╣рж╛, ржХрзМрждрзБржХ
ЁЯШВ => ЁЯШВ, ржЖржиржирзНржжрз░ ржЪржХрзБржкрж╛ржирзА, ржЖржиржирзНржж, ржЖржиржирзНржжрз░ ржЪржХрзБржкрж╛ржирзА рж╕рж╣ ржорзБржЦ, ржорзБржЦ
ЁЯШГ => ЁЯШГ, ржЦрзЛрж▓рж╛ ржорзБржЦрзЗрз░рзЗ ржорж┐ржЪрж┐ржХрж┐рзЯрж╛, ржорж┐ржЪрж┐ржХрж┐рзЯрж╛, ржорзБржЦ, ржХрзМрждрзБржХ
ЁЯШД => ЁЯШД, ржЦрзЛрж▓рж╛ ржорзБржЦрзЗрз░рзЗ ржорж┐ржЪрж┐ржХрж┐рзЯрж╛, ржорж┐ржЪрж┐ржХрж┐рзЯрж╛, ржорзБржЦ, ржорж┐ржЪрж┐ржХрж┐рзЯрж╛ ржЪржХрзБ, ржХрзМрждрзБржХ
ЁЯШЕ => ЁЯШЕ, ржарж╛ржгрзНржбрж╛ ржШрж╛ржорз░ ржорж┐ржЪрж┐ржХрж┐рзЯрж╛, ржарж╛ржгрзНржбрж╛ ржШрж╛ржо рж╕рж╣ ржорж┐ржЪрж┐ржХрж┐рзЯрж╛ рж╣рж╛ржБрж╣рж┐
ЁЯШЖ => ЁЯШЖ, ржЦрзЛрж▓рж╛ ржорзБржЦрз░ ржорж┐ржЪрж┐ржХрж┐рзЯрж╛ рж╣рж╛ржБрж╣рж┐, ржмржирзНржз ржЪржХрзБрз░рзЗ ржорж┐ржЪрж┐ржХрж┐рзЯрж╛ рж╣рж╛ржБрж╣рж┐, ржЦрзЛрж▓рж╛ ржорзБржЦ, ржмржирзНржз ржЪржХрзБ, ржорзБржЦ
ЁЯШЙ => ЁЯШЙ, ржЪржХрзБ ржЯрж┐ржкрж┐ржУрз▒рж╛ ржорзБржЦ, ржЪржХрзБ ржЯрж┐ржкрж┐ржУрз▒рж╛
ЁЯШК => ЁЯШК, ржорж┐ржЪрж┐ржХрж┐рзЯрж╛ рж╣рж╛ржБрж╣рж┐, ржорж┐ржЪрж┐ржХрж┐рзЯрж╛ ржЪржХрзБ, ржорж┐ржЪрж┐ржХрж┐рзЯрж╛ ржорзБржЦ ржЖрз░рзБ ржЪржХрзБ, ржорж┐ржЪрж┐ржХрж┐рзЯрж╛ ржорзБржЦ, ржорзБржЦ
ЁЯШЛ => ЁЯШЛ, рж╕рзБрж╕рзНржмрж╛ржжрзБ ржорзБржЦ, рж╕рзБрж╕рзНржмрж╛ржжрзБ, ржорж┐ржЪрж┐ржХрж┐рзЯрж╛ рж╣рж╛ржБрж╣рж┐рз░ ржорзБржЦ, рж╕рзБрж╕рзНржмрж╛ржжрзБ ржЦрж╛ржжрзНржп, ржорзБржЦ
ЁЯШО => ЁЯШО, ржХрзБрж▓, ржЪрж╛ржиржЧрзНрж▓рж╛ржЫ рж╕рж╣ ржорж┐ржЪрж┐ржХрж┐рзЯрж╛ржЗ рж╣ржБрж╣рж╛, ржорж┐ржЪрж┐ржХрж┐рзЯрж╛ рж╣рж╛ржБрж╣рж┐, ржЪрж╛ржиржЧрзНрж▓рж╛ржЫ
ЁЯШН => ЁЯШН, ржорж┐ржЪрж┐ржХрж┐рзЯрж╛ рж╣рж╛ржБрж╣рж┐рз░ ржорзБржЦ, рж╣рзГржжрзЯ ржЪржХрзБ, ржкрзНрз░рзЗржо, ржорз░ржорж▓ржЧрж╛, ржЪржХрзБ, ржорзБржЦ
ЁЯШШ => ЁЯШШ, ржЪрзБржорзНржмржи ржкрзНрз░рзЗрз░ржг ржХрз░рж╛, ржЪрзБржорзНржмржи ржкрзНрз░рзЗрз░ржг ржХрз░рж╛ ржорзБржЦ
ЁЯШЧ => ЁЯШЧ, ржЪрзБржорзНржмржи ржорзБржЦ, ржЪрзБржорзНржмржи, ржорзБржЦ
ЁЯШЩ => ЁЯШЩ, ржЪрзБржорзНржмржи ржЖрз░рзБ ржорж┐ржЪрж┐ржХрж┐рзЯрж╛ рж╣рж╛ржБрж╣рж┐, ржорж┐ржЪрж┐ржХрж┐рзЯрж╛ рж╣рж╛ржБрж╣рж┐ рж╕рж╣ ржЪрзБржорзНржмржи ржжрж┐рзЯрж╛ ржорзБржЦ
ЁЯШЪ => ЁЯШЪ, ржЪрзБржорзНржмржи, ржЪржХрзБ ржмржирзНржз ржХрз░рж┐ ржЪрзБржорзНржмржи, ржмржирзНржз ржЪржХрзБ
тШ║ => тШ║, ржорж┐ржЪрж┐ржХрж┐рзЯрж╛ржЗ ржержХрж╛ ржорзБржЦ, рж╕рзНржорж╛ржЗрж▓рзА, ржнрз░рзНрждрж┐ ржиржХрз░рж╛ рж╕рзНржорж╛ржЗрж▓рзА ржорзБржЦ, ржорзБржЦ
ЁЯШЗ => ЁЯШЗ, ржЬрзНржпрзЛрждрж┐ржГржЪржХрзНрз░ рж╕рж╣ ржорж┐ржЪрж┐ржХрж┐рзЯрж╛ рж╣рж╛ржБрж╣рж┐, ржорж┐ржЪрж┐ржХрж┐рзЯрж╛ рж╣рж╛ржБрж╣рж┐, ржЬрзНржпрзЛрждрж┐ржГржЪржХрзНрз░, ржорзБржЦ
ЁЯШР => ЁЯШР, ржирж┐рж╕рзНрждрзЗржЬ ржорзБржЦ, ржирж┐рз░ржкрзЗржХрзНрж╖ ржорзБржЦ, ржирж┐рж╕рзНрждрзЗржЬ, ржирж┐рз░ржкрзЗржХрзНрж╖, ржорзБржЦ, ржорждрж╛ржоржд ржирж╛ржЗ
ЁЯШС => ЁЯШС, ржоржирзЛржнрж╛рз▒рж╣рзАржи, ржоржирзЛржнрж╛рз▒ ржкрзНрз░ржХржЯ ржиржХрз░рж╛ ржорзБржЦ, ржорзБржЦ, ржорждрж╛ржоржд ржирж╛ржЗ
ЁЯШ╢ => ЁЯШ╢, ржорзБржЦ ржирзЛрж╣рзЛрз▒рж╛ ржорзБржЦржоржгрзНржбрж▓, ржорзБржЦ ржЕржмрж┐рж╣ржирзЗ ржорзБржЦржоржгрзНржбрж▓
ЁЯШП => ЁЯШП, ржмрзЗржБржХрж╛ рж╣рж╛ржБрж╣рж┐, ржмрзЗржБржХрж╛ рж╣рж╛ржБрж╣рж┐рз░ ржорзБржЦ, ржорзБржЦ
ЁЯШг => ЁЯШг, ржнрзБрж▓ ржХрз░рж┐рж▓рзЛржБ, ржоржЗ ржнрзБрж▓ ржХрз░рж┐рж▓рзЛржБ ржорзБржЦ, ржЕржХрзНрж▓рж╛ржирзНржд ржорзБржЦ, ржЕржХрзНрж▓рж╛ржирзНржд, ржорзБржЦ
ЁЯШе => ЁЯШе, ржУрж╣!, ржЕрж╕ржирзНрждрзБрж╖рзНржЯ ржХрж┐ржирзНрждрзБ рж╕ржХрж╛рж╣ ржкрзНрз░рж╛ржкрзНржд, рж╕ржХрж╛рж╣ ржкрзНрз░рж╛ржкрзНржд, ржЕрж╕ржирзНрждрзБрж╖рзНржЯ, ржорзБржЦ
ЁЯШо => ЁЯШо, ржорзЗрж▓рж╛ ржорзБржЦ рж╕рж╣ ржорзБржЦржоржгрзНржбрж▓, ржорзЗрж▓рж╛ ржорзБржЦ, ржорзБржЦ, ржорзБржЦржоржгрзНржбрж▓
ЁЯШп => ЁЯШп, ржмрж┐рж╕рзНржорж┐ржд ржорзБржЦ, рж╕рзНрждржорзНржнрж┐ржд, ржЖржЪрз░рж┐ржд, ржорзБржЦ
ЁЯШк => ЁЯШк, рждржирзНржжрзНрз░рж╛ржоржЧрзНржи, рждржирзНржжрзНрз░рж╛ржоржЧрзНржи ржорзБржЦ, ржорзБржЦ
ЁЯШл => ЁЯШл, ржнрж╛ржЧрз░рзБрз▒рж╛, ржнрж╛ржЧрз░рзБрз▒рж╛ ржорзБржЦ, ржорзБржЦ
ЁЯШ┤ => ЁЯШ┤, ржЯрзЛржкржирж┐ ржпрзЛрз▒рж╛, ржЯрзЛржкржирж┐ ржпрзЛрз▒рж╛ ржорзБржЦ, ржорзБржЦ
ЁЯШМ => ЁЯШМ, рж╕ржХрж╛рж╣ ржкрзЛрз▒рж╛ ржорзБржЦ, рж╕ржХрж╛рж╣
ЁЯШЫ => ЁЯШЫ, ржЬрж┐ржнрж╛ ржЙрж▓рж┐ржУрз▒рж╛, ржЬрж┐ржнрж╛ ржмрж╛рж╣рж┐рз░рж▓рзИ ржЙрж▓рж┐ржУрз▒рж╛, ржЬрж┐ржнрж╛ ржУрж▓рж╛ржЗ ржержХрж╛ ржорзБржЦ
ЁЯШЬ => ЁЯШЬ, ржЬрж┐ржнрж╛ ржЙрж▓рж┐ржУрз▒рж╛, ржЬрзЛржХрзЛрз▒рж╛, ржЪржХрзБ ржЯрж┐ржкрж┐рзЯрж╛ржЗ ржЬрж┐ржнрж╛ ржмрж╛рж╣рж┐рз░рж▓рзИ ржЙрж▓рж┐ржУрз▒рж╛, ржХрзМрждрзБржХ
ЁЯШЭ => ЁЯШЭ, ржШрзГржгрж╛, ржмржирзНржзрзБ ржЪржХрзБрз░рзЗ ржЬрж┐ржнрж╛ ржЙрж▓рж┐ржУрз▒рж╛, ржнрзЯрж╛ржиржХ, ржЬрж┐ржнрж╛ ржЙрж▓рж┐ржУрз▒рж╛, ржЪржХрзБ ржмржирзНржз, ржорзБржЦ
ЁЯШТ => ЁЯШТ, ржЕрж╕ржирзНрждрзБрж╖рзНржЯ, ржЕрж╕ржирзНрждрзБрж╖рзНржЯ ржорзБржЦ, ржмрж┐рз░ржХрзНржд, ржорзБржЦ
ЁЯШУ => ЁЯШУ, ржарж╛ржгрзНржбрж╛ ржШрж╛ржо, ржарж╛ржгрзНржбрж╛ ржШрж╛ржо рж╕рж╣ ржорзБржЦ, ржорзБржЦ
ЁЯШФ => ЁЯШФ, ржЪрж┐ржирзНрждрж╛ржоржЧрзНржи ржорзБржЦ, ржЪрж┐ржирзНрждрж╛ржоржЧрзНржи, ржмрж┐рж╖ржирзНржи, ржорзБржЦ
ЁЯШХ => ЁЯШХ, ржмрж┐ржнрзНрз░рж╛ржирзНржд ржорзБржЦ, ржмрж┐ржнрзНрз░рж╛ржирзНржд, ржорзБржЦ
ЁЯШЦ => ЁЯШЦ, ржХрж┐ржВржХрж░рзНрждржмрзНржпржмрж┐ржорзВржврж╝ ржорзБржЦ, ржХрж┐ржВржХрж░рзНрждржмрзНржпржмрж┐ржорзВрзЭ, ржорзБржЦ
ЁЯШ╖ => ЁЯШ╖, ржорж╛рж╕рзНржХ рж╕рж╣ ржорзБржЦ, рж╢рзАржд, ржмрждрз░рз░ рждрж▓ржд, ржорзЗржбрж┐ржХрзЗрж▓ ржорж╛рж╕рзНржХ, ржорж╛рж╕рзНржХ, ржорзБржЦ
ЁЯШ▓ => ЁЯШ▓, рж╣рждржмрж╛ржХ рж╣рзЛрз▒рж╛ ржорзБржЦ, рж╣рждржмрж╛ржХ, ржПржХрзЗржмрж╛рз░рзЗ рж╕рзНрждржорзНржнрж┐ржд, рж╕рзНрждржорзНржнрж┐ржд, ржорзБржЦ
ЁЯШЮ => ЁЯШЮ, ржЕрж╕ржирзНрждрзБрж╖рзНржЯ, ржЕрж╕ржирзНрждрзБрж╖рзНржЯ ржорзБржЦ, ржорзБржЦ
ЁЯШЯ => ЁЯШЯ, ржЪрж┐ржирзНрждрж┐ржд, ржЪрж┐ржирзНрждрж┐ржд ржорзБржЦ, ржорзБржЦ
ЁЯШд => ЁЯШд, ржмрж┐ржЬрзЯрз░ ржнрж╛рз▒, ржоржЗ ржЬрж┐ржХрж┐рж▓рзЛржБ ржорзБржЦ, ржоржЗ ржЬрж┐ржХрж┐рж▓рзЛржБ, ржмрж┐ржЬрзЯ, ржорзБржЦ
ЁЯШв => ЁЯШв, ржХржирзНржжрж╛, ржХржирзНржжрж╛ ржорзБржЦ, ржжрзБржЦ, ржЪржХрзБрж▓рзЛ, ржорзБржЦ
ЁЯШн => ЁЯШн, ржЬрзЛрз░ржХрзИ ржХржирзНржжрж╛, ржЪржХрзБрж▓рзЛ, ржХржирзНржзрж╛, ржХрж╛ржирзНржжрзЛржи, ржорзБржЦ
ЁЯШж => ЁЯШж, ржнрзНрз░рзВржХрзБржЯрж┐рз░ ржорзБржЦ, ржнрзНрз░рзВржХрзБржЯрж┐ рж╕рж╣ ржорзЗрж▓рж╛ ржорзБржЦ, ржорзЗрж▓рж╛ ржорзБржЦ, ржнрзНрз░рзВржХрзБржЯрж┐, ржорзБржЦ
ЁЯШз => ЁЯШз, рж╢рзЛржХрж╛ржХрзБрж▓, рж╢рзЛржХрж╛ржХрзБрж▓ ржорзБржЦ, ржжрзБржЦ ржнрзЛржЧрж╛, ржорзБржЦ
ЁЯШи => ЁЯШи, ржнрзЯрж╛рждрзБрз░, ржЖрждржЩрзНржХрж┐ржд, ржЖрждржЩрзНржХрж┐ржд ржорзБржЦ, ржорзБржЦ
ЁЯШй => ЁЯШй, ржХрзНрж▓рж╛ржирзНржд, ржнрж╛ржЧрз░рзБрз▒рж╛, ржХрзНрж▓рж╛ржирзНржд ржорзБржЦ, ржорзБржЦ
ЁЯШм => ЁЯШм, ржнрзЗржЩрзБржЪрж╛рж▓рж┐, ржорзБржЦ ржнрзЗржЩрзБржЪрж╛рж▓рж┐, ржнрзЗржЩрзБржЪрзЛрз▒рж╛, ржорзБржЦ
ЁЯШ░ => ЁЯШ░, ржЦрз░ржзрз░ ржХрз░рж╛ ржорзБржЦ, ржарж╛ржгрзНржбрж╛ ржШрж╛ржо рж╕рж╣ ржирзАрж▓рж╛ ржорзБржЦ, ржорзЗрж▓рж╛ ржорзБржЦ, ржарж╛ржгрзНржбрж╛ ржШрж╛ржо, ржорзБржЦ
ЁЯШ▒ => ЁЯШ▒, ржнрзЯрж╛рждрзБрз░ ржорзБржЦ, ржнрзЯржд ржЪрж┐ржЮрз░рж╛, ржнрзЯржд ржЪрж┐ржЮрз░рж╛ ржорзБржЦ, ржнрзЯ, ржнрзЯрж╛рждрзБрз░, ржЖрждржЩрзНржХрж┐ржд, ржорзБржЦ
ЁЯШ│ => ЁЯШ│, рз░ржЩрж╛ ржкрз░рж╛, рз░ржЩрж╛ ржкрз░рж╛ ржорзБржЦ, рж╣рждржмрзБржжрзНржзрж┐ржд ржкрз░рж╛, рж╣рждржмрзБржжрзНржзрж┐ржд ржкрз░рж╛ ржорзБржЦ
ЁЯШ╡ => ЁЯШ╡, ржмрж┐рж╣рзНржмрж▓, ржмрж┐рж╣рзНржмрж▓ рж╣рзЛрз▒рж╛ ржорзБржЦ, ржорзБржЦ
ЁЯШб => ЁЯШб, ржорзБржЦ ржУржлржирзНржжрзЛрз▒рж╛, ржЦржЩрж╛рж▓, ржХрзНрж╖рзБржмрзНржз, рз░ржЩрж╛ ржУржлржирзНржжрзЛрз▒рж╛ ржорзБржЦ, рз░ржЩрж╛ ржкрз░рж╛ ржорзБржЦ, ржорзБржЦ
ЁЯШа => ЁЯШа, ржЦржВ, ржЦржЩрж╛рж▓ ржорзБржЦ, ржорзБржЦ
ЁЯШИ => ЁЯШИ, рж╢рж┐ржВ рж╕рж╣ ржорж┐ржЪрж┐ржХрж┐рзЯрж╛ рж╣рж╛ржБрж╣рж┐, ржорж┐ржЪрж┐ржХрж┐рзЯрж╛ рж╣рж╛ржБрж╣рж┐, рж╢рж┐ржВ
ЁЯС┐ => ЁЯС┐, ржЗржорзНржк, рж╕рз░рзБ ржнрзВржд, рз░рж╛ржХрзНрж╖рж╕, ржорзБржЦ
ЁЯС╣ => ЁЯС╣, рз░рж╛ржХрзНрж╖рж╕, ржнрзВржд, ржЬрж╛ржкрж╛ржирзА рз░рж╛ржХрзНрж╖рж╕, ржорзБржЦ
ЁЯС║ => ЁЯС║, ржкрж┐рж╢рж╛ржЪ, ржнрзВржд, ржЬрж╛ржкрж╛ржирзА ржкрж┐рж╢рж╛ржЪ, ржорзБржЦ
ЁЯТА => ЁЯТА, ржХржВржХрж╛рж▓, рж╕рж╛ржзрзБ ржХржерж╛, ржорзБржЦ
ЁЯС╗ => ЁЯС╗, ржнрзВржд, рж╕рж╛ржзрзБ ржХржерж╛рз░ ржнрзВржд, ржорзБржЦ
ЁЯС╜ => ЁЯС╜, ржПрж▓рж┐рзЯрзЗржи, ржмрз░рзНрж╣рж┐ржЧрзНрз░рж╣рз░ ржкрзНрз░рж╛ржгрзА, UFO, ржорзБржЦ
ЁЯС╛ => ЁЯС╛, ржПрж▓рж┐рзЯрзЗржи ржо'ржирж╖рзНржЯрж╛рз░, ржо'ржирж╖рзНржЯрж╛рз░, UFO, рж╕рж╛ржзрзБ ржХржерж╛, ржорзБржЦ
ЁЯТй => ЁЯТй, ржорж▓, рж╢рзМржЪ
ЁЯШ║ => ЁЯШ║, рж╣рж╛ржБрж╣рж┐ ржержХрж╛ ржорзЗржХрзБрз░рзА ржорзБржЦ, ржорзЗрж▓рж╛ ржорзБржЦ рж╕рж╣ ржорзЗржХрзБрз░рзАрз░ ржорзБржЦржоржгрзНржбрж▓, ржорзЗржХрзБрз░рзАрз░ ржорзБржЦ, ржорзЗрж▓рж╛ ржорзБржЦ, ржорзЗржХрзБрз░рзА, ржорзБржЦ
ЁЯШ╕ => ЁЯШ╕, ржорж┐ржЪрж┐ржХрж┐рзЯрж╛ржЗ ржержХрж╛ ржорзЗржХрзБрз░рзАрз░ ржорзБржЦ, ржорж┐ржЪрж┐ржХрж┐рзЯрж╛, ржорж┐ржЪрж┐ржХрж┐рзЯрж╛ржЗ ржержХрж╛ ржорзБржЦ ржЖрз░рзБ ржЪржХрзБ рж╕рж╣ ржорзЗржХрзБрз░рзА, ржорзЗржХрзБрз░рзАрз░ ржорзБржЦ, ржорзЗржХрзБрз░рзА
ЁЯШ╣ => ЁЯШ╣, ржЖржиржирзНржжрз░ ржЪржХрзБрж▓рзЛ, ржорзЗржХрзБрз░рзАрз░ ржорзБржЦ, ржЖржиржирзНржжрз░ ржЪржХрзБрж▓рзЛ рж╕рж╣ ржорзЗржХрзБрз░рзАрз░ ржорзБржЦ, ржорзЗржХрзБрз░рзА
ЁЯШ╗ => ЁЯШ╗, рж╣рж╛ржБрж╣рж┐ ржержХрж╛ ржорзЗржХрзБрз░рзА ржорзБржЦ, рж╣рзГржжрзЯ ржЖржХрзГрждрж┐рз░ ржЪржХрзБ рж╕рж╣ рж╣рж╛ржБрж╣рж┐ ржержХрж╛ ржорзЗржХрзБрз░рзАрз░ ржорзБржЦржоржгрзНржбрж▓, ржкрзНрз░рзЗржо, рж╣рзГржжрзЯ, ржорзЗржХрзБрз░рзАрз░ ржорзБржЦ, ржорзЗржХрзБрз░рзА, ржорзБржЦ
ЁЯШ╝ => ЁЯШ╝, ржмрж┐ржХрзГржд ржорзЗржХрзБрз░рзАрз░ ржорзБржЦ, ржмрж┐ржХрзГржд, ржмрж┐ржжрзНрж░рзВржкрж╛рждрзНржоржХ рж╣рж╛ржБрж╣рж┐, ржорзЗржХрзБрз░рзАрз░ ржорзБржЦ, ржорзЗржХрзБрз░рзА, ржорзБржЦ
ЁЯШ╜ => ЁЯШ╜, ржЪрзБржорж╛ ржжрж┐ ржержХрж╛ ржорзЗржХрзБрз░рзА, ржЪржХрзБ ржмржирзНржз, ржЪрзБржорж╛ ржжрж┐ ржержХрж╛, ржЪрзБржорзНржмржи, ржЪржХрзБ, ржорзЗржХрзБрз░рзА, ржорзБржЦ
ЁЯЩА => ЁЯЩА, ржХрзНрж▓рж╛ржирзНржд ржорзЗржХрзБрз░рзАрз░ ржорзБржЦ, рж╣рзЗ ржнржЧрз▒рж╛ржи, рж╕ржБржЪрж╛ржХрзИрзЯрзЗ ржЖржЪрз░рж┐ржд, ржорзЗржХрзБрз░рзА, ржорзБржЦ
ЁЯШ┐ => ЁЯШ┐, ржХржирзНржжрж╛ ржорзЗржХрзБрз░рзАрз░ ржорзБржЦ, ржХржирзНржзрж╛, ржХрж╛ржирзНржжрзЛржи, ржорзЗржХрзБрз░рзАрз░ ржорзБржЦ, ржорзЗржХрзБрз░рзА, ржорзБржЦ
ЁЯШ╛ => ЁЯШ╛, ржорзБржЦ ржУржлржирзНржжрзЛрз▒рж╛ ржорзЗржХрзБрз░рзА ржорзБржЦ, ржорзБржЦ ржУржлржирзНржжрзЛрз▒рж╛, ржорзЗржХрзБрз░рзАрз░ ржорзБржЦ, ржорзЗржХрзБрз░рзА, ржорзБржЦ
ЁЯЩИ => ЁЯЩИ, ржмрзЗрзЯрж╛ ржирж╛ржЪрж╛ржм, ржмрзЗрзЯрж╛ ржирж╛ржЪрж╛ржм ржмрж╛ржирзНржжрз░, ржмрж╛ржирзНржжрз░
ЁЯЩЙ => ЁЯЩЙ, ржмрзЗрзЯрж╛ ржирзБрж╢рзБржирж┐ржм, ржмрзЗрзЯрж╛ ржирзБрж╢рзБржирж┐ржм ржмрж╛ржирзНржжрз░, ржмрж╛ржирзНржжрз░
ЁЯЩК => ЁЯЩК, ржмрзЗрзЯрж╛ ржиржХтАЩржм, ржмрзЗрзЯрж╛ ржиржХтАЩржм ржмрж╛ржирзНржжрз░, ржмрж╛ржирзНржжрз░
ЁЯСж => ЁЯСж, рж▓'рз░рж╛, ржорж╛ржирзБрж╣
ЁЯСз => ЁЯСз, ржЫрзЛрз▒рж╛рж▓рзА, ржорж╛ржирзБрж╣
ЁЯСи => ЁЯСи, ржкрзБрз░рзБрж╖, ржмрзНржпржХрзНрждрж┐
ЁЯСй => ЁЯСй, ржорж╣рж┐рж▓рж╛, ржмрзНржпржХрзНрждрж┐
ЁЯС┤ => ЁЯС┤, ржмрзГржжрзНржз ржорж╛ржирзБрж╣, ржкрзБрз░рзБрж╖
ЁЯС╡ => ЁЯС╡, ржмрзГржжрзНржзрж╛ ржорж╣рж┐рж▓рж╛, ржорж╣рж┐рж▓рж╛
ЁЯС╢ => ЁЯС╢, рж╢рж┐рж╢рзБ, ржХрзЗржЪрзБрз▒рж╛, ржорж╛ржирзБрж╣
ЁЯС▒ => ЁЯС▒, рж╕рзЛржгрж╛рж▓рзА ржЪрзБрж▓рж┐рз░рзЗ ржЫрзЛрз▒рж╛рж▓рзА, рж╕рзЛржгрж╛рж▓рзА ржЪрзБрж▓рж┐, ржЫрзЛрз▒рж╛рж▓рзА
ЁЯСо => ЁЯСо, ржкрзБрж▓рж┐ржЪ, ржкрзБрж▓рж┐ржЪ ржмрж┐рж╖рзЯрж╛, ржЖрз░ржХрзНрж╖рзА
ЁЯС▓ => ЁЯС▓, ржорж╛ржирзБрж╣, ржорзЛржЪрз░ рж╕рзИрждрзЗ ржмрзНржпржХрзНрждрж┐, ржЧрзБрз▒рж╛ ржкрж┐ ржорзЛ
ЁЯС│ => ЁЯС│, ржкрж╛ржЧрзБрз░рж┐ ржержХрж╛ ржкрзБрз░рзБрж╖, ржкрж╛ржЧрзБрз░рж┐, ржорж╛ржирзБрж╣
ЁЯС╖ => ЁЯС╖, рж╢рзНрз░ржорж┐ржХ, ржирж┐рз░рзНржорж╛ржг рж╢рзНрз░ржорж┐ржХ
ЁЯС╕ => ЁЯС╕, рз░рж╛ржгрзА, рж╕рж╛ржзрзБ ржХржерж╛рз░ рз░рж╛ржгрзА
ЁЯТВ => ЁЯТВ, ржЧрж╛рз░рзНржбржорзЗржи, ржкрзНрз░рж╣рз░рзА, ржмрзНржпржХрзНрждрж┐
ЁЯОЕ => ЁЯОЕ, ржЪрж╛ржирзНрждрж╛, ржЪрж╛ржирзНрждрж╛ ржХрзНрж▓'ржЬ, ржЦрзНрз░рзАрж╖рзНржЯржорж╛ржЪ, ржмрз░ржжрж┐ржи, ржЙржжржпрж╛ржкржи
ЁЯС╝ => ЁЯС╝, рж╢рж┐рж╢рзБ ржжрзЗрз▒ржжрзВржд, ржжрзЗрз▒ржжрзВржд, рж╕рж╛ржзрзБ ржХржерж╛
ЁЯТЖ => ЁЯТЖ, ржорзБржЦрз░ ржорж╛рж▓рж┐ржЪ, ржорж╛рж▓рж┐ржЪ, ржЪрзЗрж▓рзБржи
ЁЯТЗ => ЁЯТЗ, ржЪрзБрж▓рж┐ ржХржЯрж╛, ржмрж┐ржЙржЯрж┐ ржкрж╛рз░рзНрж▓рж╛рз░, ржкрж╛рз░рзНрж▓рж╛рз░
ЁЯС░ => ЁЯС░, ржХржЗржирж╛, ржУрз░ржирж┐рз░ рж╕рзИрждрзЗ ржХржЗржирж╛, ржмрж┐ржмрж╛рж╣
ЁЯЩН => ЁЯЩН, ржнрзНрз░рзВржХрзБржЯрж┐, ржнрзНрз░рзВржХрзБржЯрж┐ ржорз░рж╛ ржмрзНржпржХрзНрждрж┐, ржмрзНржпржХрзНрждрж┐, ржнржЩрзНржЧрзА
ЁЯЩО => ЁЯЩО, ржорзБржЦ ржУржлржирзНржжрзЛрз▒рж╛, ржорзБржЦ ржУржлржирзНржжрзЛрз▒рж╛ ржмрзНржпржХрзНрждрж┐, ржмрзНржпржХрзНрждрж┐, ржнржЩрзНржЧрзА
ЁЯЩЕ => ЁЯЩЕ, ржнрж╛рж▓ ржирж╣рзЯ ржнржЩрзНржЧрзА, ржнрж╛рж▓ ржирж╣рзЯ, ржирж╣рзЯ, ржирж┐рж╖рж┐ржжрзНржз, ржнржЩрзНржЧрзА, ржорзБржЦ
ЁЯЩЖ => ЁЯЩЖ, ржарж┐ржХ ржнржЩрзНржЧрзА, ржарж┐ржХ ржЖржЫрзЗ, ржнржЩрзНржЧрзА, ржорзБржЦ
ЁЯТБ => ЁЯТБ, рждржерзНржп ржХрзЗржирзНржжрзНрз░, рж╕рж╣рж╛рзЯ, рждржерзНржп, ржмрзНржпржХрзНрждрж┐
ЁЯЩЛ => ЁЯЩЛ, рж╕рзБржЦрзА ржмрзНржпржХрзНрждрж┐, рж╣рж╛ржд ржжржЩрж╛, рж╣рж╛ржд ржжржЩрж╛ ржмрзНржпржХрзНрждрж┐, рж╕рзБржЦрзА, ржмрзНржпржХрзНрждрж┐, ржнржЩрзНржЧрзА
ЁЯЩЗ => ЁЯЩЗ, ржоржЗ ржжрзБржГржЦрзАржд, ржЧржнрзАрз░ ржорзБрз░ ржжрзБржкрж┐ржУрз▒рж╛, ржжрзБржГржЦрзАржд, ржорзБрз░ ржжрзБржкрж┐ржУрз▒рж╛, ржнржЩрзНржЧрзА, ржмрзНржпржХрзНрждрж┐
ЁЯЩМ => ЁЯЩМ, рж╣рзБрз░рзЗ, ржЖржиржирзНржжржд ржжрзБрзЯрзЛржЦржи рж╣рж╛ржд ржжржЩрж╛, ржжрзБрзЯрзЛ рж╣рж╛ржд, ржЖржиржирзНржж ржЙржжржпрж╛ржкржи
ЁЯЩП => ЁЯЩП, рж╣рж╛рждржпрзЛрз░ ржХрз░рж╛, ржкрзНрз░рж╛рз░рзНржержирж╛, ржкрзНрз░рж╛рз░рзНржержирж╛ ржХрз░рж╛, рж╣рж╛ржд, ржнржЩрзНржЧрзА
ЁЯСд => ЁЯСд, ржкрж╛рз░рзНрж╢рзНржм ржорзВрз░рзНрждрж┐, ржЖржмржХрзНрж╖ ржорзВрж░рзНрждрж┐, ржорж╛ржирзБрж╣
ЁЯСе => ЁЯСе, ржкрж╛рз░рзНрж╢рзНржм ржорзВрз░рзНрждрж┐, ржЖржмржХрзНрж╖ ржорзВрж░рзНрждрж┐, ржорж╛ржирзБрж╣
ЁЯЪ╢ => ЁЯЪ╢, ржкржержЪрж╛рз░рзА, ржЦрзЛржЬ ржХрзЭрж╛
ЁЯПГ => ЁЯПГ, ржжрзМрз░ржмрж┐ржж, ржжрзМрз░рж╛, ржорж╛рз░рж╛ржержи, ржЦрзЗрж▓
ЁЯСп => ЁЯСп, ржорзБрз░ржд ржлрж┐ржЯрж╛ ржорз░рж╛ ржЫрзЛрз▒рж╛рж▓рзА, ржЫрзЛрз▒рж╛рж▓рзА
ЁЯТГ => ЁЯТГ, ржирз░рзНрждржХрзА, ржирзГрждрзНржп, ржорж╛ржирзБрж╣
ЁЯТП => ЁЯТП, ржХрж┐ржЪ, ржЪрзБржорж╛, ржЪрзБржорзНржмржи, рз░рзЛржорж╛ржЮрзНржЪ
ЁЯТС => ЁЯТС, ржжржорзНржкрждрзНрждрзА, рз░рзЛржорж╛ржЮрзНржЪ, рж╣рзГржжрзЯ ржЪрж┐ржирз░ рж╕рзИрждрзЗ ржжржорзНржкрждрзНрждрзА, ржкрзНрз░рзЗржо
ЁЯСк => ЁЯСк, ржкрз░рж┐рзЯрж╛рж▓, ржорж╛ржХ, ржжрзЗржЙрждрж╛ржХ, рж▓'рз░рж╛-ржЫрзЛрз▒рж╛рж▓рзА
ЁЯСл => ЁЯСл, ржорж╣рж┐рж▓рж╛ ржЖрз░рзБ ржкрзБрз░рзБрж╖, ржжржорзНржкрждрзА, ржмрзНржпржХрзНрждрж┐, рж╣рж╛рждрзЗ рж╣рж╛ржд ржзрз░рж┐ ржержХрж╛ ржорж╣рж┐рж▓рж╛ ржЖрз░рзБ ржкрзБрз░рзБрж╖
ЁЯСм => ЁЯСм, ржжрзБржЬржи ржкрзБрз░рзБрж╖, рж╣рж╛рждрзЗ рж╣рж╛ржд ржзрз░рж┐ ржержХрж╛ ржжрзБржЬржи ржкрзБрз░рзБрж╖, ржмрзНржпржХрзНрждрж┐
ЁЯСн => ЁЯСн, ржжрзБржЧрз░рж╛ржХрзА ржорж╣рж┐рж▓рж╛, рж╣рж╛рждрзЗ рж╣рж╛ржд ржзрз░рж┐ ржержХрж╛ ржжрзБржЧрз░рж╛ржХрзА ржорж╣рж┐рж▓рж╛
ЁЯТк => ЁЯТк, ржмрж╛рж╣рзБ, ржорж╛ржВрж╕ржкрзЗрж╢рзА, ржмрж▓ржмрж╛ржи, ржмрж╛рж╣рзБржмрж▓
ЁЯСИ => ЁЯСИ, ржмрж╛ржБржУ ржорзБржЦрзАрзЯрж╛ ржЖржЩрзБрж▓рж┐, рждрз░рзНржЬржирзА ржЖржЩрзБрж▓рж┐, ржЖржЩрзБрж▓рж┐
ЁЯСЙ => ЁЯСЙ, рж╕рзЛржБ ржорзБржЦрзАрзЯрж╛ ржЖржЩрзБрж▓рж┐, рждрз░рзНржЬржирзА ржЖржЩрзБрж▓рж┐, ржЖржЩрзБрж▓рж┐
ЁЯСЖ => ЁЯСЖ, ржЖржЩрзБрж▓рж┐, рждрз░рзНржЬржирзА ржЖржЩрзБрж▓рж┐, ржУржкрз░ ржорзБржЦрзАрзЯрж╛ ржЖржЩрзБрж▓рж┐
ЁЯСЗ => ЁЯСЗ, рждрж▓ ржорзБржЦрзАрзЯрж╛ ржЖржЩрзБрж▓рж┐, рждрз░рзНржЬржирзА ржЖржЩрзБрж▓рж┐, ржЖржЩрзБрж▓рж┐
тЬМ => тЬМ, ржХрзЗржБржЪрж┐, ржмрж┐ржЬрзЯрз░ рж╣рж╛рждрз░ ржЪрж┐рж╣рзНржи, ржмрж┐ржЬрзЯ, рж╣рзЯ
тЬЛ => тЬЛ, ржХрж╛ржЧрж╛ржЬ, ржжржЩрж╛ рж╣рж╛ржд
ЁЯСМ => ЁЯСМ, ржЕ'ржХрзЗ ржЪрж┐ржи, ржЕ'ржХрзЗ рж╣рж╛рждрз░ ржЪрж┐ржи, рж╣рж╛ржд
ЁЯСН => ЁЯСН, ржерж╛ржорзНржмржЪ ржЖржк, ржУржкрз░ ржорзБржЦрзАрзЯрж╛ ржмрзБрзЭрж╛ ржЖржЩрзБрж▓рж┐, ржмрзБрзЭрж╛ ржЖржЩрзБрж▓рж┐
ЁЯСО => ЁЯСО, ржерж╛ржорзНржмржЪ ржбрж╛ржЙржи, рждрж▓ ржорзБржЦрзАрзЯрж╛ ржмрзБрзЭрж╛ ржЖржЩрзБрж▓рж┐, ржмрзБрзЭрж╛ ржЖржЩрзБрж▓рж┐
тЬК => тЬК, рж╢рж┐рж▓, ржУржкрз░ржорзБрз▒рж╛ рж╣рж╛рждрз░ ржорзБржарж┐
ЁЯСК => ЁЯСК, ржШрзЛржЪрж╛, рж╣рж╛рждрз░ ржорзБржарж┐, рж╣рж╛ржд
ЁЯСЛ => ЁЯСЛ, рж╣рж╛ржд, рж╣рж╛ржд ржЬрзЛржХрз░рж╛, ржорзЗрж▓рж╛ рж╣рж╛ржд
ЁЯСП => ЁЯСП, рж╣рж╛ржд рждрж╛рж▓рж┐, рж╣рж╛ржд ржЪрж╛ржкрз░рж┐, рж╣рж╛ржд, рж╣рж╛рждрз░ ржЪрж┐ржи
ЁЯСР => ЁЯСР, ржЦрзЛрж▓рж╛ рж╣рж╛ржд, рж╣рж╛ржд, ржЦрзЛрж▓рж╛ рж╣рж╛рждрз░ ржЪрж┐ржи
ЁЯТЕ => ЁЯТЕ, ржиржЦрз░ ржпрждржи, ржиржЦ, ржорзЗржирж┐ржХрж┐ржЙрз░, ржирзЗржЗрж▓ ржкрж▓рж┐ржЪ, ржХржЪржорзЗржЯрж┐ржХ, ржкрзНрз░рж╕рж╛ржзржи
ЁЯСВ => ЁЯСВ, ржХрж╛ржг, рж╢рз░рзАрз░
ЁЯСГ => ЁЯСГ, ржирж╛ржХ, ржорзБржЦ, рж╢рз░рзАрз░
ЁЯСг => ЁЯСг, ржнрз░рж┐рз░ ржЪрж┐ржи, ржнрз░рж┐рз░ ржкржЯрж╛, рж╢рз░рзАрз░
ЁЯСА => ЁЯСА, ржЪржХрзБрж╣рж╛рж▓рж┐, ржЪржХрзБ, ржорзБржЦ
ЁЯСЕ => ЁЯСЕ, ржЬрж┐ржнрж╛, ржорзБржЦ, рж╢рз░рзАрз░
ЁЯСД => ЁЯСД, ржорзБржЦ, ржУржа, рж╢рз░рзАрз░
ЁЯТЛ => ЁЯТЛ, ржЪрзБржорзНржмржирз░ ржЪрж┐рж╣рзНржи, ржУржБржа, ржЪрзБржорж╛, рз░рзЛржорж╛ржЮрзНржЪ
ЁЯТШ => ЁЯТШ, рж╣рзГржжрзЯ ржЖрз░рзБ ржХрж╛ржБрзЬ, рж╣рзГржжрзЯ, ржХрж╛рзЬ ржержХрж╛ рж╣рзГржжрзЯ, ржкрзНрз░рзЗржо
ЁЯТУ => ЁЯТУ, ржзржкржзржкржирж┐ ржХрз░рж╛ рж╣рзГржжрзЯ, рж╣рзГржжрзЯ, рж╕рзНржкржирзНржжржи, ржкрзНрз░рзЗржо, ржЖржмрзЗржЧ
ЁЯТФ => ЁЯТФ, ржнржЧрзНржи рж╣рзГржжрзЯ, рж╣рзГржжрзЯ, ржнржЧрзНржи, ржЖржмрзЗржЧ
ЁЯТХ => ЁЯТХ, ржжрзБржЦржи рж╣рзГржжрзЯ, ржкрзНрз░рзЗржорж┐ржХ, ржкрзНрз░рзЗржо, ржЖржмрзЗржЧ
ЁЯТЦ => ЁЯТЦ, ржЬрж┐рж▓рж┐ржХрж┐ ржержХрж╛ рж╣рзГржжрзЯ, ржЙрждрзНрждрзЗржЬрж┐ржд, ржкрзНрз░рзЗржо, ржЖржмрзЗржЧ
ЁЯТЧ => ЁЯТЧ, ржмрж╛рзЭрж┐ ржЕрж╣рж╛ рж╣рзГржжрзЯ, ржЙрждрзНрждрзЗржЬрж┐ржд, рж╣рзГржжрзЯ, ржкрзНрз░рзЗржо, ржЖржмрзЗржЧ
ЁЯТЩ => ЁЯТЩ, ржирзАрж▓рж╛ рж╣рзГржжрзЯ, ржирзАрж▓рж╛, рж╣рзГржжрзЯ, ржЖржмрзЗржЧ
ЁЯТЪ => ЁЯТЪ, рж╕рзЗржЙржЬрзАрзЯрж╛ рж╣рзГржжрзЯ, рж╣рзГржжрзЯ, ржЖржмрзЗржЧ
ЁЯТЫ => ЁЯТЫ, рж╣рж╛рж▓ржзрзАрзЯрж╛ рж╣рзГржжрзЯ, рж╣рзГржжрзЯ, ржЖржмрзЗржЧ
ЁЯТЬ => ЁЯТЬ, ржмрзЗржЩрзБржирзАрзЯрж╛ рж╣рзГржжрзЯ, ржмрзЗржЩрзБржирзАрзЯрж╛, рж╣рзГржжрзЯ, ржЖржмрзЗржЧ
ЁЯТЭ => ЁЯТЭ, рз░рж┐ржмржи рж╕рж╣ рж╣рзГржжрзЯ, рж╣рзГржжрзЯ, рз░рж┐ржмржи, ржнрзЗрж▓рзЗржгрзНржЯрж╛ржЗржи, ржЖржмрзЗржЧ
ЁЯТЮ => ЁЯТЮ, ржШрзБрз░рж┐ ржержХрж╛ рж╣рзГржжрзЯ, рж╣рзГржжрзЯ, ржкрзНрз░рзЗржо, ржЖржмрзЗржЧ
ЁЯТЯ => ЁЯТЯ, рж╕ржЬрзНржЬрж┐ржд рж╣рзГржжрзЯ, рж╣рзГржжрзЯ
ЁЯТМ => ЁЯТМ, ржкрзНрз░рзЗржо ржкрждрзНрз░, рж╣рзГржжрзЯрз░ ржЪрж┐рж╣рзНржи рж╕рж╣ ржЪрж┐ржарж┐, рж╣рзГржжрзЯ, рз░рзЛржорж╛ржЮрзНржЪ
ЁЯТд => ЁЯТд, ржирж┐ржжрзНрз░рж╛ржоржЧрзНржи, ржЯрзЛржкржирж┐, ржирж╛ржХрз░ ржШрзЛрз░рзНржШрзЛрз░ржгрж┐
ЁЯТв => ЁЯТв, ржЦржВ, ржЦржЩрз░ ржЪрж┐рж╣рзНржи, ржЖржмрзЗржЧ
ЁЯТг => ЁЯТг, ржмржорзНржм, ржЖржмрзЗржЧ
ЁЯТе => ЁЯТе, рж╕ржВржШрз░рзНрж╖, ржЖржмрзЗржЧ
ЁЯТж => ЁЯТж, ржШрж╛ржо ржЫрж┐ржЯрж┐ржХрж┐ ржкрз░рж╛, ржШрж╛ржо, ржШрж╛ржорзЛрз▒рж╛
ЁЯТи => ЁЯТи, ржЬрзЛрз░рзЗ ржжрзМрз░рж╛, ржжрзМрз░рж╛, ржЖржмрзЗржЧ
ЁЯТл => ЁЯТл, ржЖржЪржирзНржжрзНрз░рж╛ржЗ ржХрз░рж╛, рждрз░рж╛
ЁЯТм => ЁЯТм, ржмржХрзНрждржмрзНржп ржмрзЗрж▓рзБржи, ржмржХрзНрждржмрзНржп ржмрж╛ржмрж▓, ржЙржХрзНрждрж┐ ржмрзЗрж▓рзБржи, ржЙржХрзНрждрж┐ ржмрж╛ржмрж▓, ржЙржХрзНрждрж┐, ржХржорж┐ржХ
ЁЯТн => ЁЯТн, ржЪрж┐ржирзНрждрж╛ ржмрзЗрж▓рзБржи, ржЪрж┐ржирзНрждрж╛ ржмрж╛ржмрж▓, ржЪрж┐ржирзНрждрж╛, ржХржорж┐ржХ
ЁЯСУ => ЁЯСУ, ржЪржЪржорж╛, ржкрзЛржЪрж╛ржХ
ЁЯСФ => ЁЯСФ, ржирзЗржХржЯрж╛ржЗ, ржкрзЛржЪрж╛ржХ
ЁЯСХ => ЁЯСХ, ржЯрж┐-ржЪрж╛рз░рзНржЯ, ржкрзЛржЪрж╛ржХ
ЁЯСЦ => ЁЯСЦ, ржкрзЗржгрзНржЯ, ржЯрзНрз░рж╛ржЙржЬрж╛рз░, ржкрзЛржЪрж╛ржХ
ЁЯСЧ => ЁЯСЧ, ржбрзНрз░рзЗржЫ, ржорж╣рж┐рж▓рж╛рз░ ржкрзЛржЪрж╛ржХ
ЁЯСШ => ЁЯСШ, ржХрж┐ржорзЛржирзЛ, ржЬрж╛ржкрж╛ржирзА ржкрзЛржЪрж╛ржХ, ржкрзЛржЪрж╛ржХ
ЁЯСЩ => ЁЯСЩ, ржмрж┐ржХрж┐ржирж┐, рж╕рж╛ржБрждрзЛрз░рз░ ржкрзЛржЪрж╛ржХ, ржкрзЛржЪрж╛ржХ
ЁЯСЪ => ЁЯСЪ, ржорж╣рж┐рж▓рж╛рз░ ржкрзЛржЪрж╛ржХ, ржкрзЛржЪрж╛ржХ
ЁЯСЫ => ЁЯСЫ, ржкрж╛рз░рзНржЪ, ржзржи ржерзЛрз▒рж╛ ржорзЛржирж╛
ЁЯСЬ => ЁЯСЬ, рж╣рзЗржгрзНржбржмрзЗржЧ, рж╣рж╛рждржорзЛржирж╛
ЁЯСЭ => ЁЯСЭ, ржкрж╛ржЙржЪ, ржмрзЗржЧ, ржорзЛржирж╛, ржкрзЛржЪрж╛ржХ
ЁЯОТ => ЁЯОТ, рж╕рзНржХрзБрж▓ ржмрзЗржЧ, рж╕рзНржХрзБрж▓
ЁЯСЮ => ЁЯСЮ, ржкрзБрз░рзБрж╖рз░ ржЬрзЛрждрж╛, ржЬрзЛрждрж╛, ржкрзЛржЪрж╛ржХ
ЁЯСЯ => ЁЯСЯ, ржПржерж▓рзЗржЯрз░ ржЬрзЛрждрж╛, рж╕рзНржирзАржХрж╛рз░, ржЬрзЛрждрж╛, ржкрзЛржЪрж╛ржХ
ЁЯСа => ЁЯСа, рж╣рж╛ржЗ-рж╣рж┐рж▓, ржЬрзЛрждрж╛, ржкрзЛржЪрж╛ржХ
ЁЯСб => ЁЯСб, ржорж╣рж┐рж▓рж╛рз░ ржЪрзЗржгрзНржбрзЗрж▓, ржЪрзЗржгрзНржбрзЗрж▓, ржкрзЛржЪрж╛ржХ
ЁЯСв => ЁЯСв, ржорж╣рж┐рж▓рж╛рз░ ржмрзБржЯ, ржмрзБржЯ ржЬрзЛрждрж╛, ржкрзЛржЪрж╛ржХ
ЁЯСС => ЁЯСС, ржорзБржХрзБржЯ, ржкрзЛржЪрж╛ржХ
ЁЯСТ => ЁЯСТ, ржорж╣рж┐рж▓рж╛рз░ ржЯрзБржкрж┐, ржЯрзБржкрж┐, ржкрзЛржЪрж╛ржХ
ЁЯОй => ЁЯОй, ржЯржк рж╣рзЗржЯ, рж╣рзЗржЯ
ЁЯОУ => ЁЯОУ, ржЧрзНрз░рзЗржбрзБрз▒рзЗрж╢рзНржмржи ржХрзЗржк, ржХрзЗржк, ржЯрзБржкрж┐, ржЙржжржпрж╛ржкржи
ЁЯТД => ЁЯТД, рж▓рж┐ржкрж╖рзНржЯрж┐ржХ, ржорзЗржХржЖржк, ржХржЪржорзЗржЯрж┐ржХ, ржкрзНрз░рж╕рж╛ржзржи
ЁЯТН => ЁЯТН, ржЖржЩрзБржарж┐, рз░рзЛржорж╛ржЮрзНржЪ
ЁЯТО => ЁЯТО, ржоржгрж┐, ржоржгрж┐ ржкрж╛ржерз░, рж╣рзАрз░рж╛, рз░рзЛржорж╛ржЮрзНржЪ
ЁЯР╡ => ЁЯР╡, ржмрж╛ржирзНржжрз░рз░ ржорзБржЦ, ржмрж╛ржирзНржжрз░, ржорзБржЦ, ржЬрзАрз▒
ЁЯРТ => ЁЯРТ, ржмрж╛ржирзНржжрз░, ржЬржирзНрждрзБ
ЁЯР╢ => ЁЯР╢, ржХрзБржХрзБрз░рз░ ржорзБржЦ, ржХрзБржХрзБрз░, ржорзБржЦ, ржЬрзАрз▒
ЁЯРХ => ЁЯРХ, ржХрзБржХрзБрз░, ржХрзБржХрзБрз░рз░ ржкрзЛрз▒рж╛рж▓рзА
ЁЯРй => ЁЯРй, ржХрзЗржХрзЛрз░рж╛ ржирзЛржорз░ ржХрзБржХрзБрз░, ржХрзБржХрзБрз░, ржЬрзАрз▒
ЁЯР║ => ЁЯР║, ржХрзБржХрзБрз░ржирзЗржЪрзАрзЯрж╛ ржмрж╛ржШрз░ ржорзБржЦ, ржХрзБржХрзБрз░ржирзЗржЪрзАрзЯрж╛ ржмрж╛ржШ, ржорзБржЦ, ржЬрзАрз▒
ЁЯР▒ => ЁЯР▒, ржорзЗржХрзБрз░рзАрз░ ржорзБржЦ, ржорзЗржХрзБрз░рзА, ржорзБржЦ, ржЬрзАрз▒
ЁЯРИ => ЁЯРИ, ржорзЗржХрзБрз░рж┐, ржЬржирзНрждрзБ
ЁЯРп => ЁЯРп, ржмрж╛ржШрз░ ржорзБржЦ, ржмрж╛ржШ, ржЬрзАрз▒
ЁЯРЕ => ЁЯРЕ, ржмрж╛ржШ, ржЬржирзНрждрзБ
ЁЯРЖ => ЁЯРЖ, ржирж╛рж╣рз░ржлрзБржЯрзБржХрзА ржмрж╛ржШ, ржЬржирзНрждрзБ
ЁЯР┤ => ЁЯР┤, ржШрзЛржБрз░рж╛рз░ ржорзБржЦ, ржШрзЛржБрз░рж╛, ржорзБржЦ, ржЬрзАрз▒
ЁЯРО => ЁЯРО, ржШрзЛржБрз░рж╛, ржЬржирзНрждрзБ
ЁЯРо => ЁЯРо, ржЧрз░рзБрз░ ржорзБржЦ, ржЧрз░рзБ, ржорзБржЦ, ржЬрзАрз▒
ЁЯРВ => ЁЯРВ, рж╖рж╛ржБрзЬ, ржЬржирзНрждрзБ
ЁЯРГ => ЁЯРГ, ржо'рж╣, ржЬржирзНрждрзБ
ЁЯРД => ЁЯРД, ржЧрз░рзБ, ржЬржирзНрждрзБ
ЁЯР╖ => ЁЯР╖, ржЧрж╛рж╣рз░рж┐рз░ ржорзБржЦ, ржЧрж╛рж╣рз░рж┐, ржорзБржЦ, ржЬрзАрз▒
ЁЯРЦ => ЁЯРЦ, ржЧрж╛рж╣рз░рж┐, ржЬржирзНрждрзБ
ЁЯРЧ => ЁЯРЧ, ржмржиржЧрж╛рж╣рз░рж┐, ржЬржирзНрждрзБ
ЁЯР╜ => ЁЯР╜, ржЧрж╛рж╣рз░рж┐рз░ ржирж╛ржХ, ржЧрж╛рж╣рз░рж┐, ржЬрзАрз▒
ЁЯРП => ЁЯРП, рз░рж╛ржо ржЫрж╛ржЧрж▓рзА, ржЬржирзНрждрзБ
ЁЯРС => ЁЯРС, ржнрзЗрзЬрж╛, ржЬржирзНрждрзБ
ЁЯРР => ЁЯРР, ржЫрж╛ржЧрж▓рзА, ржЬржирзНрждрзБ
ЁЯРк => ЁЯРк, ржЙржЯ, ржПржЯрж╛ ржХрзБржЬ ржержХрж╛ ржЙржЯ, ржЬрзАрз▒
ЁЯРл => ЁЯРл, ржжрзБржЯрж╛ ржХрзБржЬ ржержХрж╛ ржЙржЯ, ржЙржЯ, ржЬрзАрз▒
ЁЯРШ => ЁЯРШ, рж╣рж╛рждрзА, ржЬржирзНрждрзБ
ЁЯРн => ЁЯРн, ржирж┐ржЧржирж┐рз░ ржорзБржЦ, ржирж┐ржЧржирж┐, ржЬрзАрз▒
ЁЯРБ => ЁЯРБ, ржирж┐ржЧржирж┐, ржЬржирзНрждрзБ
ЁЯРА => ЁЯРА, ржПржирзНржжрзБрз░, ржЬржирзНрждрзБ
ЁЯР╣ => ЁЯР╣, рж╣рж╛ржорж╖рзНржЯрж╛рз░рз░ ржорзБржЦ, рж╣рж╛ржорж╖рзНржЯрж╛рз░, ржорзБржЦ, ржЬрзАрз▒
ЁЯР░ => ЁЯР░, ржПржирзНржжрзБрз░рз░ ржорзБржЦ, ржПржирзНржжрзБрз░, ржорзБржЦ, ржЬрзАрз▒
ЁЯРЗ => ЁЯРЗ, рж╢рж╣рж╛ржкрж╣рзБ, ржЬржирзНрждрзБ
ЁЯР╗ => ЁЯР╗, ржнрж╛рж▓рзБржХрз░ ржорзБржЦ, ржнрж╛рж▓рзБржХ, ржорзБржЦ, ржЬрзАрз▒
ЁЯРи => ЁЯРи, ржХрзЛрз▒рж╛рж▓рж╛, ржХрзЛрз▒рж╛рж▓рж╛ ржнрж╛рж▓рзБржХ, ржЬрзАрз▒
ЁЯР╝ => ЁЯР╝, ржкрж╛ржгрзНржбрж╛рз░ ржорзБржЦ, ржкрж╛ржгрзНржбрж╛, ржорзБржЦ, ржЬрзАрз▒
ЁЯР╛ => ЁЯР╛, ржЬржирзНрждрзБрз░ ржнрз░рж┐рз░ ржкржЯрж╛, ржнрз░рж┐рз░ ржкржЯрж╛рз░ ржЪрж┐рж╣рзНржи, ржЬржирзНрждрзБ
ЁЯРФ => ЁЯРФ, ржорж╛ржЗржХрзА ржорзВрз░рзНржЧрзА, ржкржХрзНрж╖рзА
ЁЯРУ => ЁЯРУ, ржорждрж╛ ржорзВрз░рзНржЧрзА, ржкржХрзНрж╖рзА
ЁЯРг => ЁЯРг, ржХржгрж┐ ржлрзБржЯрж┐ ржУрж▓рзЛрз▒рж╛ ржЪрз░рж╛ржЗ ржкрзЛрз▒рж╛рж▓рзА, ржорзВрз░рзНржЧрзА ржкрзЛрз▒рж╛рж▓рзА, ржорзВрз░рзНржЧрзА, ржЬрзАрз▒, ржкржХрзНрж╖рзА
ЁЯРд => ЁЯРд, ржкрзЛрз▒рж╛рж▓рзА ржорзВрз░рзНржЧрзА, ржкрзЛрз▒рж╛рж▓рзА, ржорзВрз░рзНржЧрзА, ржЬрзАрз▒, ржкржХрзНрж╖рзА
ЁЯРе => ЁЯРе, ржорзВрз░рзНржЧрзАрз░ ржкрзЛрз▒рж╛рж▓рзА, рж╕ржирзНржорзБржЦ ржорзБржЦрзА ржорзВрз░рзНржЧрзАрз░ ржкрзЛрз▒рж╛рж▓рзА, ржорзВрз░рзНржЧрзА, ржЬрзАрз▒, ржкржХрзНрж╖рзА
ЁЯРж => ЁЯРж, ржЪрз░рж╛ржЗ, ржЬрзАрз▒
ЁЯРз => ЁЯРз, ржкрзЗржЩрзНржЧрзБржЗржи, ржкржХрзНрж╖рзА, ржЬрзАрз▒
ЁЯР╕ => ЁЯР╕, ржнрзЗржБржХрзБрж▓рж┐рз░ ржорзБржЦ, ржнрзЗржХрзБрж▓рж┐, ржорзБржЦ, ржЬрзАрз▒
ЁЯРК => ЁЯРК, ржШрз░рж┐рзЯрж╛рж▓, ржЬржирзНрждрзБ
ЁЯРв => ЁЯРв, ржХрж╛ржЫ, ржЬрзАрз▒
ЁЯРН => ЁЯРН, рж╕рж╛ржк, рж╕рз░рзАрж╕рзГржк
ЁЯР▓ => ЁЯР▓, ржбрзНрз░рзЗржЧржирз░ ржорзБржЦ, ржбрзНрз░рзЗржЧржи, ржорзБржЦ, ржЬрзАрз▒
ЁЯРЙ => ЁЯРЙ, ржбрзНрз░рзЗржЧржи, ржЬржирзНрждрзБ
ЁЯР│ => ЁЯР│, ржлрзЛржБрз▒рж╛рз░рж╛ ржорз░рж╛ рждрж┐ржорж┐ ржорж╛ржЫ, рждрж┐ржорж┐ ржорж╛ржЫ, ржорж╛ржЫ
ЁЯРЛ => ЁЯРЛ, рждрж┐ржорж┐ржорж╛ржЫ, ржЬржирзНрждрзБ
ЁЯРм => ЁЯРм, ржбрж▓ржлрж┐ржи, ржЬрзАрз▒
ЁЯРЯ => ЁЯРЯ, ржорж╛ржЫ, ржЬрзАрз▒
ЁЯРа => ЁЯРа, ржмрж┐рж╖рзБрз▒рзАрзЯ ржорж╛ржЫ, ржорж╛ржЫ, ржЬрж▓ржЬ ржЬрзАрз▒
ЁЯРб => ЁЯРб, ржмрзНрж▓рзЛржлрж┐ржЫ, ржорж╛ржЫ, ржЬрзАрз▒
ЁЯРЩ => ЁЯРЩ, ржЕржХрзНржЯрзЛржкрж╛ржЪ, ржЬржирзНрждрзБ
ЁЯРЪ => ЁЯРЪ, ржЦрзЛрж▓рж╛, ржХрзБржгрзНржбрж▓рзАрзЯ ржЦрзЛрж▓рж╛, ржЬржирзНрждрзБ
ЁЯРМ => ЁЯРМ, рж╢рж╛ржорзБржХ, ржЬржирзНрждрзБ
ЁЯРЫ => ЁЯРЫ, ржЪрзЗрж▓рж╛, ржмрж┐ржЫрж╛, ржкрж▓рзБ, ржкрзЛржХ
ЁЯРЬ => ЁЯРЬ, ржкрз░рзБрз▒рж╛, ржкрзЛржХ
ЁЯРЭ => ЁЯРЭ, ржорзМржорж╛ржЦрж┐, ржорж╛ржЦрж┐, ржкрждржВржЧ
ЁЯРЮ => ЁЯРЮ, ржЧрзБржмрз░рзБрз▒рж╛ ржкрзЛржХ, рж╕рзЛржгржкрзЛржХ, ржкрждржВржЧ
ЁЯТР => ЁЯТР, ржм'ржХрзЗржЯ, ржлрзБрж▓рз░ ржерзЛржкрж╛, ржлрзБрж▓, рз░рзЛржорж╛ржЮрзНржЪ
ЁЯМ╕ => ЁЯМ╕, ржЪрзЗрз░рзА ржкрзБрж╖рзНржк, ржЪрзЗрз░рзА, ржлрзБрж▓ ржжрз░рзНрж╢ржи, ржлрзБрж▓
ЁЯТо => ЁЯТо, ржлрзБрж▓рз░ рж╖рзНржЯрж╛ржорзНржк, ржлрзБрж▓, рж╖рзНржЯрж╛ржорзНржк, рж╢рзБржн рж╕ржорзНржкржирзНржи рж╖рзНржЯрж╛ржорзНржк
ЁЯМ╣ => ЁЯМ╣, ржЧрзЛрж▓рж╛ржк, ржлрзБрж▓
ЁЯМ║ => ЁЯМ║, ржЬржмрж╛ржлрзБрж▓, ржлрзБрж▓
ЁЯМ╗ => ЁЯМ╗, рж╕рзВрз░рзНржпрзНржпржорзБржЦрзА ржлрзБрж▓, ржлрзБрж▓
ЁЯМ╝ => ЁЯМ╝, ржкрзБрж╖рзНржк, ржлрзБрж▓
ЁЯМ╖ => ЁЯМ╖, ржЯрж┐ржЙрж▓рж┐ржк, ржлрзБрж▓
ЁЯМ▒ => ЁЯМ▒, ржЧржЫржкрзБрж▓рж┐, ржкрзБрж▓рж┐, ржЕржВржХрзБрз░
ЁЯМ▓ => ЁЯМ▓, ржЪрж┐рз░рж╕рзЗржЙржЬ ржЧржЫ, ржЪрж┐рз░рж╕рзЗржЙржЬ, ржЧржЫ
ЁЯМ│ => ЁЯМ│, ржЫрж╛ржБ ржжрж┐рзЯрж╛ ржЧржЫ, ржЫрж╛ржБ ржжрж┐рзЯрж╛, ржкрз░рзНржгржкрж╛рждрзА, ржЧржЫ
ЁЯМ┤ => ЁЯМ┤, рждрж╛рж▓ ржЧржЫ, рждрж╛рж▓, ржЧржЫ
ЁЯМ╡ => ЁЯМ╡, ржХрзЗржХрзЗржЯрж╛ржЪ, ржЙржжрзНржнрж┐ржж
ЁЯМ╛ => ЁЯМ╛, ржзрж╛ржи ржЧржЫ, ржзрж╛ржирз░ ржХрз░рзНржг, ржзрж╛ржи, ржХрз░рзНржг
ЁЯМ┐ => ЁЯМ┐, ржФрж╖ржзрзА, ржкрж╛ржд
ЁЯНА => ЁЯНА, ржЪрж╛рз░рж┐ржЦрж┐рж▓рж╛ ржкрж╛рждрз░ ржШрж╛ржБрж╣, ржкрж╛ржд, ржШрж╛ржБрж╣, ржнрж╛ржЧрзНржпржмрж╛ржи
ЁЯНБ => ЁЯНБ, ржорзЗржкрж▓ ржкрж╛ржд, рж╕рз░рж┐ ржкрз░рж╛ ржкрж╛ржд, ржкрж╛ржд
ЁЯНВ => ЁЯНВ, рж╕рз░рж┐ ржкрз░рж╛ ржкрж╛ржд, рж╕рз░рж╛ ржкрж╛ржд, рж╕рз░рж┐ ржкрз░рж╛, ржкрж╛ржд
ЁЯНГ => ЁЯНГ, ржмрждрж╛рж╣ржд ржкрж╛ржд, ржмрждрж╛рж╣ ржмрж▓рж╛, ржкрж╛ржд, ржмрждрж╛рж╣
ЁЯНЗ => ЁЯНЗ, ржЖржЩрзБрз░, ржлрж▓
ЁЯНИ => ЁЯНИ, рждрз░ржорзБржЬ, ржлрж▓рж╛
ЁЯНЙ => ЁЯНЙ, рждрз░ржорзБржЬ, ржлрж▓
ЁЯНК => ЁЯНК, ржорзМржЪрзБржорзА ржЯрзЗржЩрж╛, ржХржорж▓рж╛, ржлрж▓
ЁЯНЛ => ЁЯНЛ, ржирзЗржорзБ, ржирзЗржорзБ ржЯрзЗржЩрж╛, ржлрж▓
ЁЯНМ => ЁЯНМ, ржХрж▓, ржлрж▓
ЁЯНН => ЁЯНН, ржЖржирж╛рз░рж╕, ржлрж▓
ЁЯНО => ЁЯНО, рз░ржЩрж╛ ржЖржкрзЗрж▓, ржЖржкрзЗрж▓, рз░ржЩрж╛, ржлрж▓
ЁЯНП => ЁЯНП, рж╕рзЗржЙржЬрзАрзЯрж╛ ржЖржкрзЗрж▓, ржЖржкрзЗрж▓, рж╕рзЗржЙржЬрзАрзЯрж╛, ржлрж▓
ЁЯНР => ЁЯНР, ржирж╛ржЪржкрждрж┐, ржлрж▓
ЁЯНС => ЁЯНС, ржирз░рж╛ржмржЧрз░рж┐, ржлрж▓
ЁЯНТ => ЁЯНТ, ржЪрзЗрз░рзА, ржлрж▓
ЁЯНУ => ЁЯНУ, рж╖рзНржЯ'ржмрзЗрз░рзА, ржмрзЗрз░рзА, ржлрж▓
ЁЯНЕ => ЁЯНЕ, ржмрж┐рж▓рж╛рж╣рзА, ржкрж╛ржЪрж▓рж┐
ЁЯНЖ => ЁЯНЖ, ржмрзЗржЩрзЗржирж╛, ржкрж╛ржЪрж▓рж┐
ЁЯМ╜ => ЁЯМ╜, ржорж╛ржХрзИ, ржХрз░рзНржг, ржЧрзЛржоржзрж╛ржи
ЁЯНД => ЁЯНД, ржХрж╛ржаржлрзБрж▓рж╛
ЁЯМ░ => ЁЯМ░, ржмрж╛ржжрж╛ржо
ЁЯНЮ => ЁЯНЮ, ржкрж╛ржЙрз░рзБржЯрзА, ржкрж╛ржУрз░рзБржЯрзАрз░ рж▓рзЛржл, рз░рзЗрж╖рзНржЯрзБрз░рзЗржгрзНржЯ
ЁЯНЦ => ЁЯНЦ, ржорж╛ржВрж╕, рж╣рж╛рзЬ рж╕рж╣ ржорж╛ржВрж╕, рз░рзЗрж╖рзНржЯрзБрз░рзЗржгрзНржЯ
ЁЯНЧ => ЁЯНЧ, ржХрзБржХрзБрз░рж╛ ржорж╛ржВрж╕рз░ ржарзЗржВ, ржХрзБржХрзБрз░рж╛ ржорж╛ржВрж╕, ржарзЗржВ, рз░рзЗрж╖рзНржЯрзБрз░рзЗржгрзНржЯ
ЁЯНФ => ЁЯНФ, рж╣рзЗржоржмрж╛рз░рзНржЧрж╛рз░, ржмрж╛рз░рзНржЧрж╛рз░, рз░рзЗрж╖рзНржЯрзБрз░рзЗржгрзНржЯ
ЁЯНЯ => ЁЯНЯ, ржнржЬрж╛, ржлрзНрз░рзЗржирзНрж╕ ржлрзНрз░рж╛ржЗ, рз░рзЗрж╖рзНржЯрзБрз░рзЗржгрзНржЯ
ЁЯНХ => ЁЯНХ, ржкрж┐ржЬрзНржЬрж╛рз░ ржЯрзБржХрзБрз░рж╛, ржкрж┐ржЬрзНржЬрж╛, ржЯрзБржХрзБрз░рж╛, рз░рзЗрж╖рзНржЯрзБрз░рзЗржгрзНржЯ
ЁЯН▓ => ЁЯН▓, рж╖рзНржЯрж┐ржЙ, ржЦрж╛ржжрзНржпрз░ ржмрж╛рждрж┐, рз░рзЗрж╖рзНржЯрзБрз░рзЗржгрзНржЯ
ЁЯН▒ => ЁЯН▒, ржмрзЗржирзНржЯрзБ, ржмрзЗржирзНржЯрзБ ржмржХрзНрж╕, рз░рзЗрж╖рзНржЯрзБрз░рзЗржгрзНржЯ
ЁЯНШ => ЁЯНШ, ржЪрж╛ржЙрж▓ ржЦрзБржирзНржжрж╛ ржЦрзБржирзНржжржирж╛, ржЪрж╛ржЙрж▓
ЁЯНЩ => ЁЯНЩ, ржЪрж╛ржЙрж▓рз░ ржЧрзЛрж▓рж╛, ржЕржирж┐ржЧрж┐рз░рж┐, ржЪрж╛ржЙрж▓, рз░рзЗрж╖рзНржЯрзБрз░рзЗржгрзНржЯ
ЁЯНЪ => ЁЯНЪ, рз░ржирзНржзрж╛ ржнрж╛ржд, ржнрж╛ржд, рз░рзЗрж╖рзНржЯрзБрз░рзЗржгрзНржЯ
ЁЯНЫ => ЁЯНЫ, ржЖржЮрзНржЬрж╛ ржЖрз░рзБ ржнрж╛ржд, ржЖржЮрзНржЬрж╛, ржнрж╛ржд, рз░рзЗрж╖рзНржЯрзБрз░рзЗржгрзНржЯ
ЁЯНЬ => ЁЯНЬ, рз░рж╛ржорзЗржи, ржирзБржбрж▓рз░ ржмрж╛рждрж┐, ржирзБржбрж▓, ржнрж╛ржк ржУрж▓рж╛ржЗ ржержХрж╛, ржмрж╛рждрж┐, рз░рзЗрж╖рзНржЯрзБрз░рзЗржгрзНржЯ
ЁЯНЭ => ЁЯНЭ, рж╕рзНржкрж╛ржШрзЗржЯрж┐, ржкрж╛рж╖рзНржЯрж╛, рз░рзЗрж╖рзНржЯрзБрз░рзЗржгрзНржЯ
ЁЯНа => ЁЯНа, рж╕рзЗржХрж╛ ржЖрж▓рзБ, ржорж┐ржарж╛ ржЖрж▓рзБ, ржЖрж▓рзБ
ЁЯНв => ЁЯНв, ржЕ'ржбрзЗржи, ржЦрз░рж┐ржХрж╛ржд ржжрж┐рзЯрж╛ рж╕рж╛ржЧрз░рзАрзЯ ржЦрж╛ржжрзНржп, ржЦрз░рж┐ржХрж╛, рз░рзЗрж╖рзНржЯрзБрз░рзЗржгрзНржЯ
ЁЯНг => ЁЯНг, ржЪрзБржЪрж┐, рз░рзЗрж╖рзНржЯрзБрз░рзЗржгрзНржЯ
ЁЯНд => ЁЯНд, ржнржЬрж╛ ржорж┐ржЫрж╛ржорж╛ржЫ, ржорж┐ржЫрж╛ржорж╛ржЫ, рз░рзЗрж╖рзНржЯрзБрз░рзЗржгрзНржЯ
ЁЯНе => ЁЯНе, ржорж╛ржЫрз░ ржХрзЗржХ, ржШрзБрз░ржгрзАрзЯрж╛ ржбрж┐ржЬрж╛ржЗржирз░ рж╕рзИрждрзЗ ржорж╛ржЫрз░ ржХрзЗржХ, ржорж╛ржЫ, рз░рзЗрж╖рзНржЯрзБрз░рзЗржгрзНржЯ
ЁЯНб => ЁЯНб, ржорзЛржЪрж┐, ржорзЛржЪрж┐ ржмрж▓, ржЦрз░рж┐ржХрж╛ржд ржжрж┐рзЯрж╛ ржорзЛржЪрж┐ ржмрж▓, ржбрзЗржЩрзНржЧрзЛ, рз░рзЗрж╖рзНржЯрзБрз░рзЗржгрзНржЯ
ЁЯНж => ЁЯНж, ржХрзЛржорж▓ ржЖржЗржЪ ржХрзНрз░рзАржо, ржЖржЗржЪ ржХрзНрз░рзАржо, ржХрзНрз░рзАржо, рз░рзЗрж╖рзНржЯрзБрз░рзЗржгрзНржЯ
ЁЯНз => ЁЯНз, ржЪрзЗржнржб ржЖржЗржЪ, рз░рзЗрж╖рзНржЯрзБрз░рзЗржгрзНржЯ
ЁЯНи => ЁЯНи, ржЖржЗржЪ ржХрзНрз░рзАржо, ржЖржЗржЪ, ржХрзНрз░рзАржо, рз░рзЗрж╖рзНржЯрзБрз░рзЗржгрзНржЯ
ЁЯНй => ЁЯНй, ржб'ржирж╛ржЯ, рз░рзЗрж╖рзНржЯрзБрз░рзЗржгрзНржЯ
ЁЯНк => ЁЯНк, ржХрзБржБржХрж┐, рз░рзЗрж╖рзНржЯрзБрз░рзЗржгрзНржЯ
ЁЯОВ => ЁЯОВ, ржЬржирзНржоржжрж┐ржирз░ ржХрзЗржХ, ржХрзЗржХ, ржЬржирзНржоржжрж┐ржи, ржЙржжржпрж╛ржкржи
ЁЯН░ => ЁЯН░, рж╢рзНрж▓рж╛ржЗржЪржб ржХрзЗржХ, ржХржЯрж╛ ржХрзЗржХ, рз░рзЗрж╖рзНржЯрзБрз░рзЗржгрзНржЯ
ЁЯНл => ЁЯНл, ржЪржХрж▓рзЗржЯ ржмрж╛рз░, ржЪржХрж▓рзЗржЯ, рз░рзЗрж╖рзНржЯрзБрз░рзЗржгрзНржЯ
ЁЯНм => ЁЯНм, ржХрзЗржгрзНржбрзА, рз░рзЗрж╖рзНржЯрзБрз░рзЗржгрзНржЯ
ЁЯНн => ЁЯНн, рж▓рж▓рж┐ржкржк, ржХрзЗржгрзНржбрж┐, рз░рзЗрж╖рзНржЯрзБрз░рзЗржгрзНржЯ
ЁЯНо => ЁЯНо, ржХрж╛рж╖рзНржЯрж╛рз░рзНржб, ржкрзБржбрж┐ржВ, рз░рзЗрж╖рзНржЯрзБрз░рзЗржгрзНржЯ
ЁЯНп => ЁЯНп, ржорзМрз░ ржмрж╛рждрж┐, ржорзМ, ржмрж╛рждрж┐, рз░рзЗрж╖рзНржЯрзБрз░рзЗржгрзНржЯ
ЁЯН╝ => ЁЯН╝, ржХрзЗржБржЪрзБрз▒рж╛рз░ ржмржЯрж▓, ржЧрж╛ржЦрзАрз░ ржЦрзЛрз▒рж╛ ржмржЯрж▓
ЁЯН╡ => ЁЯН╡, ржЪрж╛рж╣рз░ ржкрж┐рзЯрж▓рж╛, ржкрж┐рзЯрж▓рж╛, ржЪрж╛рж╣
ЁЯН╢ => ЁЯН╢, ржмржЯрж▓, ржХрж╛ржк, ржмржЯрж▓ ржЖрз░рзБ ржХрж╛ржк, рз░рзЗрж╖рзНржЯрзБрз░рзЗржгрзНржЯ, ржмрж╛рз░
ЁЯН╖ => ЁЯН╖, рз▒рж╛ржЗржи, рз▒рж╛ржЗржирз░ ржЧрж┐рж▓рж╛ржЪ, ржЧрж┐рж▓рж╛ржЪ, рж╕рзБрз░рж╛, рз░рзЗрж╖рзНржЯрзБрз░рзЗржгрзНржЯ, ржмрж╛рз░
ЁЯН╕ => ЁЯН╕, ржХржХржЯрзЗржЗрж▓, ржХржХржЯрзЗржЗрж▓ ржЧрж┐рж▓рж╛ржЪ, рз░рзЗрж╖рзНржЯрзБрз░рзЗржгрзНржЯ, ржмрж╛рз░
ЁЯН╣ => ЁЯН╣, ржЯрзНрз░'ржкрж┐ржХрзЗрж▓ ржбрзНрз░рж┐ржВржХ, ржбрзНрз░рж┐ржВржХ, рз░рзЗрж╖рзНржЯрзБрз░рзЗржгрзНржЯ, ржмрж╛рз░
ЁЯН║ => ЁЯН║, ржмрж┐рзЯрзЗрз░, ржмрж┐рзЯрзЗрз░ ржоржЧ, ржоржЧ, рз░рзЗрж╖рзНржЯрзБрз░рзЗржгрзНржЯ, ржмрж╛рз░
ЁЯН╗ => ЁЯН╗, ржмрж┐рзЯрзЗрз░ ржоржЧ, ржмрж┐рзЯрзЗрз░ ржоржЧрз░ ржЦрзБржирзНржжрж╛, ржмрж┐рзЯрзЗрз░, рз░рзЗрж╖рзНржЯрзБрз░рзЗржгрзНржЯ, ржмрж╛рз░
ЁЯН┤ => ЁЯН┤, ржХрж╛ржЯрж╛ржЪрж╛ржорзБржЪ ржЖрз░рзБ ржЪрзБрз░рж┐, ржХрж╛ржЯрж╛ржЪрж╛ржорзБржЪ, ржЪрзБрз░рж┐, рз░рзЗрж╖рзНржЯрзБрз░рзЗржгрзНржЯ
ЁЯН│ => ЁЯН│, рждрж╛рз▒рж╛, рз░ржирзНржзрж╛, рз░рзЗрж╖рзНржЯрзБрз░рзЗржгрзНржЯ
ЁЯМН => ЁЯМН, ржЧрзЛрж▓ржХ, ржкрзГржерж┐ржмрзА, ржЗржЙрз░рзЛржк, ржЖржлрзНрз░рж┐ржХрж╛
ЁЯМО => ЁЯМО, ржЧрзЛрж▓ржХ, ржкрзГржерж┐ржмрзА, ржЖржорзЗрз░рж┐ржХрж╛
ЁЯМП => ЁЯМП, ржЧрзЛрж▓ржХ, ржкрзГржерж┐ржмрзА, ржПржЪрж┐рзЯрж╛, ржЕрж╖рзНржЯрзНрз░рзЗрж▓рзАрзЯрж╛
ЁЯМР => ЁЯМР, ржЧрзЛрж▓ржХ, ржнрзВржоржзрзНржп
ЁЯМЛ => ЁЯМЛ, ржЖржЧрзНржирзЗрзЯржЧрж┐рз░рж┐, ржЖржЧрзНржирзЗрзЯржЧрж┐рз░рж┐ ржЙржжрзНржЧрж┐рз░ржг
ЁЯЧ╗ => ЁЯЧ╗, ржорж╛ржЙржгрзНржЯ ржлрж┐ржЬрж┐, ржкрз░рзНржмржд
ЁЯПа => ЁЯПа, ржШрз░, ржЧрзГрж╣, ржЖржЯрзНржЯрж╛рж▓рж┐ржХрж╛
ЁЯПб => ЁЯПб, ржШрз░, ржмрж╛ржЧрж┐ржЪрж╛рз░ рж╕рзИрждрзЗ ржШрз░
тЫк => тЫк, ржЧрзАрз░рзНржЬрж╛, ржЧрзГрж╣
ЁЯПв => ЁЯПв, ржЕржлрж┐ржЪ ржШрз░, ржЕржлрж┐ржЪ, ржХрж╛рз░рзНржпрж╛рж▓рзЯ, ржЕржЯрзНржЯрж╛рж▓рж┐ржХрж╛
ЁЯПг => ЁЯПг, ржкрзЛрж╖рзНржЯ ржЕржлрж┐ржЪ, ржЬрж╛ржкрж╛ржирзА ржкрзЛрж╖рзНржЯ ржЕржлрж┐ржЪ
ЁЯПд => ЁЯПд, ржкрзЛрж╖рзНржЯ ржЕржлрж┐ржЪ, ржЗржЙрз░рзЛржкрж┐рзЯрж╛ржи ржкрзЛрж╖рзНржЯ ржЕржлрж┐ржЪ
ЁЯПе => ЁЯПе, ржЪрж┐ржХрж┐рзОрж╕рж╛рж▓рзЯ, рж╣рж╕рзНржкрж┐ржЯрж╛рж▓, ржмрж┐рж▓рзНржбрж┐ржВ
ЁЯПж => ЁЯПж, ржмрзЗржВржХ, ржЧрзГрж╣
ЁЯПи => ЁЯПи, рж╣рзЛржЯрзЗрж▓, ржмрж┐ржЪржирж╛
ЁЯПй => ЁЯПй, рж╣рзЛржЯрзЗрж▓, ржмрж┐ржЪржирж╛, ржкрзНрз░рзЗржо ржмрж┐ржЪржирж╛
ЁЯПк => ЁЯПк, рж╕рзБрж▓ржн ржорзВрж▓рзНржпрз░ ржжрзЛржХрж╛ржи, ржжрзЛржХрж╛ржи, ржмрж┐рж▓рзНржбрж┐ржВ
ЁЯПл => ЁЯПл, рж╕рзНржХрзБрж▓, ржмрж┐ржжрзНржпрж╛рж▓рзЯ
ЁЯПм => ЁЯПм, ржбрж┐ржкрж╛рз░ржЯржорзЗржгрзНржЯ рж╖рзНржЯ'рз░, ржжрзЛржХрж╛ржи
ЁЯПн => ЁЯПн, ржлрзЗржХрзНржЯрз░рзА, ржХрж╛рз░ржЦрж╛ржирж╛
ЁЯПп => ЁЯПп, ржЬрж╛ржкрж╛ржирзА ржжрзБрз░рзНржЧ, ржжрзБрз░рзНржЧ, ржЕржЯрзНржЯрж╛рж▓рж┐ржХрж╛
ЁЯП░ => ЁЯП░, ржЗржЙрз░рзЛржкрзАрзЯрж╛ржи ржжрзБрз░рзНржЧ, ржжрзБрз░рзНржЧ, ржЕржЯрзНржЯрж╛рж▓рж┐ржХрж╛
ЁЯТТ => ЁЯТТ, ржмрж┐ржмрж╛рж╣ ржЧрзАрз░рзНржЬрж╛ржШрз░, ржмрж┐ржмрж╛рж╣, ржЧрзАрз░рзНржЬрж╛, рз░рзЛржорж╛ржЮрзНржЪ
ЁЯЧ╝ => ЁЯЧ╝, ржЯржХрж┐ржЕтАЩ ржЯрж╛рз▒рж╛рз░, ржЯржХрж┐ржЕтАЩ, рж╕рзНрждржорзНржн
ЁЯЧ╜ => ЁЯЧ╜, рж╖рзНржЯрзЗржЪрзНржпрзБ ржЕржл рж▓рж┐ржмрж╛рз░ржЯрж┐, ржорзВрз░рзНрждрж┐, рж╕рзНржмрждржирзНрждрзНрз░рждрж╛
ЁЯЧ╛ => ЁЯЧ╛, ржЬрж╛ржкрж╛ржирз░ ржорзЗржк, ржорзЗржк, ржЬрж╛ржкрж╛ржи
тЫ▓ => тЫ▓, ржлрж╛ржЙржгрзНржЯрзЗржЗржи
тЫ║ => тЫ║, рждржорзНржмрзБ, рж╢рж┐ржмрж┐рз░
ЁЯМБ => ЁЯМБ, ржХрзБржБрз▒рж▓рзАржорзЯ, ржХрзБржБрз▒рж▓рзА
ЁЯМГ => ЁЯМГ, рз░рж╛рждрж┐рз░ рждрз░рж╛, рждрз░рж╛, рз░рж╛рждрж┐
ЁЯМД => ЁЯМД, рж╕рзВрз░рзНржпрзЛржжрзЯ, рз░рж╛рждрж┐ржкрзБрз▒рж╛рз░ рж╕рзВрз░рзНржп, ржкрз░рзНржмрждрз░ ржУржкрз░рзЗржжрж┐ рж╕рзВрз░рзНржпрзЛржжрзЯ, ржкрз░рзНржмржд
ЁЯМЕ => ЁЯМЕ, рж╕рзВрз░рзНржпрзЛржжрзЯ, рз░рж╛рждрж┐ржкрзБрз▒рж╛рз░ рж╕рзВрз░рзНржп
ЁЯМЖ => ЁЯМЖ, рж╕ржирзНржзрзНржпрж╛рз░ ржЪрж╣рз░, рж╕ржирзНржзрзНржпрж╛, ржЧржзрзБрж▓рж┐, рж╕рзВрз░рзНржпрж╛рж╕рзНржд, ржЪрж╣рз░, ржЕржЯрзНржЯрж╛рж▓рж┐ржХрж╛, рж▓рзЗржгрзНржбрж╕рзНржХрзЗржк
ЁЯМЗ => ЁЯМЗ, рж╕рзВрз░рзНржпрж╛рж╕рзНржд, рж╕ржирзНржзрзНржпрж╛, ржЕржЯрзНржЯрж╛рж▓рж┐ржХрж╛рз░ ржУржкрз░рзЗржжрж┐ рж╕рзВрз░рзНржпрж╛рж╕рзНржд, ржЕржЯрзНржЯрж╛рж▓рж┐ржХрж╛
ЁЯМЙ => ЁЯМЙ, ржирзИрж╢ ржжрж▓ржВ, ржирж┐рж╢рж╛рз░ ржжрж▓ржВ, ржирж┐рж╢рж╛
ЁЯММ => ЁЯММ, рж╣рж╛рждрзА-ржкржЯрж┐
ЁЯОа => ЁЯОа, ржХрзЗрз░ржЪрзЗрж▓, ржХрзЗрз░ржЪрзЗрж▓ ржШрзЛрз░рж╛, ржШрзЛрз░рж╛, ржоржирзЛрз░ржЮрзНржЬржи
ЁЯОб => ЁЯОб, ржлрзЗрз░рж┐ржЪ ржЪржХрж╛, ржлрзЗрз░рж┐ржЪ, ржЪржХрж╛, ржмрж┐ржирзЛржжржи ржкрж╛рз░рзНржХ, ржоржирзЛрз░ржЮрзНржЬржи
ЁЯОв => ЁЯОв, рз░рзЛрж▓рж╛рз░ ржХ'рж╖рзНржЯрж╛рз░, рз░рзЛрж▓рж╛рз░, ржХрзЛрж╖рзНржЯрж╛рз░, ржмрж┐ржирзЛржжржи ржкрж╛рз░рзНржХ, ржоржирзЛрз░ржЮрзНржЬржи
ЁЯТИ => ЁЯТИ, ржирж╛ржкрж┐рждрз░ ржжрзЛржХрж╛ржи, ржирж╛ржкрж┐ржд
ЁЯОк => ЁЯОк, ржЪрж╛рз░рзНржХрж╛ржЪрз░ рждржорзНржмрзБ, рждржорзНржмрзБ, ржоржирзЛрз░ржЮрзНржЬржи
ЁЯОн => ЁЯОн, ржорзБржЦрж╛, ржХрж▓рж╛, ржоржирзЛрз░ржЮрзНржЬржи, ржкрзНрз░ржжрз░рзНрж╢ржиржорзВрж▓ржХ ржХрж▓рж╛
ЁЯОи => ЁЯОи, рз░ржЩрз░ ржкрзЗрж▓рзЗржЯ, ржЪрж┐рждрзНрз░рж╢рж┐рж▓рзНржкрж┐рз░ ржкрзЗрж▓рзЗржЯ, ржЪрж┐рждрзНрз░рж╢рж┐рж▓рзНржкрж┐, рз░ржВ, рж╢рж┐рж▓рзНржкржХрж▓рж╛
ЁЯО░ => ЁЯО░, рж╢рзНрж▓'ржЯ ржорзЗржЪрж┐ржи, рж╢рзНрж▓'ржЯ, ржЦрзЗрж▓
ЁЯЪВ => ЁЯЪВ, ржнрж╛ржк ржЗржЮрзНржЬрж┐ржи, рз░рзЗрж▓ ржЗржЮрзНржЬрж┐ржи, ржЯрзНрз░рзЗржЗржи, ржмрж╛рж╣ржи
ЁЯЪГ => ЁЯЪГ, ржЯрзНрз░рзЗржЗржи, ржмрзИржжрзНржпрзБрждрж┐ржХ ржЯрзНрз░рзЗржЗржи, рз░рзЗрж▓ ржХрж╛рз░, ржмрзИржжрзНржпрзБрждрж┐ржХ, рз░рзЗрж▓рз▒рзЗ, ржЯрзНрз░рж╛ржо, ржмрж╛рж╣ржи
ЁЯЪД => ЁЯЪД, ржЙржЪрзНржЪ-ржЧрждрж┐рз░ ржЯрзНрз░рзЗржЗржи, ржмрзБрж▓рзЗржЯ ржЯрзНрз░рзЗржЗржи, ржмрж╛рж╣ржи
ЁЯЪЕ => ЁЯЪЕ, ржЙржЪрзНржЪ ржЧрждрж┐рз░ ржЯрзНрз░рзЗржЗржи, ржмрзБрж▓рзЗржЯ ржирж╛ржХ, ржмрзБрж▓рзЗржЯ ржирж╛ржХ рж╕рж╣ ржЙржЪрзНржЪ ржЧрждрж┐рз░ ржЯрзНрз░рзЗржЗржи, ржЯрзНрз░рзЗржЗржи, ржмрж╛рж╣ржи
ЁЯЪЖ => ЁЯЪЖ, ржЯрзНрз░рзЗржЗржи, рз░рзЗрж▓, ржмрж╛рж╣ржи
ЁЯЪЗ => ЁЯЪЗ, ржЪрж╛ржмрз▒рзЗ, ржорзЗржЯрзНрз░тАЩ рз░рзЗрж▓, ржмрж╛рж╣ржи
ЁЯЪИ => ЁЯЪИ, ржкрж╛рждрж▓ рз░рзЗрж▓, ржкрж╛рждрж▓, рз░рзЗрж▓, ржмрж╛рж╣ржи
ЁЯЪЙ => ЁЯЪЙ, рз░рзЗрж▓ рж╖рзНржЯрзЗржЪржи, рз░рзЗрж▓, рж╖рзНржЯрзЗржЪржи
ЁЯЪК => ЁЯЪК, ржЯрзНрз░рж╛ржо, ржмрж╛рж╣ржи
ЁЯЪЭ => ЁЯЪЭ, ржорзЛржирзЛрз░рзЗрж▓, ржмрж╛рж╣ржи
ЁЯЪЮ => ЁЯЪЮ, ржкрз░рзНржмрждрзАрзЯрж╛ рз░рзЗрж▓, ржкрз░рзНржмрждрзАрзЯрж╛ ржХрзЗржмрж▓ ржХрж╛рз░, ржкрз░рзНржмржд, рз░рзЗрж▓рз▒рзЗ, ржмрж╛рж╣ржи
ЁЯЪЛ => ЁЯЪЛ, ржЯрзНрз░рж╛ржо ржХрж╛рз░, ржЯрзНрз░рж╛ржо, ржХрж╛рз░, ржмрж╛рж╣ржи
ЁЯЪМ => ЁЯЪМ, ржмрж╛ржЫ, ржмрж╛рж╣ржи
ЁЯЪН => ЁЯЪН, ржЖрж╣рж┐ ржержХрж╛ ржмрж╛ржЫ, ржмрж╛ржЫ, ржЖрж╣рж┐ ржержХрж╛, ржмрж╛рж╣ржи
ЁЯЪО => ЁЯЪО, ржЯрзНрз░рж▓рзАржмрж╛ржЫ, ржмрж╛ржЫ, ржЯрзНрз░рж▓рзА, ржмрж╛рж╣ржи
ЁЯЪП => ЁЯЪП, ржмрж╛ржЫ ржЖрж╕рзНржерж╛ржи, ржмрж╛ржЫ, ржЖрж╕рзНржерж╛ржи
ЁЯЪР => ЁЯЪР, ржорж┐ржирж┐ржмрж╛ржЫ, ржмрж╛ржЫ, ржмрж╛рж╣ржи
ЁЯЪС => ЁЯЪС, ржПржорзНржмрзБрж▓рзЗржирзНрж╕, ржмрж╛рж╣ржи
ЁЯЪТ => ЁЯЪТ, ржЕржЧрзНржирж┐ржирж┐рз░рзНржмрж╛ржкржХ ржЧрж╛рзЬрзА, ржЕржЧрзНржирж┐ржирж┐рз░рзНржмрж╛ржкржХ ржЯрзНрз░рж╛ржХ, ржЬрзБржЗ, ржмрж╛рж╣ржи
ЁЯЪУ => ЁЯЪУ, ржЖрз░ржХрзНрж╖рзАрз░ ржмрж╛рж╣ржи, ржкрзЗржЯрзНрз░рж▓ ржХрж╛рз░, ржЖрз░ржХрзНрж╖рзА, ржмрж╛рж╣ржи
ЁЯЪФ => ЁЯЪФ, ржЖрж╣рж┐ ржержХрж╛ ржЖрз░ржХрзНрж╖рзАрз░ ржмрж╛рж╣ржи, ржЖрз░ржХрзНрж╖рзАрз░ ржмрж╛рж╣ржи, ржЖрз░ржХрзНрж╖рзА, ржмрж╛рж╣ржи
ЁЯЪХ => ЁЯЪХ, ржЯрзЗржХрзНрж╕рж┐, ржмрж╛рж╣ржи
ЁЯЪЦ => ЁЯЪЦ, ржЖрж╣рж┐ ржержХрж╛ ржЯрзЗржХрзНрж╕рж┐, ржЯрзЗржХрзНрж╕рж┐, ржмрж╛рж╣ржи
ЁЯЪЧ => ЁЯЪЧ, ржХрж╛рз░, ржЕржЯрзЛржорзЛржмрж╛ржЗрж▓, ржмрж╛рж╣ржи
ЁЯЪШ => ЁЯЪШ, ржЖрж╣рж┐ ржержХрж╛ ржХрж╛рз░, ржЖрж╣рж┐ ржержХрж╛ ржЕржЯрзЛржорзЛржмрж╛ржЗрж▓, ржХрж╛рз░, ржЕржЯрзЛржорзЛржмрж╛ржЗрж▓, ржмрж╛рж╣ржи
ЁЯЪЩ => ЁЯЪЩ, ржЖрз░.ржнрж┐., ржмрж┐ржирзЛржжржирз░ ржмрж╛рж╣ржи, ржмрж╛рж╣ржи
ЁЯЪЪ => ЁЯЪЪ, ржмрж┐рждрз░ржг ржЯрзНрз░рж╛ржХ, ржЯрзНрз░рж╛ржХ, ржмрж╛рж╣ржХ
ЁЯЪЫ => ЁЯЪЫ, рж▓рз░рзА, ржЪрзЗржорж┐, ржпрзЛрз░рж╛ рж▓ржЧрзЛрз▒рж╛ рж▓рз░рзА, ржЯрзНрз░рж╛ржХ, ржЯрзНрз░рзЗржЗрж▓рж╛рз░, ржмрж╛рж╣ржи
ЁЯЪЬ => ЁЯЪЬ, ржЯрзНрз░рзЗржХрзНржЯрз░, ржмрж╛рж╣ржи
ЁЯЪ▓ => ЁЯЪ▓, ржмрж╛ржЗржХ, ржмрж╛ржЗржЪрж╛ржЗржХрзЗрж▓, ржЪрж╛ржЗржХрзЗрж▓, ржмрж╛рж╣ржи
тЫ╜ => тЫ╜, ржкрзЗржЯрзНрз░тАЩрж▓ ржХрзЗржирзНржжрзНрз░, ржЗржирзНржзржи ржкрж╛ржорзНржк, ржЗржирзНржзржи, ржкрзЗржЯрзНрз░рж▓
ЁЯЪи => ЁЯЪи, ржШрзВрз░рзНржгрзАрзЯржорж╛ржи рж▓рж╛ржЗржЯ, ржЖрз░ржХрзНрж╖рзАрз░ рж▓рж╛ржЗржЯ, рз░ржЩрж╛ рж▓рж╛ржЗржЯ, ржЖрз░ржХрзНрж╖рзАрз░ ржмрж╛рж╣ржи
ЁЯЪе => ЁЯЪе, ржЯрзНрз░рзЗржлрж┐ржХ рж▓рж╛ржЗржЯ, ржкржерж╛рж▓рж┐ ржЯрзНрз░рзЗржлрж┐ржХ рж▓рж╛ржЗржЯ, ржЯрзНрз░рзЗржлрж┐ржХ ржЪрж┐ржЧржирзЗрж▓, рж▓рж╛ржЗржЯ, ржЯрзНрз░рзЗржлрж┐ржХ
ЁЯЪж => ЁЯЪж, ржЯрзНрз░рзЗржлрж┐ржХ рж▓рж╛ржЗржЯ, ржЙрж▓ржорзНржм ржЯрзНрз░рзЗржлрж┐ржХ рж▓рж╛ржЗржЯ, ржЯрзНрз░рзЗржлрж┐ржХ ржЪрж┐ржЧржирзЗрж▓, рж▓рж╛ржЗржЯ, ржЯрзНрз░рзЗржлрж┐ржХ
ЁЯЪз => ЁЯЪз, ржирж┐рз░рзНржорзАрзЯржорж╛ржи, ржирж┐рз░рзНржорж╛ржгрз░ ржЪрж┐рж╣рзНржи, ржирж┐рз░рзНржорж╛ржг, ржЪрж┐рж╣рзНржи
тЪУ => тЪУ, рж▓ржЩрзНржЧрз░, ржЪрж┐рж╣рзНржи
тЫ╡ => тЫ╡, ржкрж╛рж▓рждрз░рж╛ ржирж╛ржУ, ржирж╛ржУ, рзЯрж╛ржЪрзНржЫ, рж╕ржорзБржжрзНрз░ рз░рж┐ржЬрз░рзНржЯ, рз░рж┐ржЬрз░рзНржЯ
ЁЯЪг => ЁЯЪг, ржмржарж╛ ржорз░рж╛ ржирж╛ржУ, ржирж╛ржУ, ржмрж╛рж╣ржи
ЁЯЪд => ЁЯЪд, рж╕рзНржкрзАржбржмрзЛржЯ, ржирж╛ржУ, ржмрж╛рж╣ржи
ЁЯЪв => ЁЯЪв, ржЬрж╛рж╣рж╛ржЬ, ржмрж╛рж╣ржи
ЁЯТ║ => ЁЯТ║, ржЪржХрзА, ржЖрж╕ржи
ЁЯЪБ => ЁЯЪБ, рж╣рзЗрж▓рж┐ржХржкрзНржЯрж╛рз░, ржмрж╛рж╣ржи
ЁЯЪЯ => ЁЯЪЯ, ржУрж▓ржорж╛ рз░рзЗрж▓рз▒рзЗ, ржУрж▓ржорж╛, рз░рзЗрж▓рз▒рзЗ, ржмрж╛рж╣ржи
ЁЯЪа => ЁЯЪа, ржкрз░рзНржмрждрзАрзЯрж╛ ржХрзЗржмрж▓рз▒рзЗ, ржкрз░рзНржмрждрзАрзЯрж╛ ржХрзЗржмрж▓ржХрж╛рз░, ржХрзЗржмрж▓ ржХрж╛рз░, ржХрзЗржмрж▓, ржХрж╛рз░, ржкрз░рзНржмржд, ржмрж╛рж╣ржи
ЁЯЪб => ЁЯЪб, ржХрзЗржмрж▓ ржХрж╛рз░, ржмрж╛рзЯржмрзАрзЯ рз░рзЗрж▓рз▒рзЗ, рз░рзЛржкрз▒рзЗ, ржмрж╛рзЯржмрзАрзЯ, ржЯрзНрз░рж╛ржорз▒рзЗ, ржЧржгрзНржбрзЛрж▓рж╛, ржмрж╛рж╣ржи
ЁЯЪА => ЁЯЪА, рз░ржХрзЗржЯ, ржмрж╛рж╣ржи
ЁЯЪк => ЁЯЪк, ржжрзБрз▒рж╛рз░
ЁЯЪ╜ => ЁЯЪ╜, рж╢рзМржЪрж╛ржЧрж╛рз░
ЁЯЪ┐ => ЁЯЪ┐, рж╢рзНржмрж╛рз▒рж╛рз░
ЁЯЫА => ЁЯЫА, ржмрж╛рже
ЁЯЫБ => ЁЯЫБ, ржмрж╛рже ржЯрж╛ржм
тМЫ => тМЫ, ржмрж╛рж▓рж┐ржШрзЬрзА, ржмрж╛рж▓рж┐
тП│ => тП│, ржмрж╛рж▓рж┐ ржЯрж╛ржЗржорж╛рз░, ржмрж╛рж▓рж┐рз░ ржШржгрзНржЯрж╛ржШрзЬрзА, ржмрж╛рж▓рж┐ржШрзЬрзА, ржЯрж╛ржЗржорж╛рз░
тМЪ => тМЪ, рж╣рж╛рждржШрзЬрзА, ржШрзЬрзА
тП░ => тП░, ржПрж▓рж╛рз░рзНржо ржШрзЬрзА, ржПрж▓рж╛рз░рзНржо, ржШрзЬрзА
ЁЯХЫ => ЁЯХЫ, 12 ржмржЬрж╛, ржШрзЬрзА, 12:00
ЁЯХз => ЁЯХз, ржмрж╛рз░ ржмрж╛ржЬрж┐ рждрзНрз░рж┐рж╢ ржорж┐ржирж┐ржЯ, ржШрзЬрзА, 12:30
ЁЯХР => ЁЯХР, 1 ржмржЬрж╛, ржШрзЬрзА, 1:00
ЁЯХЬ => ЁЯХЬ, ржбрзЗрз░ ржмржЬрж╛, ржШрзЬрзА, 1:30
ЁЯХС => ЁЯХС, 2 ржмржЬрж╛, ржШрзЬрзА, 2:00
ЁЯХЭ => ЁЯХЭ, ржЖрзЭрзИ ржмржЬрж╛, ржШрзЬрзА, 2:30
ЁЯХТ => ЁЯХТ, 3 ржмржЬрж╛, ржШрзЬрзА, 3:00
ЁЯХЮ => ЁЯХЮ, рждрж┐ржирж┐ ржмрж╛ржЬрж┐ рждрзНрз░рж┐рж╢ ржорж┐ржирж┐ржЯ, ржШрзЬрзА, 3:30
ЁЯХУ => ЁЯХУ, 4 ржмржЬрж╛, ржШрзЬрзА, 4:00
ЁЯХЯ => ЁЯХЯ, ржЪрж╛рз░рж┐ ржмрж╛ржЬрж┐ рждрзНрз░рж┐рж╢ ржорж┐ржирж┐ржЯ, ржШрзЬрзА, 4:30
ЁЯХФ => ЁЯХФ, 5 ржмржЬрж╛, ржШрзЬрзА, 5:00
ЁЯХа => ЁЯХа, ржкрж╛ржБржЪ ржмрж╛ржЬрж┐ рждрзНрз░рж┐рж╢ ржорж┐ржирж┐ржЯ, ржШрзЬрзА, 5:30
ЁЯХХ => ЁЯХХ, 6 ржмржЬрж╛, ржШрзЬрзА, 6:00
ЁЯХб => ЁЯХб, ржЫрзЯ ржмрж╛ржЬрж┐ рждрзНрз░рж┐рж╢ ржорж┐ржирж┐ржЯ, ржШрзЬрзА, 6:30
ЁЯХЦ => ЁЯХЦ, 7 ржмржЬрж╛, ржШрзЬрзА, 7:00
ЁЯХв => ЁЯХв, рж╕рж╛ржд ржмрж╛ржЬрж┐ рждрзНрз░рж┐рж╢ ржорж┐ржирж┐ржЯ, ржШрзЬрзА, 7:30
ЁЯХЧ => ЁЯХЧ, 8 ржмржЬрж╛, ржШрзЬрзА, 8:00
ЁЯХг => ЁЯХг, ржЖржа ржмрж╛ржЬрж┐ рждрзНрз░рж┐рж╢ ржорж┐ржирж┐ржЯ, ржШрзЬрзА, 8:30
ЁЯХШ => ЁЯХШ, 9 ржмржЬрж╛, ржШрзЬрзА, 9:00
ЁЯХд => ЁЯХд, ржи ржмрж╛ржЬрж┐ рждрзНрз░рж┐рж╢ ржорж┐ржирж┐ржЯ, ржШрзЬрзА, 9:30
ЁЯХЩ => ЁЯХЩ, 10 ржмржЬрж╛, ржШрзЬрзА, 10:00
ЁЯХе => ЁЯХе, ржжрж╣ ржмрж╛ржЬрж┐ рждрзНрз░рж┐рж╢ ржорж┐ржирж┐ржЯ, ржШрзЬрзА, 10:30
ЁЯХЪ => ЁЯХЪ, 11 ржмржЬрж╛, ржШрзЬрзА, 11:00
ЁЯХж => ЁЯХж, ржПржШрж╛рз░ ржмрж╛ржЬрж┐ рждрзНрз░рж┐рж╢ ржорж┐ржирж┐ржЯ, ржШрзЬрзА, 11:30
ЁЯМС => ЁЯМС, ржирждрзБржи ржЪржирзНржжрзНрз░, ржЕржорж╛рз▒рж╕рзНржпрж╛рз░ ржЪржирзНржжрзНрз░, ржЕржорж╛рз▒рж╕рзНржпрж╛, ржирждрзБржи, ржЪржирзНржжрзНрз░
ЁЯМТ => ЁЯМТ, ржЕрз░рзНржзржЪржирзНржжрзНрз░, ржЕрз░рзНржз, ржмрз░рзНржжрзНржзрж┐ржд ржЪржирзНржжрзНрз░, ржмрз░рзНржжрзНржзрж┐ржд, ржЪржирзНржжрзНрз░
ЁЯМУ => ЁЯМУ, ржЕрз░рзНржзржЪржирзНржжрзНрз░, ржкрзНрз░ржержо ржЕрз░рзНржз ржЪржирзНржжрзНрз░, ржЪржирзНржжрзНрз░, ржЕрз░рзНржз
ЁЯМФ => ЁЯМФ, ржмрз░рзНржжрзНржзрж┐ржд ржЪржирзНржжрзНрз░, ржмрз░рзНржжрзНржзрж┐ржд, ржжрзБрз░рж╛ржкрж┐ржарж┐рзЯрж╛ ржЪржирзНржжрзНрз░, ржжрзБрз░рж╛ржкрж┐ржарж┐рзЯрж╛, ржЪржирзНржжрзНрз░
ЁЯМХ => ЁЯМХ, ржкрзВрз░рзНржгрж┐ржорж╛рз░ ржЬрзЛржи, ржкрзВрз░рзНржгрж┐ржорж╛, ржЙржЬрзНржЬрзНржмрж▓ ржЪржирзНржжрзНрз░, ржЙржЬрзНржЬрзНржмрж▓, ржЪржирзНржжрзНрз░
ЁЯМЦ => ЁЯМЦ, ржирж┐рж╕рзНрждрзЗржЬ ржЪржирзНржжрзНрз░, ржирж┐рж╕рзНрждрзЗржЬ, ржжрзБрз░рж╛ржкрж┐ржарж┐рзЯрж╛ ржЪржирзНржжрзНрз░, ржжрзБрз░рж╛ржкрж┐ржарж┐рзЯрж╛, ржЪржирзНржжрзНрз░
ЁЯМЧ => ЁЯМЧ, ржЕрз░рзНржз ржЪржирзНржжрзНрз░, ржЕрз░рзНржз, ржЕржирзНрждрж┐ржо ржЕрз░рзНржз ржЪржирзНржжрзНрз░, ржЪржирзНржжрзНрз░
ЁЯМШ => ЁЯМШ, ржХрж╛ржБржЪрж┐ржЬрзЛржи, ржХрж╛ржБржЪрж┐, ржирж┐рж╕рзНрждрзЗржЬ ржЪржирзНржжрзНрз░, ржирж┐рж╕рзНрждрзЗржЬ, ржЪржирзНржжрзНрз░
ЁЯМЩ => ЁЯМЩ, ржХрж╛ржБржЪрж┐ржЬрзЛржи, ржХрж╛ржБржЪрж┐, ржЪржирзНржжрзНрз░
ЁЯМЪ => ЁЯМЪ, ржирждрзБржи ржЪржирзНржжрзНрз░ ржорзБржЦ, ржирждрзБржи ржЪржирзНржжрзНрз░, ржорзБржЦ рж╕рж╣ ржирждрзБржи ржЪржирзНржжрзНрз░, ржЪржирзНржжрзНрз░, ржорзБржЦ
ЁЯМЫ => ЁЯМЫ, ржЕрз░рзНржз ржЪржирзНржжрзНрз░, ржПржЦржи ржорзБржЦ рж╕рж╣ ржЕрз░рзНржз ржЪржирзНржжрзНрз░, ржПржЦржи ржорзБржЦ рж╕рж╣ ржЪржирзНржжрзНрз░, ржЪржирзНржжрзНрз░, ржорзБржЦ
ЁЯМЬ => ЁЯМЬ, ржЕрз░рзНржз ржЪржирзНржжрзНрз░рз░ ржорзБржЦ, ржПржЦржи ржорзБржЦ рж╕рж╣ ржЕрз░рзНржз ржЪржирзНржжрзНрз░, ржПржЦржи ржорзБржЦ рж╕рж╣ ржЪржирзНржжрзНрз░, ржЕржирзНрждрж┐ржо ржЕрз░рзНржз ржЪржирзНржжрзНрз░, ржЕрз░рзНржз ржЪржирзНржжрзНрз░, ржЪржирзНржжрзНрз░, ржорзБржЦ
ЁЯМЭ => ЁЯМЭ, ржкрзВрз░рзНржг ржЪржирзНржжрзНрз░ ржорзБржЦ, ржПржЦржи ржорзБржЦ рж╕рж╣ ржкрзВрз░рзНржг ржЪржирзНржжрзНрз░, ржПржЦржи ржорзБржЦ рж╕рж╣ ржЪржирзНржжрзНрз░, ржкрзВрз░рзНржг ржЪржирзНржжрзНрз░, ржкрзВрз░рзНржг, ржЪржирзНржжрзНрз░, ржорзБржЦ
ЁЯМЮ => ЁЯМЮ, рж╕рзВрз░рзНржп ржорзБржЦ, рж╕рзВрз░рзНржп, ржорзБржЦ
ЁЯМЯ => ЁЯМЯ, ржЬрж┐рж▓рж┐ржХрж┐ ржержХрж╛ рждрз░рж╛, ржЬрж┐рж▓рж┐ржХрж╛, ржЙржЬрзНржЬрзНржмрж▓рж┐ржд, ржжрзАржкрзНржд, рждрз░рж╛
ЁЯМа => ЁЯМа, ржкржкрзАрзЯрж╛ рждрз░рж╛, ржкржкрзАрзЯрж╛, ржЦрж╣рж┐ ржкрз░рж╛ рждрз░рж╛, ржЦрж╣рж┐ ржкрз░рж╛, рждрз░рж╛
тШБ => тШБ, ржбрж╛рз▒рз░, ржмрждрз░
тЫЕ => тЫЕ, ржбрж╛рз▒рз░рз░ ржкрж┐ржЫржлрж╛рж▓рзЗ рж╕рзВрз░рзНржпрзНржп, ржбрж╛рз▒рз░рз░ рж╕рзИрждрзЗ рж╕рзВрз░рзНржпрзНржп, рж╕рзВрз░рзНржпрзНржп, ржбрж╛рз▒рз░
ЁЯМА => ЁЯМА, ржзрзБржорзБрж╣рж╛, ржзрзБржорзБрж╣рж╛-ржмрждрж╛рж╣, ржШрзВрз░рзНржгрзА ржмрждрж╛рж╣, ржЖржЪржирзНржжрзНрз░рж╛ржЗ
ЁЯМИ => ЁЯМИ, рз░рж╛ржоржзрзЗржирзБ
ЁЯМВ => ЁЯМВ, ржЫржБрждрж┐, ржмрз░рж╖рзБржг, ржмрзГрж╖рзНржЯрж┐ржкрж╛ржд
тЪб => тЪб, ржЙржЪрзНржЪ ржнтАЩрж▓рзНржЯрзЗржЬ, ржЙржЪрзНржЪ ржнтАЩрж▓рзНржЯрзЗржЬ ржмрж┐ржкржж, ржЙржЪрзНржЪ ржнтАЩрж▓рзНржЯрзЗржЬ ржЪрж┐рж╣рзНржи, ржмрж┐ржкржж, ржЙржЪрзНржЪ, ржнтАЩрж▓рзНржЯрзЗржЬ, ржЪрж┐рж╣рзНржи
тЫД => тЫД, рждрзБрж╖рж╛рз░ ржорж╛ржирз▒, рждрзБрж╖рж╛рз░ ржЕржмрж┐рж╣ржирзЗ рждрзБрж╖рж╛рз░ ржорж╛ржирз▒, рждрзБрж╖рж╛рз░
ЁЯФе => ЁЯФе, ржЬрзБржЗ, рж╢рж┐ржЦрж╛
ЁЯТз => ЁЯТз, ржарж╛ржгрзНржбрж╛ ржШрж╛ржо, ржШрж╛ржо, ржШрж╛ржорз░ ржЯрзЛржкрж╛рж▓
ЁЯМК => ЁЯМК, ржврзМ, рж╕рж╛ржЧрз░рз░ ржврзМ, ржкрж╛ржирзАрз░ ржврзМ
ЁЯОГ => ЁЯОГ, рз░ржЩрж╛рж▓рж╛ржУ, ржЬрзЗржХ, рж╣рзЗрж▓рзЛрз▒рзАржи, ржЙржжржпрж╛ржкржи
ЁЯОД => ЁЯОД, ржЦрзНрз░рзАрж╖рзНржЯржорж╛ржЪ ржЧржЫ, ржЧржЫ, ржЙржжржпрж╛ржкржи
ЁЯОЖ => ЁЯОЖ, ржЖрждржЪржмрж╛ржЬрзА, ржЙржжржпрж╛ржкржи
ЁЯОЗ => ЁЯОЗ, ржлржЯржХрж╛, ржлрзБрж▓ржЬрз░рж┐, ржЖрждржЪржмрж╛ржЬрзА, ржЙржжржпрж╛ржкржи
тЬи => тЬи, рждрж┐рз░ржмрж┐рз░рзЛрз▒рж╛, рждрж┐рз░ржмрж┐рз░рж╛ржЗ ржержХрж╛ рждрз░рж╛, рждрж┐рз░ржмрж┐рз░рж╛ржЗ ржержХрж╛, рждрз░рж╛
ЁЯОИ => ЁЯОИ, ржмрзЗрж▓рзБржи, ржЙржжржпрж╛ржкржи
ЁЯОЙ => ЁЯОЙ, ржкрж╛рз░рзНржЯрзА ржкржкрж╛рз░, ржкрж╛рз░рзНржЯрзА, ржЙржжржпрж╛ржкржи
ЁЯОК => ЁЯОК, ржХржиржлрзЗржЯрж┐, ржХржиржлрзЗржЯрж┐ ржмрж▓, ржЙржжржпрж╛ржкржи
ЁЯОЛ => ЁЯОЛ, ржЧржЫ ржЖрз░рзБ ржХрж╛ржЧржЬрз░ ржкржЯрж┐, рждрз░рж╛ ржЙрзОрж╕рз▒, ржЧржЫ, ржХрж╛ржЧржЬрз░ ржкржЯрж┐, ржЙржжржпрж╛ржкржи
ЁЯОМ => ЁЯОМ, ржХржЯрж╛ржХржЯрж┐ ржХрз░рж╛ ржкрждрж╛ржХрж╛, ржЬрж╛ржкрж╛ржирз░ ржХржЯрж╛ржХржЯрж┐ ржХрз░рж╛ ржкрждрж╛ржХрж╛, ржХржЯрж╛ржХржЯрж┐, ржкрждрж╛ржХрж╛, ржЙржжржпрж╛ржкржи
ЁЯОН => ЁЯОН, ржкрж╛ржЗржи рж╕рж╛ржЬ-рж╕ржЬрзНржЬрж╛, ржирждрзБржи ржмржЫрз░, ржЬрж╛ржкрж╛ржирзА, ржкрж╛ржЗржи, ржЙржжржпрж╛ржкржи
ЁЯОО => ЁЯОО, ржкрзБрждрж▓рж╛, ржкрзБрждрж▓рж╛рз░ ржЙрзОрж╕рз▒, ржЙрзОрж╕рз▒, ржЬрж╛ржкрж╛ржирзА, ржЙржжржпрж╛ржкржи
ЁЯОП => ЁЯОП, ржХрж╛рз░рзНржк рж╖рзНржЯрзНрз░рж┐ржорж╛рз░, рж╖рзНржЯрзНрз░рж┐ржорж╛рз░, ржЙржжржпрж╛ржкржи
ЁЯОР => ЁЯОР, рз▒рж┐ржгрзНржб ржЪрж╛ржЗржо, ржЪрж╛ржЗржо, ржЭржВржХрж╛рз░, ржмрждрж╛рж╣рз░ ржЭржВржХрж╛рз░
ЁЯОС => ЁЯОС, ржЪржирзНржжрзНрз░ ржжрз░рзНрж╢ржи, ржЪржирзНржжрзНрз░ ржжрз░рзНрж╢ржи ржЙрзОрж╕рз▒
ЁЯОА => ЁЯОА, рз░рж┐ржмржи, ржЙржжржпрж╛ржкржи
ЁЯОБ => ЁЯОБ, ржЙржкрж╣рж╛рз░, ржорзЗрз░рж┐ржУрз▒рж╛ ржЙржкрж╣рж╛рз░, ржЙржжржпрж╛ржкржи
ЁЯОл => ЁЯОл, ржЯрж┐ржХрзЗржЯ, ржоржирзЛрз░ржЮрзНржЬржи
тЪ╜ => тЪ╜, ржлрзБржЯржмрж▓рз░ ржмрж▓, ржлрзБржЯржмрж▓, ржмрж▓
тЪ╛ => тЪ╛, ржмрзЗржЫржмрж▓
ЁЯПА => ЁЯПА, ржмрж╛рж╕рзНржХрзЗржЯржмрж▓, ржмрж╛рж╕рзНржХрзЗржЯржмрж▓ ржЦрзЗрж▓
ЁЯПИ => ЁЯПИ, ржЖржорзЗрз░рж┐ржХрж╛ржи ржлрзБржЯржмрж▓, ржмрж▓, ржЦрзЗрж▓
ЁЯПЙ => ЁЯПЙ, рз░рж╛ржЧржмрзА ржлрзБржЯржмрж▓, рз░рж╛ржЧржмрзАрз░ ржмрж▓, ржмрж▓, ржЦрзЗрж▓
ЁЯО╛ => ЁЯО╛, ржЯрзЗржирж┐ржЪ, ржЯрзЗржирж┐ржЪ ржмрж▓, ржЯрзЗржирж┐ржЪ рз░рзЗржХрзЗржЯ ржЖрз░рзБ ржмрж▓, ржмрж▓, ржХрзНрз░рзАрзЬрж╛
ЁЯО▒ => ЁЯО▒, ржмрж┐рж▓рж┐рзЯрж╛рз░рзНржб, ржЖржаржЯрж╛ ржмрж▓, ржЦрзЗрж▓
ЁЯО│ => ЁЯО│, ржмрзЛржЙрж▓рж┐ржВ, ржмрзМрж▓рж┐ржВ, ржмрж▓, ржЧрзЗржо
тЫ│ => тЫ│, ржлрзНрж▓рзЗржЧ ржЗржи рж╣рзЛрж▓, ржЧтАЩрж▓рзНржл, ржЧтАЩрж▓рзНржл ржлрзНрж▓рзЗржЧ, рж╣рзЛрж▓
ЁЯОг => ЁЯОг, ржорж╛ржЫ ржзрз░рж╛, ржмрз░рж╢рж┐ ржмрзЛрз▒рж╛, ржмрз░рж╢рж┐ ржЖрз░рзБ ржорж╛ржЫ, ржмрз░рж╢рж┐, ржорж╛ржЫ, ржоржирзЛрз░ржЮрзНржЬржи
ЁЯО╜ => ЁЯО╜, ржжрзМрз░рж╛ ржЪрж╛рз░рзНржЯ, рж╢рзНржмрзЗржЫ рж╕рж╣ ржжрзМрз░рж╛ ржЪрж╛рз░рзНржЯ, ржжрзМрз░рж╛, ржЪрж╛рз░рзНржЯ, рж╢рзНржмрзЗржЫ, ржХрзНрз░рзАрзЬрж╛
ЁЯО┐ => ЁЯО┐, рж╕рзНржХрж┐, рж╕рзНржХрж┐ ржЖрз░рзБ ржмрзБржЯ, ржмрзБржЯ, ржХрзНрз░рзАрзЬрж╛
ЁЯПВ => ЁЯПВ, рж╢рзНржи'ржмрз░рзНржбрж╛рз░, рж╢рзНржи'ржмрз░рзНржбрж┐ржВ, рж╢рзНржи'ржмрз░рзНржб
ЁЯПД => ЁЯПД, ржЪрж╛рз░рзНржлрж┐ржВ, ржЪрж╛рз░рзНржлрж╛рз░, ржЦрзЗрж▓
ЁЯПЗ => ЁЯПЗ, ржШрзЛржБрз░рж╛ ржжрзМрз░, ржШрзЛржБрз░рж╛, ржЦрзЗрж▓
ЁЯПК => ЁЯПК, рж╕рж╛ржБрждрзЛрз░ржмрж┐ржж, рж╕рж╛ржБрждрзЛрз░, ржЦрзЗрж▓
ЁЯЪ┤ => ЁЯЪ┤, ржмрж╛ржЗржЪрж╛ржЗржХрзЗрж▓ ржЪрж╛рж▓ржХ, ржЪрж╛ржЗржХрзЗрж▓ ржЪрж╛рж▓ржХ, ржмрж╛ржЗржХ
ЁЯЪ╡ => ЁЯЪ╡, ржкрз░рзНржмрждрзАрзЯрж╛ ржмрж╛ржЗржЪрж╛ржЗржХрзЗрж▓ ржЪрж╛рж▓ржХ, ржмрж╛ржЗржХ, ржЪрж╛ржЗржХрзЗрж▓ ржЪрж╛рж▓ржХ, ржкрз░рзНржмржд
ЁЯПЖ => ЁЯПЖ, ржЯрзНрз░'ржлрж┐, ржкрзБрз░рж╖рзНржХрж╛рз░
ЁЯОп => ЁЯОп, рж▓ржХрзНрж╖рзНржп, ржкрзНрз░рждржХрзНрж╖рзНржп рж▓ржХрзНрж╖рзНржпржнрзЗржж, рж╕ржарж┐ржХ рж▓ржХрзНрж╖рзНржпржнрзЗржж, ржнрзЗржж, ржЦрзЗрж▓
ЁЯОо => ЁЯОо, ржнрж┐ржбрж┐ржЕ' ржЧрзЗржо, ржЧрзЗржо ржХржгрзНржЯрзНрз░'рж▓рж╛рз░, ржЧрзЗржо
ЁЯО▓ => ЁЯО▓, ржбрж╛ржЗржЪ, ржкрж╛рж╢рж╛, ржЦрзЗрж▓
ЁЯГП => ЁЯГП, ржЬ'ржХрж╛рз░ ржХрж╛рз░рзНржб, ржЬ'ржХрж╛рз░, рждрж╛ржЪ ржкрж╛ржд, рждрж╛ржЪ
ЁЯАД => ЁЯАД, ржорж╛рж╣ржЬржВ ржЯрж╛ржЗрж▓, рз░ржЩрж╛ ржбрзНрз░рзЗржЧржи, ржбрзНрз░рзЗржЧржи, ржорж╛рж╣ржЬржВ, ржЯрж╛ржЗрж▓
ЁЯО┤ => ЁЯО┤, рждрж╛ржЪ ржкрж╛ржд, ржлрзБрж▓рж╛ржо ржХрж╛рз░рзНржб, ржлрзБрж▓, рждрж╛ржЪ ржЦрзЗрж▓, ржЦрзЗрж▓, рж╣рж╛ржирж╛ржлрзБрзЬрж╛
ЁЯФЗ => ЁЯФЗ, ржирж┐рж╢ржмрзНржж, ржХржерж╛ ржиржХтАЩржм, рж╢ржмрзНржж ржиржХрз░рж┐ржм, ржмрж╛рждрж┐рж▓ ржЪрж┐рж╣рзНржи рж╕рж╣ рж╕рзНржкрзАржХрж╛рз░
ЁЯФИ => ЁЯФИ, рж╕рзНржкрзАржХрж╛рз░, рж▓рж╛ржЙржбрж╕рзНржкрзАржХрж╛рз░
ЁЯФЙ => ЁЯФЙ, рж╕рзНржкрзАржХрж╛рз░, ржирж┐ржорзНржи ржнрж▓рж┐ржЙржо, ржирж┐ржорзНржи ржнрж▓рж┐ржЙржо рж╕рж╣ рж╕рзНржкрзАржХрж╛рз░
ЁЯФК => ЁЯФК, рж╕рзНржкрзАржХрж╛рз░, ржЙржЪрзНржЪ ржнрж▓рж┐ржЙржо, ржЙржЪрзНржЪ ржнрж▓рж┐ржЙржо рж╕рж╣ рж╕рзНржкрзАржХрж╛рз░
ЁЯУв => ЁЯУв, рж▓рж╛ржЙржбрж╕рзНржкрзАржХрж╛рз░, рз░рж╛ржЬрж╣рзБрз▒рж╛ ржШрзЛрж╖ржгрж╛, рж╣рж╛ржд рж╕рзНржкрзАржХрж╛рз░, ржпрзЛржЧрж╛ржпрзЛржЧ
ЁЯУг => ЁЯУг, ржорзЗржЧрж╛ржлрзЛржи, ржпрзЛржЧрж╛ржпрзЛржЧ
ЁЯУп => ЁЯУп, ржкрзЛрж╖рзНржЯрзЗрж▓ рж╣рз░рзНржг, рж╣рз░рзНржг
ЁЯФФ => ЁЯФФ, ржШржгрзНржЯрж╛, ржЧрзАрз░рзНржЬрж╛
ЁЯФХ => ЁЯФХ, ржШржгрзНржЯрж╛ ржирж╛ржЗ, рж╢ржмрзНржж ржирж╛ржЗ, ржмрж╛рждрж┐рж▓ ржЪрж┐рж╣рзНржи рж╕рж╣ ржШржгрзНржЯрж╛, ржШржгрзНржЯрж╛
ЁЯО╝ => ЁЯО╝, рж╕ржЩрзНржЧрзАрждрз░ рж╕рзНржХ'рз░, рж╕ржЩрзНржЧрзАржд
ЁЯО╡ => ЁЯО╡, рж╕ржЩрзНржЧрзАрждрз░ рж╕рзБрз░, рж╕ржЩрзНржЧрзАржд, рж╕рзБрз░
ЁЯО╢ => ЁЯО╢, ржПржХрж╛ржзрж┐ржХ рж╕ржЩрзНржЧрзАрждрз░ рж╕рзБрз░, рж╕ржЩрзНржЧрзАржд, рж╕рзБрз░
ЁЯОд => ЁЯОд, ржорж╛ржЗржХ, ржорж╛ржЗржХрзНрз░'ржлрзЛржи, ржХрж╛рз░рж╛ржУржХрзЗ, ржоржирзЛрз░ржЮрзНржЬржи
ЁЯОз => ЁЯОз, рж╣рзЗржбржлрзЛржи, ржоржирзЛрз░ржЮрзНржЬржи
ЁЯО╖ => ЁЯО╖, ржЪрзЗржХрзНрж╕рж╛ржлрзЛржи, ржмрж╛ржжрзНржпржпржирзНрждрзНрз░, рж╕ржЩрзНржЧрзАржд
ЁЯО╕ => ЁЯО╕, ржЧрж┐ржЯрж╛рз░, ржмрж╛ржжрзНржпржпржирзНрждрзНрз░, рж╕ржЩрзНржЧрзАржд
ЁЯО╣ => ЁЯО╣, ржкрж┐рзЯрж╛ржирзЛ, рж╕ржЩрзНржЧрзАржд, ржХрзАржмрзЛрз░рзНржб, ржмрж╛ржжрзНржпржпржирзНрждрзНрз░
ЁЯО║ => ЁЯО║, ржЯрзНрз░рж╛ржорзНржкрзЗржЯ, рж╕ржЩрзНржЧрзАржд ржмрж╛ржжрзНржп, рж╕ржЩрзНржЧрзАржд, ржмрж╛ржжрзНржпржпржирзНрждрзНрз░
ЁЯО╗ => ЁЯО╗, ржнрж╛рзЯрзЛрж▓рж┐ржи, рж╕ржЩрзНржЧрзАржд, ржмрж╛ржжрзНржпржпржирзНрждрзНрз░
ЁЯУ╗ => ЁЯУ╗, рз░рзЗржбрж┐ржЕтАЩ
ЁЯУ▒ => ЁЯУ▒, ржЪрзЗрж▓ ржлрзЛржи, ржорзЛржмрж╛ржЗрж▓ ржлрзЛржи, ржлрзЛржи
ЁЯУ▓ => ЁЯУ▓, ржХрж╛рзЬ ржЪрж┐ржи рж╕рж╣ ржЪрзЗрж▓ ржлрзЛржи, ржлрзЛржи ржХрз░рж╛, ржорзЛржмрж╛ржЗрж▓ ржлрзЛржи, ржлрзЛржи
ЁЯУЮ => ЁЯУЮ, ржлрзЛржи, ржЯрзЗрж▓рж┐ржлрзЛржи, ржлрзЛржи рз░рж┐ржЪрж┐ржнрж╛рз░, ржпрзЛржЧрж╛ржпрзЛржЧ
ЁЯУЯ => ЁЯУЯ, ржкрзЗржЬрж╛рз░, ржпрзЛржЧрж╛ржпрзЛржЧ
ЁЯУа => ЁЯУа, ржлрзЗржХрзНрж╕, ржлрзЗржХрзНрж╕ ржпржирзНрждрзНрз░, ржпрзЛржЧрж╛ржпрзЛржЧ
ЁЯФЛ => ЁЯФЛ, ржмрзЗржЯрж╛рз░рж┐
ЁЯФМ => ЁЯФМ, ржмрзИржжрзНржпрзБрждрж┐ржХ ржкрзНрж▓рж╛ржЧ, ржмрж┐ржжрзНржпрзБрзО
ЁЯТ╗ => ЁЯТ╗, ржкрж┐ржЪрж┐, ржкрж╛рз░рзНржЪржирзЗрж▓ ржХржорзНржкрж┐ржЙржЯрж╛рз░, ржХржорзНржкрж┐ржЙржЯрж╛рз░
ЁЯТ╜ => ЁЯТ╜, ржорж┐ржирж┐ ржбрж┐рж╕рзНржХ, ржбрж┐рж╕рзНржХ
ЁЯТ╛ => ЁЯТ╛, ржлрзНрж▓ржкрзА ржбрж┐рж╕рзНржХ, ржлрзНрж▓ржкрзА, ржбрж┐рж╕рзНржХ
ЁЯТ┐ => ЁЯТ┐, ржмрзНрж▓рзБ-рз░рзЗ, ржбрж┐ржнрж┐ржбрж┐, ржЪрж┐ржбрж┐, ржЕржкрзНржЯрж┐ржХрзЗрж▓ ржбрж┐рж╕рзНржХ, ржбрж┐рж╕рзНржХ
ЁЯУА => ЁЯУА, ржбрж┐ржнрж┐ржбрж┐, ржбрж┐ржнрж┐ржбрж┐ ржбрж┐рж╕рзНржХ, ржбрж┐рж╕рзНржХ
ЁЯОе => ЁЯОе, ржХрзЗржорзЗрз░рж╛, ржЪрж▓ржЪрж┐рждрзНрз░рз░ ржХрзЗржорзЗрз░рж╛, ржЪрж┐ржирзЗржорж╛, ржоржирзЛрз░ржЮрзНржЬржи
ЁЯОм => ЁЯОм, ржХрзНрж▓рзЗржкрж╛рз░ржмрзЛрз░рзНржб, ржХрзНрж▓рзЗржкрж╛рз░, ржЪрж▓ржЪрж┐рждрзНрз░, ржоржирзЛрз░ржЮрзНржЬржи
ЁЯУ║ => ЁЯУ║, ржЯрж┐ржнрж┐, ржЯрзЗрж▓рж┐ржнрж┐ржЫржи
ЁЯУ╖ => ЁЯУ╖, ржХрзЗржорзЗрз░рж╛
ЁЯУ╣ => ЁЯУ╣, ржнрж┐ржбрж┐ржЕтАЩ ржХрзЗржорзЗрз░рж╛, ржХрзЗржорзЗрз░рж╛, ржнрж┐ржбрж┐ржЕтАЩ
ЁЯУ╝ => ЁЯУ╝, ржнрж┐ржбрж┐ржЕтАЩ ржХрзЗржЫрзЗржЯ, ржнрж┐ржбрж┐ржЕтАЩ, ржХрзЗржЫрзЗржЯ
ЁЯФН => ЁЯФН, ржорзЗржЧржирж┐ржлрж╛рзЯрж┐ржВ ржЧрзНрж▓рж╛ржЫ, рж╕ржирзНржзрж╛ржи, ржмрж╛ржУржБ ржорзБржЦрзА ржорзЗржЧржирж┐ржлрж╛рзЯрж┐ржВ ржЧрзНрж▓рж╛ржЫ
ЁЯФО => ЁЯФО, ржорзЗржЧржирж┐ржлрж╛рзЯрж┐ржВ ржЧрзНрж▓рж╛ржЫ, рж╕ржирзНржзрж╛ржи, рж╕рзЛржБ ржорзБржЦрзА ржорзЗржЧржирж┐ржлрж╛рзЯрж┐ржВ ржЧрзНрж▓рж╛ржЫ
ЁЯФм => ЁЯФм, ржорж╛ржЗржХрзНрз░тАЩрж╕рзНржХржк, ржЕржирзБржмрзАржХрзНрж╖ржг ржпржирзНрждрзНрз░
ЁЯФн => ЁЯФн, ржЯрзЗрж▓рж┐рж╕рзНржХрзЛржк, ржжрзВрз░ржмрзАржХрзНрж╖ржг ржпржирзНрждрзНрз░
ЁЯУб => ЁЯУб, ржЙржкржЧрзНрз░рж╣ ржбрж┐ржЫ, ржЙржкржЧрзНрз░рж╣ ржПржгрзНржЯрзЗржирж╛, ржПржгрзНржЯрзЗржирж╛, ржпрзЛржЧрж╛ржпрзЛржЧ
ЁЯТб => ЁЯТб, ржмрж╛рж▓рзНржм, ржоржирж▓рзИ ржзрж╛рз░ржгрж╛ ржПржЯрж╛ ржЖрж╣рж┐ржЫрзЗ, ржмрж┐ржжрзНржпрзБрждрзНтАН
ЁЯФж => ЁЯФж, ржлрзНрж▓рж╛ржЫрж▓рж╛ржЗржЯ, ржЯрз░рзНржЪ
ЁЯПо => ЁЯПо, рз░ржЩрж╛ рж▓рзЗржорзНржк, рж▓рзЗржорзНржк, ржмрж╛рз░, рз░рзЗрж╖рзНржЯрзБрз░рзЗржгрзНржЯ
ЁЯУФ => ЁЯУФ, ржЕрж▓ржВржХрзГржд ржЯрзЛржХрж╛ржмрж╣рзА, рж╕ржЬрзЛрз▒рж╛ ржЯрзЛржХрж╛ржмрж╣рзА, ржЯрзЛржХрж╛ржмрж╣рзА, ржмрзЗржЯрзБржкрж╛ржд
ЁЯУХ => ЁЯУХ, ржмржирзНржз ржХрж┐рждрж╛ржк, ржХрж┐рждрж╛ржк
ЁЯУЦ => ЁЯУЦ, ржЦрзЛрж▓рж╛ ржХрж┐рждрж╛ржк, ржХрж┐рждрж╛ржк
ЁЯУЧ => ЁЯУЧ, рж╕рзЗржЙржЬрзАрзЯрж╛ ржХрж┐рждрж╛ржк, ржХрж┐рждрж╛ржк
ЁЯУШ => ЁЯУШ, ржирзАрж▓рж╛ ржХрж┐рждрж╛ржк, ржХрж┐рждрж╛ржк
ЁЯУЩ => ЁЯУЩ, ржХржорж▓рж╛ ржХрж┐рждрж╛ржк, ржХрж┐рждрж╛ржк
ЁЯУЪ => ЁЯУЪ, ржХрж┐рждрж╛ржкрз░ ржарж╛ржХ, ржХрж┐рждрж╛ржк
ЁЯУУ => ЁЯУУ, ржЯрзЛржХрж╛ржмрж╣рзА
ЁЯУТ => ЁЯУТ, рж▓рзЗржЬрж╛рз░, ржЯрзЛржХрж╛ржмрж╣рзА
ЁЯУГ => ЁЯУГ, ржбржХрзБржорзЗржгрзНржЯ, ржнрж╛ржБржЬ рж╕рж╣ ржкрзГрж╖рзНржарж╛, ржкрзГрж╖рзНржарж╛
ЁЯУЬ => ЁЯУЬ, рж╕рзНржХрзНрз░рзЛрж▓, ржХрж╛ржЧржЬрз░ рж╕рзНржХрзНрз░рзЛрж▓
ЁЯУД => ЁЯУД, ржбржХрзБржорзЗржгрзНржЯ, рж╕ржирзНржорзБржЦрж▓рзИ ржорзБржЦ ржХрз░рж╛ ржкрзГрж╖рзНржарж╛, ржкрзГрж╖рзНржарж╛
ЁЯУ░ => ЁЯУ░, ржмрж╛рждрз░рж┐ржХрж╛ржХржд, ржмрж╛рждрз░рж┐
ЁЯУС => ЁЯУС, ржмрзБржХржорж╛рз░рзНржХ ржЯрзЗржм, ржЪрж┐рж╣рзНржиржХ, ржЯрзЗржм, ржмрзБржХржорж╛рз░рзНржХ
ЁЯФЦ => ЁЯФЦ, ржмрзБржХржорж╛рз░рзНржХ
ЁЯТ░ => ЁЯТ░, ржзржирз░ ржЯрзЛржкрзЛрж▓рж╛, ржзржирз░ ржмрзЗржЧ, ржзржи, ржЯржХрж╛, ржорзБржжрзНрз░рж╛, ржмрзЗржЧ
ЁЯТ┤ => ЁЯТ┤, рзЯрзЗржи ржирзЛржЯ, рзЯрзЗржи, ржЬрж╛ржкрж╛ржирзА ржорзБржжрзНрз░рж╛рз░ ржирзЛржЯ, ржзржи, ржирзЛржЯ
ЁЯТ╡ => ЁЯТ╡, ржбрж▓рж╛рз░ ржирзЛржЯ, ржмрзЗржЩрзНржХржирзЛржЯ, ржбрж▓рж╛рз░, ржзржи, ржирзЛржЯ
ЁЯТ╢ => ЁЯТ╢, ржЗржЙрз░рзЛ ржирзЛржЯ, ржЗржЙрз░рзЛ, ржмрзЗржЩрзНржХржирзЛржЯ, ржзржи, ржирзЛржЯ
ЁЯТ╖ => ЁЯТ╖, ржкрж╛ржЙржгрзНржб ржирзЛржЯ, ржкрж╛ржЙржгрзНржб, ржмрзЗржЩрзНржХржирзЛржЯ, ржзржи, ржирзЛржЯ
ЁЯТ╕ => ЁЯТ╕, ржЙрз░ржгрзАрзЯрж╛ ржзржи, ржкрж╛ржЦрж┐ рж▓ржЧрж╛ ржзржи, ржЙрз░рж┐ ржержХрж╛ ржмрзЗржЩрзНржХржирзЛржЯ, ржирзЛржЯ, ржзржи
ЁЯТ│ => ЁЯТ│, ржХрзНрз░рзЗржбрж┐ржЯ ржХрж╛рз░рзНржб, ржХрж╛рз░рзНржб
ЁЯТ╣ => ЁЯТ╣, ржмрз░рзНржзрж┐ржд ржмржЬрж╛рз░, ржЙрз░рзНржзржорзБржЦрзА ржЪрж╛рз░рзНржЯ, ржЙрз░рзНржзржорзБржЦрзА, ржЪрж╛рз░рзНржЯ, ржмржЬрж╛рз░
ЁЯУз => ЁЯУз, ржЗржорзЗржЗрж▓, ржорзЗржЗрж▓, ржкрждрзНрз░, ржпрзЛржЧрж╛ржпрзЛржЧ
ЁЯУи => ЁЯУи, ржЕржирзНрждрз░рзНржЧрж╛ржорзА ржкрждрзНрз░, ржкрзНрз░рж╛ржкрзНржд ржкрждрзНрз░, ржЕржирзНрждрз░рзНржЧрж╛ржорзА, ржкрждрзНрз░, ржорзЗржЗрж▓, ржЗржорзЗржЗрж▓, ржПржиржнрзЗрж▓ржк, ржпрзЛржЧрж╛ржпрзЛржЧ
ЁЯУй => ЁЯУй, ржмрж╣рж┐рз░рзНржЧрж╛ржорзА ржкрждрзНрз░, ржкрзНрз░рзЗрз░рж┐ржд ржкрждрзНрз░, ржмрж╣рж┐рз░рзНржЧрж╛ржорзА, ржкрждрзНрз░, ржорзЗржЗрж▓, ржЗржорзЗржЗрж▓, ржПржиржнрзЗрж▓ржк, ржпрзЛржЧрж╛ржпрзЛржЧ
ЁЯУд => ЁЯУд, ржкрзНрз░рзЗрз░рж┐ржд ржкрждрзНрз░, ржкрзНрз░рзЗрз░рж┐ржд ржмрж╛ржХржЪ, ржкрзНрз░рзЗрз░рж┐ржд, ржмрж╣рж┐рз░рзНржЧрж╛ржорзА ржмрж╛ржХржЪ, ржЯрзНрз░рзЗ, ржпрзЛржЧрж╛ржпрзЛржЧ
ЁЯУе => ЁЯУе, ржЗржиржмржХрзНрж╕, ржкрзНрз░рж╛ржкрзНржд ржкрждрзНрз░, ржкрзНрз░рж╛ржкрзНржд, ржЕржирзНрждрз░рзНржЧрж╛ржорзА ржмрж╛ржХржЪ, ржЯрзНрз░рзЗ, ржпрзЛржЧрж╛ржпрзЛржЧ
ЁЯУж => ЁЯУж, ржкрзЗржХрзЗржЯ, ржкрж╛рз░рзНржЪрзЗрж▓, ржмрж╛ржХржЪ
ЁЯУл => ЁЯУл, ржорзЗржЗрж▓ ржмрж╛ржХржЪ, ржбрж╛ржХ ржмрж╛ржХржЪ, ржЙрз░рзНржзржорзБржЦрзА ржкрждрж╛ржХрж╛ рж╕рж╣ ржорзЗржЗрж▓ ржмрж╛ржХржЪ, ржбрж╛ржХ, ржкрждрж╛ржХрж╛
ЁЯУк => ЁЯУк, ржорзЗржЗрж▓ ржмрж╛ржХржЪ, ржбрж╛ржХ ржмрж╛ржХржЪ, ржирж┐ржорзНржиржорзБржЦрзА ржкрждрж╛ржХрж╛ рж╕рж╣ ржорзЗржЗрж▓ ржмрж╛ржХржЪ, ржбрж╛ржХ, ржкрждрж╛ржХрж╛
ЁЯУм => ЁЯУм, ржорзЗржЗрж▓ ржмрж╛ржХржЪ, ржбрж╛ржХ ржмрж╛ржХржЪ, ржЙрз░рзНржзржорзБржЦрзА ржкрждрж╛ржХрж╛ рж╕рж╣ ржЦрзЛрж▓рж╛ ржорзЗржЗрж▓ ржмрж╛ржХржЪ, ржбрж╛ржХ, ржкрждрж╛ржХрж╛
ЁЯУн => ЁЯУн, ржорзЗржЗрж▓ ржмрж╛ржХржЪ, ржбрж╛ржХ ржмрж╛ржХржЪ, ржирж┐ржорзНржиржорзБржЦрзА ржкрждрж╛ржХрж╛ рж╕рж╣ ржЦрзЛрж▓рж╛ ржорзЗржЗрж▓ ржмрж╛ржХржЪ, ржбрж╛ржХ, ржкрждрж╛ржХрж╛
ЁЯУо => ЁЯУо, ржкрзЛрж╖рзНржЯржмржХрзНрж╕
ЁЯУЭ => ЁЯУЭ, ржорзЗржорзЛ, ржорзЗржорзЛ ржмрж╣рзА, ржпрзЛржЧрж╛ржпрзЛржЧ
ЁЯТ╝ => ЁЯТ╝, ржмрзНрз░рж┐ржлржХрзЗржЫ
ЁЯУБ => ЁЯУБ, ржлрж╛ржЗрж▓ ржлтАЩрж▓рзНржбрж╛рз░, ржлрж╛ржЗрж▓, ржлтАЩрж▓рзНржбрж╛рз░
ЁЯУВ => ЁЯУВ, ржЦрзЛрж▓рж╛ ржлтАЩрж▓рзНржбрж╛рз░, ржЦрзЛрж▓рж╛ ржлрж╛ржЗрж▓ ржлтАЩрж▓рзНржбрж╛рз░, ржЦрзЛрж▓рж╛, ржлрж╛ржЗрж▓, ржлтАЩрж▓рзНржбрж╛рз░
ЁЯУЕ => ЁЯУЕ, ржХрзЗрж▓рзЗржгрзНржбрж╛рз░
ЁЯУЖ => ЁЯУЖ, ржлрж╛рж▓рж┐ржм ржкрз░рж╛ ржХрзЗрж▓рзЗржгрзНржбрж╛рз░, ржХрзЗрж▓рзЗржгрзНржбрж╛рз░
ЁЯУЗ => ЁЯУЗ, ржХрж╛рз░рзНржб ржЗржгрзНржбрзЗржХрзНрж╕, рз░рзЛрж▓рзЛржбрзЗрж╕рзНржХ, ржЗржгрзНржбрзЗржХрзНрж╕
ЁЯУИ => ЁЯУИ, ржЙрз░рзНржзржорзБржЦрзА ржкрзНрз░рз▒ржгрждрж╛, ржЙрз░рзНржзржорзБржЦрзА ржкрзНрз░рз▒ржгрждрж╛рз░ ржЪрж╛рз░рзНржЯ, ржЪрж╛рз░рзНржЯ, ржЧрзНрз░рж╛ржл, ржЙрз░рзНржзржорзБржЦрзА
ЁЯУЙ => ЁЯУЙ, ржирж┐ржорзНржиржорзБржЦрзА ржкрзНрз░рз▒ржгрждрж╛, ржирж┐ржорзНржиржорзБржЦрзА ржкрзНрз░рз▒ржгрждрж╛рз░ ржЪрж╛рз░рзНржЯ, ржЪрж╛рз░рзНржЯ, ржЧрзНрз░рж╛ржл, ржирж┐ржорзНржиржорзБржЦрзА
ЁЯУК => ЁЯУК, ржжржгрзНржб ржЧрзНрз░рж╛ржл, ржжржгрзНржб ржЪрж╛рз░рзНржЯ
ЁЯУЛ => ЁЯУЛ, ржХрзНрж▓рж┐ржкржмтАЩрз░рзНржб
ЁЯУМ => ЁЯУМ, ржкрзБржЫржкрж┐ржи, ржкрж┐ржи
ЁЯУН => ЁЯУН, ржШрзВрз░ржгрзАрзЯрж╛ ржкрзБржЫржкрж┐ржи, ржкрзБржЫржкрж┐ржи, ржкрж┐ржи
ЁЯУО => ЁЯУО, ржкрзЗржкрж╛рз░ржХрзНрж▓рж┐ржк, ржХрзНрж▓рж┐ржк
ЁЯУП => ЁЯУП, ржкрзЛржг рз░рзБрж▓рж╛рз░, рз░рзБрж▓рж╛рз░
ЁЯУР => ЁЯУР, рждрзНрз░рж┐ржнрзБржЬ рз░рзБрж▓рж╛рз░, рждрзНрз░рж┐ржнрзБржЬ, ржЫрзЗржЯ ржмрз░рзНржЧ
ЁЯФТ => ЁЯФТ, рждрж▓рж╛, ржмржирзНржз рждрж▓рж╛
ЁЯФУ => ЁЯФУ, рждрж▓рж╛, ржЦрзЛрж▓рж╛ рждрж▓рж╛
ЁЯФП => ЁЯФП, рждрж▓рж╛, ржЧрзЛржкржирзАрзЯрждрж╛, ржЪрж┐рзЯрж╛рж╣рзАрз░ ржХрж▓ржо рж╕рж╣ рждрж▓рж╛
ЁЯФР => ЁЯФР, ржмржирзНржз рждрж▓рж╛, ржЫрж╛ржмрж┐ рж╕рж╣ рждрж▓рж╛, рж╕рзБрз░ржХрзНрж╖рж┐ржд
ЁЯФС => ЁЯФС, ржЫрж╛ржмрж┐, ржкрж╛ржЫрз▒рз░рзНржб
ЁЯФи => ЁЯФи, рж╣рж╛ржБрждрзБрз░рзА, рж╕ржБржЬрзБрж▓рж┐
ЁЯФз => ЁЯФз, рз░рзЗржЮрзНржЪ, рж╕ржБржЬрзБрж▓рж┐
ЁЯФй => ЁЯФй, ржирж╛ржЯ ржЖрз░рзБ ржмтАЩрж▓рзНржЯ, ржирж╛ржЯ, ржмтАЩрж▓рзНржЯ, рж╕ржБржЬрзБрж▓рж┐
ЁЯФЧ => ЁЯФЧ, рж▓рж┐ржВржХ ржЪрж┐рж╣рзНржи, рж╕ржВржпрзЛржЧ, ржжрзБржЯрж╛ рз░рж┐ржВ
ЁЯТЙ => ЁЯТЙ, ржЪрж┐рз░рж┐ржЮрзНржЬ, ржмрзЗржЬрзА, ржФрж╖ржз
ЁЯТК => ЁЯТК, ржкрж┐рж▓, ржХрзЗржкржЪрзБрж▓, ржФрж╖ржз, ржЪрж┐ржХрж┐рзОрж╕ржХ
ЁЯФк => ЁЯФк, рз░ржирзНржзрж╛ ржЪрзБрз░рж┐, ржЪрзБрз░рж┐, ржХржЯрж╛рз░рзА
ЁЯФл => ЁЯФл, ржмржирзНржжрзБржХ, ржкрж┐рж╖рзНржЯрж▓, рз░рж┐ржнрж▓ржнрж╛рз░
ЁЯПБ => ЁЯПБ, ржЪрзЗржХрж╛рз░рзНржб ржкрждрж╛ржкрж╛, ржкрждрж╛ржХрж╛, рз░рзЗржЪрж┐ржВ, ржЦрзЗрж▓
ЁЯЪй => ЁЯЪй, ржЕрз▒рж╕рзНржерж╛ржи ржкрждрж╛ржХрж╛, ржЕрз▒рж╕рзНржерж╛ржи рждржерзНржп ржкрждрж╛ржХрж╛, рждрзНрз░рж┐ржнрзБржЬрж╛ржХрж╛рз░ ржЕрз▒рж╕рзНржерж╛ржи ржкрждрж╛ржХрж╛, рждрзНрз░рж┐ржнрзБржЬрж╛ржХрж╛рз░ ржкрждрж╛ржХрж╛, ржЕрз▒рж╕рзНржерж╛ржи
ЁЯЪм => ЁЯЪм, ржзрзВржоржкрж╛ржи ржЪрж┐рж╣рзНржи, ржзрзВржоржкрж╛ржи ржЕржирзБржорзЛржжрж┐ржд, ржзрзВржоржкрж╛ржи, ржЪрж┐рж╣рзНржи
ЁЯЧ┐ => ЁЯЧ┐, ржорзЛрз▒рж╛ржЗ ржорзВрз░рзНрждрж┐, ржорзВрз░рзНрждрж┐, ржорзЛрз▒рж╛ржЗ
ЁЯФо => ЁЯФо, рж╕рзНржлржЯрж┐ржХрз░ ржмрж▓, ржнрз▒рж┐рж╖рзНржпрзОржмрж╛ржгрзА, рж╕рзНржлржЯрж┐ржХ, ржмрж▓, ржнрж╛ржЧрзНржп
ЁЯПз => ЁЯПз, ржПржЯрж┐ржПржо, ржПржЯрж┐ржПржо ржорзЗржЪрж┐ржи
ЁЯЪо => ЁЯЪо, ржЖрз▒рз░рзНржЬржирж╛рз░ ржкрж╛рждрзНрз░ ржЪрж┐рж╣рзНржи, ржПржЗ рж╕рзНржерж╛ржиржд ржЖрз▒рз░рзНржЬржирж╛ ржкрзЗрж▓рж╛ржм, ржЖрз▒рз░рзНржЬржирж╛рз░ ржмрж╛ржХржЪ, ржЪрж┐рж╣рзНржи
ЁЯЪ░ => ЁЯЪ░, ржЦрзЛрз▒рж╛ ржкрж╛ржирзА, ржмрж┐рж╢рзБржжрзНржз ржкрж╛ржирзА, ржЦрзЛрз▒рж╛ ржкрж╛ржирзАрз░ ржЪрж┐рж╣рзНржи
тЩ┐ => тЩ┐, рж╣рзБржЗрж▓ржЪрзЗрзЯрж╛рз░рз░ ржкрзНрз░рз▒рзЗрж╢рж╛ржзрж┐ржХрж╛рз░, рж╣рзБржЗрж▓ржЪрзЗрзЯрж╛рз░, ржкрзНрз░рз▒рзЗрж╢рж╛ржзрж┐ржХрж╛рз░, рж╣рзБржЗрж▓ржЪрзЗрзЯрж╛рз░ ржЪрж┐рж╣рзНржи, ржЪрж┐рж╣рзНржи
ЁЯЪ╣ => ЁЯЪ╣, ржкрзБрз░рзБрж╖ ржЪрж┐рж╣рзНржи, ржкрзБрз░рзБрж╖рз░ ржХрзЛржарж╛, ржкрзБрз░рзБрж╖рз░ ржЪрж┐рж╣рзНржи, ржЪрж┐рж╣рзНржи
ЁЯЪ║ => ЁЯЪ║, ржорж╣рж┐рж▓рж╛ ржЪрж┐рж╣рзНржи, ржорж╣рж┐рж▓рж╛рз░ ржХрзЛржарж╛, ржЪрж┐рж╣рзНржи
ЁЯЪ╗ => ЁЯЪ╗, рж╢рзМржЪрж╛ржЧрж╛рз░ ржЪрж┐рж╣рзНржи, рж╢рзМржЪрж╛ржЧрж╛рз░, рж╕рзНржирж╛ржирж╛ржЧрж╛рз░
ЁЯЪ╝ => ЁЯЪ╝, ржХрзЗржБржЪрзБрз▒рж╛ ржЪрж┐рж╣рзНржи, ржХрзЗржБржЪрзБрз▒рж╛ ржЖржЫрзЗ, ржХрзЗржБржЪрзБрз▒рж╛рз░ ржХрж╛ржкрзЛрз░ рж╕рж▓рзЛрз▒рж╛ рж╕рзНржерж╛ржи, ржХрзЗржБржЪрзБрз▒рж╛
ЁЯЪ╛ => ЁЯЪ╛, ржкрж╛ржирзА ржХрзНрж▓ржЬрзЗржЯ, рж╢рзМржЪрж╛ржЧрж╛рз░, рж╕рзНржирж╛ржирж╛ржЧрж╛рз░
ЁЯЫВ => ЁЯЫВ, ржкрж╛ржЫржктАЩрз░рзНржЯ ржирж┐рзЯржирзНрждрзНрз░ржг, ржкрж╛ржЫржктАЩрз░рзНржЯ, ржирж┐рзЯржирзНрждрзНрз░ржг
ЁЯЫГ => ЁЯЫГ, рж╢рзБрж▓рзНржХ ржмрж┐ржнрж╛ржЧ
ЁЯЫД => ЁЯЫД, ржмрзЗржЧрзЗржЬ ржжрж╛ржмрзА, ржмрзЗржЧрзЗржЬ
ЁЯЫЕ => ЁЯЫЕ, ржПрз░рж┐ ржпрзЛрз▒рж╛ рж▓рж╛ржЧрзЗржЬ, ржмрзЗржЧрзЗржЬ рж╕рзЗрз▒рж╛, рж▓рж╛ржЧрзЗржЬ, ржмрзЗржЧрзЗржЬ
тЪа => тЪа, рж╕рж╛рз▒ржзрж╛ржи ржЪрж┐рж╣рзНржи, рж╕рж╛рз▒ржзрж╛ржи, ржЪрж┐рж╣рзНржи
ЁЯЪ╕ => ЁЯЪ╕, рж╢рж┐рж╢рзБрз▒рзЗ ржкрже ржкрж╛рз░ ржХрз░рж╛ рж╕рзНржерж╛ржи, рж╢рж┐рж╢рзБ, ржкрже ржкрж╛рз░ ржХрз░рж╛, ржЪрж┐рж╣рзНржи
тЫФ => тЫФ, ржкрзНрз░рз▒рзЗрж╢ ржирж┐рж╖рзЗржз ржЪрж┐рж╣рзНржи, ржкрзНрз░рз▒рзЗрж╢ ржирж┐рж╖рзЗржз, ржирж┐рж╖рж┐ржжрзНржз, ржЪрж┐рж╣рзНржи
ЁЯЪл => ЁЯЪл, ржкрзНрз░рз▒рзЗрж╢ ржирж┐рж╖рзЗржз ржЪрж┐рж╣рзНржи, ржкрзНрз░рз▒рзЗрж╢ ржирж┐рж╖рзЗржз, ржЪрж┐рж╣рзНржи
ЁЯЪ│ => ЁЯЪ│, ржЪрж╛ржЗржХрзЗрж▓ ржирж╣рзЯ, ржмрж╛ржЗржЪрж╛ржЗржХрзЗрж▓ ржирж╣рзЯ, ржмрж╛ржЗржЪрж╛ржЗржХрзЗрж▓ ржЕржирзБржорзЛржжрж┐ржд ржирж╣рзЯ, ржмрж╛ржЗржХ, ржмрж╛рж╣ржи
ЁЯЪн => ЁЯЪн, ржзрзВржоржкрж╛ржи ржирж┐рж╖рзЗржз ржЪрж┐рж╣рзНржи, ржзрзВржоржкрж╛ржи ржирж┐рж╖рзЗржз, ржЪрж┐рж╣рзНржи
ЁЯЪп => ЁЯЪп, рж▓рзЗрждрзЗрз░рж╛ ржиржХрз░рж┐ржм ржЪрж┐рж╣рзНржи, рж▓рзЗрждрзЗрз░рж╛ ржиржХрз░рж┐ржм, ржЖрз▒рз░рзНржЬржирж╛ ржкрзЗрж▓рзЛрз▒рж╛ ржирж┐рж╖рзЗржз, ржЪрж┐рж╣рзНржи
ЁЯЪ▒ => ЁЯЪ▒, ржЦрж╛ржм ржирзЛрз▒рж╛рз░рж╛ ржкрж╛ржирзА, ржЕрж╢рзБржжрзНржз ржкрж╛ржирзА, ржкрж╛ржирзА, ржЦрзЛрз▒рж╛рз░ ржмрж╛ржмрзЗ ржирж╣рзЯ
ЁЯЪ╖ => ЁЯЪ╖, ржкржержЪрж╛рз░рзА ржирж╣рзЯ, ржкржержЪрж╛рз░рзА ржЕржирзБржорзЛржжрж┐ржд ржирж╣рзЯ, ржкржержЪрж╛рз░рзА, ржЦрзЛржЬ ржХрзЭрж╛, ржЪрж┐рж╣рзНржи
ЁЯФГ => ЁЯФГ, ржкрзБржирз░-рж▓рзЛржб, ржкрзБржирз░-рж▓рзЛржб ржЪрж┐ржи, ржЙрж▓ржорзНржм ржШрзЬрзАрз░ ржХрж╛ржЯрж╛рз░ ржжрж┐рж╢рз░ ржХрж╛рзЬ, ржХрж╛рзЬ
ЁЯФД => ЁЯФД, ржШрзЬрзАрз░ ржХрж╛ржЯрж╛рз░ ржмрж┐ржкрз░рзАржд ржжрж┐рж╢рз░ ржХрж╛рзЬ, ржШрзЬрзАрз░ ржХрж╛ржЯрж╛рз░ ржмрж┐ржкрз░рзАржд ржжрж┐рж╢, ржХрж╛рзЬ
ЁЯФЩ => ЁЯФЩ, ржкрж┐ржЫрж▓рзИ, ржкрж┐ржЫрж▓рзИ ржХрж╛рзЬ, ржмрж╛ржУржБ ржХрж╛рзЬ рж╕рж╣ ржкрж┐ржЫрж▓рзИ, ржмрж╛ржУржБ ржХрж╛рзЬ, ржХрж╛рзЬ
ЁЯФЪ => ЁЯФЪ, рж╕ржорж╛ржкрзНржд, рж╕ржорж╛ржкрзНржд ржХрж╛рзЬ, рж╕ржорж╛ржкрзНржд ржХрж╛рзЬ рж╕рж╣ ржкрж┐ржЫрж▓рзИ, ржмрж╛ржУржБ ржХрж╛рзЬ, ржХрж╛рзЬ
ЁЯФЫ => ЁЯФЫ, ржЕржи ржХрж╛рзЬ, ржЖрж╢рзНржЪрз░рзНржпржмрзЛржзржХ ржЪрж┐рж╣рзНржи рж╕рж╣ ржЕржи ржЖрз░рзБ ржХрж╛рзЬ, ржХрж╛рзЬ
ЁЯФЬ => ЁЯФЬ, рж╕рзЛржиржХрж╛рж▓рзЗ ржЪрж┐ржи, рж╕рзЛржиржХрж╛рж▓рзЗ, рж╕рзЛржБ ржХрж╛рзЬ рж╕рж╣ рж╕рзЛржиржХрж╛рж▓рзЗ, ржХрж╛рзЬ
ЁЯФЭ => ЁЯФЭ, рж╢рзАрз░рзНрж╖ ржХрж╛рзЬ, рж╢рзАрз░рзНрж╖, ржЙрз░рзНржзржорзБржЦрзА ржХрж╛рзЬ рж╕рж╣ рж╢рзАрз░рзНрж╖, ржЙрз░рзНржзржорзБржЦрзА ржХрж╛рзЬ
ЁЯФп => ЁЯФп, ржЫрзЯ ржорзБржЦрзА рждрз░рж╛, ржнрз▒рж┐рж╖рзНржпрзОржмрж╛ржгрзА, рждрз░рж╛, ржнрж╛ржЧрзНржп
тЩ╗ => тЩ╗, рз░рж┐ржЪрж╛ржЗржХрж▓рж┐ржВ ржЪрж┐рж╣рзНржи, ржЧрзЛржЯрж╛ ржмрж┐рж╢рзНржмржЬржирзАржи рз░рж┐ржЪрж╛ржЗржХрж▓рж┐ржВ ржЪрж┐рж╣рзНржи, рз░рж┐ржЪрж╛ржЗржХрж▓рж┐ржВ, ржмрж┐рж╢рзНржмржЬржирзАржи, ржЪрж┐рж╣рзНржи
ЁЯУЫ => ЁЯУЫ, ржирж╛ржорз░ ржмрзЗржЬ, ржирж╛ржо
ЁЯФ░ => ЁЯФ░, рж╕рзЗржЙржЬрзАрзЯрж╛ ржЖрз░рзБ рж╣рж╛рж▓ржзрзАрзЯрж╛ ржкрж╛ржд, рж╕рзЗржЙржЬрзАрзЯрж╛ ржЖрз░рзБ рж╣рж╛рж▓ржзрзАрзЯрж╛, ржЬрж╛ржкрж╛ржирзА
ЁЯФ▒ => ЁЯФ▒, рждрзНрз░рж┐рж╢рзВрж▓ ржЪрж┐рж╣рзНржи, рж▓ржЩрзНржЧрз░, рждрзНрз░рж┐рж╢рзВрж▓, ржкрзНрз░рждрж┐ржХ
тЬЕ => тЬЕ, ржЯрж┐ржХ ржЪрж┐рж╣рзНржи, ржЯрж┐ржХ, ржбрж╛ржа ржЯрж┐ржХ ржЪрж┐рж╣рзНржи
тЭМ => тЭМ, ржХржЯрж╛ ржЪрж┐рж╣рзНржи, тАЬXтАЭ
тЭО => тЭО, ржХржЯрж╛ ржЪрж┐рж╣рзНржи, ржмрз░рзНржЧрз░ ржнрж┐рждрз░ржд тАЬXтАЭ
тЮХ => тЮХ, ржпрзЛржЧ, ржбрж╛ржа ржпрзЛржЧ ржЪрж┐ржи, ржпрзЛржЧ ржЪрж┐ржи, ржЪрж┐рж╣рзНржи
тЮЦ => тЮЦ, ржмрж┐рзЯрзЛржЧ, ржбрж╛ржа ржмрж┐рзЯрзЛржЧ ржЪрж┐ржи, ржмрж┐рзЯрзЛржЧ ржЪрж┐ржи, ржЪрж┐рж╣рзНржи
тЮЧ => тЮЧ, рж╣рз░ржг, ржбрж╛ржа рж╣рз░ржг ржЪрж┐ржи, рж╣рз░ржг ржЪрж┐ржи, ржЪрж┐рж╣рзНржи
тЮ░ => тЮ░, ржнрж╛ржЬржпрзБржХрзНржд ржкрж╛ржХ, ржШрзБрз░рж╛, ржкрж╛ржХ
тЮ┐ => тЮ┐, ржжрзНржмрзИржд ржнрж╛ржЬржпрзБржХрзНржд ржкрж╛ржХ, ржнрж╛ржЬржпрзБржХрзНржд ржкрж╛ржХ, ржЬрж╛ржкрж╛ржи, ржмрж┐ржирж╛ржорзВрж▓рзАрзЯрж╛ ржбрж╛рзЯрзЗрж▓
ЁЯТ▒ => ЁЯТ▒, ржмрж┐ржжрзЗрж╢рзА ржорзБржжрзНрз░рж╛рз░ ржмрж┐ржирж┐ржорзЯ, ржмрж┐ржжрзЗрж╢рзА ржорзБржжрзНрз░рж╛
ЁЯТ▓ => ЁЯТ▓, ржбрж▓рж╛рз░ ржЪрж┐ржи, ржм'рж▓рзНржб ржбрж▓рз░ ржЪрж┐ржи, ржбрж▓рж╛рз░, ржзржи, ржорзБржжрзНрз░рж╛
тЭУ => тЭУ, ржкрзНрз░рж╢рзНржиржмрзЛржзржХ ржЪрж┐ржи, ржкрзНрз░рж╢рзНржи
тЭФ => тЭФ, ржкрзНрз░рж╢рзНржиржмрзЛржзржХ ржЪрж┐ржи, ржкрзНрз░рж╢рзНржи
тЭХ => тЭХ, ржнрж╛рз▒ржмрзЛржзржХ ржЪрж┐ржи, ржнрж╛рз▒ржмрзЛржзржХ
уА░ => уА░, ржврзМ ржбрзЗржЫ, ржжрзАржШрж▓ рж╢ржмрзНржж ржЪрж┐рж╣рзНржи, ржврзМ, ржбрзЗржЫ
┬й => ┬й, рж╕рзНржмрждрзНржмрж╛ржзрж┐ржХрж╛рз░ ржЪрж┐ржи, рж╕рзНржмрждрзНржмрж╛ржзрж┐ржХрж╛рз░
┬о => ┬о, ржкржЮрзНржЬрзАрзЯржи ржЪрж┐рж╣рзНржи, ржкржЮрзНржЬрзАржХрзГржд
тДв => тДв, ржЯрзНрз░рзЗржб ржорж╛рз░рзНржХ ржЪрж┐рж╣рзНржи, ржЯрзНрз░рзЗржб ржорж╛рз░рзНржХ, ржЪрж┐рж╣рзНржи
тЩИ => тЩИ, ржорзЗрж╖, рз░рж╛рж╢рж┐
тЩЙ => тЩЙ, ржмрзГрж╖, рз░рж╛рж╢рж┐
тЩК => тЩК, ржорж┐ржерзБржи, рз░рж╛рж╢рж┐
тЩЛ => тЩЛ, ржХрз░рзНржХржЯ, рз░рж╛рж╢рж┐
тЩМ => тЩМ, рж╕рж┐ржВрж╣, рз░рж╛рж╢рж┐
тЩН => тЩН, ржХржирзНржпрж╛, рз░рж╛рж╢рж┐
тЩО => тЩО, рждрзБрж▓рж╛, рз░рж╛рж╢рж┐
тЩП => тЩП, ржмрзГрж╢рзНржЪрж┐ржХ, рз░рж╛рж╢рж┐
тЩР => тЩР, ржзржирзБ, рз░рж╛рж╢рж┐
тЩС => тЩС, ржоржХрз░, рз░рж╛рж╢рж┐
тЩТ => тЩТ, ржХрзБржорзНржн, рз░рж╛рж╢рж┐
тЩУ => тЩУ, ржорзАржи, рз░рж╛рж╢рж┐
тЫО => тЫО, ржЕржлрж┐ржЙржХрж╛ржЫ, рз░рж╛рж╢рж┐
ЁЯФА => ЁЯФА, ржХржЯрж╛ржХржЯрж┐ ржХрж╛рзЬ, ржХржЯрж╛ржХржЯрж┐ рж╕рзЛржБржорзБржЦрзА ржХрж╛рзЬ, ржХрж╛рзЬ ржЪрж┐ржи
ЁЯФБ => ЁЯФБ, ржШрзЬрзАрз░ ржХрж╛ржЯрж╛рз░ ржжрж┐рж╢рз░ ржХрж╛рзЬ, ржШрзЬрзАрз░ ржХрж╛ржЯрж╛рз░ ржжрж┐рж╢, ржХрж╛рзЬ
ЁЯФВ => ЁЯФВ, ржШрзЬрзАрз░ ржХрж╛ржЯрж╛рз░ ржжрж┐рж╢рз░ ржХрж╛рзЬ, 1 рж╕ржВржЦрзНржпрж╛ рж╕рж╣ ржШрзЬрзАрз░ ржХрж╛ржЯрж╛рз░ ржжрж┐рж╢рз░ ржХрж╛рзЬ, ржШрзЬрзАрз░ ржХрж╛ржЯрж╛рз░ ржжрж┐рж╢, ржХрж╛рзЬ
тПй => тПй, ржжрзНрз░рзБрждржнрж╛рз▒рзЗ ржЖржЧрж▓рзИ, ржжрзНржмрзИржд рж╕рзЛржБ ржХрж╛рзЬ, рж╕рзЛржБ, ржХрж╛рзЬ
тПк => тПк, ржкрж┐ржЫрж▓рзИ, ржжрзНржмрзИржд ржмрж╛ржУржБ ржХрж╛рзЬ, ржмрж╛ржУржБ, ржХрж╛рзЬ
ЁЯФ╝ => ЁЯФ╝, ржЙрз░рзНржзржорзБржЦрзА рждрзНрз░рж┐ржнрзБржЬ, ржЙрз░рзНржзржорзБржЦрзА рждрзНрз░рж┐ржнрзБржЬ ржмрзБржЯрж╛ржо, рждрзНрз░рж┐ржнрзБржЬ
тПл => тПл, ржУржкрж▓рзИ ржХрж╛рзЬ, ржжрзНржмрзИржд ржУржкрз░рж▓рзИ ржХрж╛рзЬ, ржУржкрз░рж▓рзИ, ржХрж╛рзЬ
ЁЯФ╜ => ЁЯФ╜, ржирж┐ржорзНржиржорзБржЦрзА рждрзНрз░рж┐ржнрзБржЬ, ржирж┐ржорзНржиржорзБржЦрзА рждрзНрз░рж┐ржнрзБржЬ ржмрзБржЯрж╛ржо, рждрзНрз░рж┐ржнрзБржЬ
тПм => тПм, рждрж▓рж▓рзИ ржХрж╛рзЬ, ржжрзНржмрзИржд рждрж▓рж▓рзИ ржХрж╛рзЬ, ржУржкрз░рж▓рзИ, ржХрж╛рзЬ
ЁЯОж => ЁЯОж, ржЪрж┐ржирзЗржорж╛, ржЪрж▓ржЪрж┐рждрзНрз░, ржЪрж┐ржирзЗржорж╛рз░ ржЪрж┐ржи, ржоржирзЛрз░ржЮрзНржЬржи
ЁЯФЕ => ЁЯФЕ, ржирж┐ржорзНржи ржЙржЬрзНржЬрзНржмрж▓рждрж╛, ржирж┐ржорзНржи, ржЕржирзБржЬрзНржмрж▓, ржирж┐ржорзНржи ржЙржЬрзНржЬрзНржмрж▓рждрж╛рз░ ржЪрж┐рж╣рзНржи, ржЙржЬрзНржЬрзНржмрж▓рждрж╛
ЁЯФЖ => ЁЯФЖ, ржЙржЪрзНржЪ ржЙржЬрзНржЬрзНржмрж▓рждрж╛, ржЙржЬрзНржЬрзНржмрж▓, ржЙржЪрзНржЪ ржЙржЬрзНржЬрзНржмрж▓рждрж╛рз░ ржЪрж┐рж╣рзНржи, ржЙржЬрзНржЬрзНржмрж▓рждрж╛
ЁЯУ╢ => ЁЯУ╢, ржорзЛржмрж╛ржЗрж▓ рж╕ржВржХрзЗржд, ржжржгрзНржбрж┐ржХрж╛ рж╕рж╣ ржПржгрзНржЯрзЗржирж╛, рж╕ржВржХрзЗрждрз░ рж╢ржХрзНрждрж┐, рж╕ржВржХрзЗржд, ржПржгрзНржЯрзЗржирж╛, ржорзЛржмрж╛ржЗрж▓, ржлрзЛржи
ЁЯУ╡ => ЁЯУ╡, ржЪрзЗрж▓ ржлрзЛржи ржирж┐рж╖рзЗржз, ржлрзЛржи ржХрз░рж╛ ржирж┐рж╖рзЗржз, ржорзЛржмрж╛ржЗрж▓, ржлрзЛржи
ЁЯУ│ => ЁЯУ│, ржХржорзНржкржи ржорзЛржб, ржЪрзЗрж▓ ржлрзЛржи, ржорзЛржмрж╛ржЗрж▓ ржлрзЛржи, ржлрзЛржи
ЁЯУ┤ => ЁЯУ┤, ржлрзЛржи ржЕржл, ржЪрзЗрж▓ ржлрзЛржи ржЕржл, ржЪрзЗрж▓ ржлрзЛржи, ржлрзЛржи
ЁЯФЯ => ЁЯФЯ, ржХрзАржХрзЗржк ржжрж╣, 10
ЁЯТп => ЁЯТп, рж╕ржорзНржкрзВрз░рзНржг рж╕рзНржХ'рз░, 100 ржкржЗржгрзНржЯ, 100, рж╕рзНржХ'рз░
ЁЯФЮ => ЁЯФЮ, 18 ржмржЫрз░рз░ рждрж▓ржд ржирж╣рзЯ, 18 ржмржЫрз░рз░ рждрж▓ржд ржирж┐рж╖рзЗржз, 18 ржмржЫрз░рз░ рждрж▓ржд
ЁЯФа => ЁЯФа, ржмрз░ржлрж▓рж╛рз░ ржЖржЦрз░, ржмрз░ржлрж▓рж╛рз░ рж▓рзЗржЯрж┐ржи ржЖржЦрз░ ржЗржиржкрзБржЯ, ржмрз░ржлрж▓рж╛рз░ рж▓рзЗржЯрж┐ржи
ЁЯФб => ЁЯФб, рж╕рз░рзБржлрж▓рж╛рз░ ржЖржЦрз░, рж╕рз░рзБрж▓рж╛рз░ рж▓рзЗржЯрж┐ржи ржЖржЦрз░ ржЗржиржкрзБржЯ, рж╕рз░рзБржлрж▓рж╛рз░ рж▓рзЗржЯрж┐ржи
ЁЯФв => ЁЯФв, рж╕ржВржЦрзНржпрж╛, рж╕ржВржЦрзНржпрж╛ ржЗржиржкрзБржЯ
ЁЯФг => ЁЯФг, ржЪрж┐рж╣рзНржи, ржЪрж┐рж╣рзНржи ржЗржиржкрзБржЯ
ЁЯФд => ЁЯФд, рж▓рзЗржЯрж┐ржи ржмрз░рзНржгржорж╛рж▓рж╛, рж▓рзЗржЯрж┐ржи ржмрз░рзНржгржорж╛рж▓рж╛ ржЗржиржкрзБржЯ, рж▓рзЗржЯрж┐ржи, ржЗржВрз░рж╛ржЬрзА, ABC
ЁЯЕ░ => ЁЯЕ░, рждрзЗржЬрз░ ржкрзНрз░ржХрж╛рз░ A, ржкрзНрз░ржХрж╛рз░ A, рждрзЗржЬрз░ ржкрзНрз░ржХрж╛рз░, рждрзЗржЬ, A
ЁЯЖО => ЁЯЖО, рждрзЗржЬрз░ ржкрзНрз░ржХрж╛рз░ AB, ржкрзНрз░ржХрж╛рз░ AB, рждрзЗржЬрз░ ржкрзНрз░ржХрж╛рз░, рждрзЗржЬ, AB
ЁЯЕ▒ => ЁЯЕ▒, рждрзЗржЬрз░ ржкрзНрз░ржХрж╛рз░ B, ржкрзНрз░ржХрж╛рз░ B, рждрзЗржЬрз░ ржкрзНрз░ржХрж╛рз░, рждрзЗржЬ, B
ЁЯЖС => ЁЯЖС, CL, ржкрз░рж┐рж╖рзНржХрж╛рз░, CL ржЪрж┐рж╣рзНржи
ЁЯЖТ => ЁЯЖТ, ржарж╛ржгрзНржбрж╛, ржарж╛ржгрзНржбрж╛ ржЪрж┐рж╣рзНржи
ЁЯЖУ => ЁЯЖУ, ржорзБржХрзНржд, ржорзБржХрзНржд ржЪрж┐рж╣рзНржи, ржорж╛ржЫрзБрж▓ржмрж┐рж╣рзАржи, ржЪрж┐рж╣рзНржи
ЁЯЖФ => ЁЯЖФ, ID, ID ржЪрж┐рж╣рзНржи, ржкрз░рж┐ржЪрзЯ, ржЪрж┐рж╣рзНржи
ЁЯЖХ => ЁЯЖХ, ржирждрзБржи, ржирждрзБржи ржЪрж┐рж╣рзНржи, ржЪрж┐рж╣рзНржи
ЁЯЖЦ => ЁЯЖЦ, NG, NG ржЪрж┐рж╣рзНржи, ржЪрж┐рж╣рзНржи
ЁЯЕ╛ => ЁЯЕ╛, рждрзЗржЬрз░ ржкрзНрз░ржХрж╛рз░ O, ржкрзНрз░ржХрж╛рз░ O, рждрзЗржЬрз░ ржкрзНрз░ржХрж╛рз░, рждрзЗржЬ, O
ЁЯЖЧ => ЁЯЖЧ, OK, OK ржЪрж┐рж╣рзНржи
ЁЯЕ┐ => ЁЯЕ┐, ржкрж╛рз░рзНржХрж┐ржВ, ржкрж╛рз░рзНржХрж┐ржВ рж╕рзНржерж╛ржи
ЁЯЖШ => ЁЯЖШ, SOS, SOS ржЪрж┐рж╣рзНржи, рж╕рж╣рж╛рзЯ, ржЪрж┐рж╣рзНржи
ЁЯЖЩ => ЁЯЖЩ, UP!, UP! ржЪрж┐рж╣рзНржи, ржЪрж┐рж╣рзНржи
ЁЯЖЪ => ЁЯЖЪ, ржмржирж╛ржо, vs, ржмржирж╛ржо ржЪрж┐рж╣рзНржи, ржЪрж┐рж╣рзНржи
ЁЯИБ => ЁЯИБ, ржЬрж╛ржкрж╛ржирзА рж╢ржмрзНржж
ЁЯИВ => ЁЯИВ, ржЬрж╛ржкрж╛ржирзА рж╢ржмрзНржж
ЁЯИ╖ => ЁЯИ╖, ржЬрж╛ржкрж╛ржирзА рж╢ржмрзНржж
ЁЯИ╢ => ЁЯИ╢, ржЬрж╛ржкрж╛ржирзА рж╢ржмрзНржж
ЁЯИп => ЁЯИп, ржЬрж╛ржкрж╛ржирзА рж╢ржмрзНржж
ЁЯЙР => ЁЯЙР, ржЬрж╛ржкрж╛ржирзА рж╢ржмрзНржж
ЁЯИ╣ => ЁЯИ╣, ржЬрж╛ржкрж╛ржирзА рж╢ржмрзНржж
ЁЯИЪ => ЁЯИЪ, ржЬрж╛ржкрж╛ржирзА рж╢ржмрзНржж
ЁЯИ▓ => ЁЯИ▓, ржЬрж╛ржкрж╛ржирзА рж╢ржмрзНржж
ЁЯЙС => ЁЯЙС, ржЪрзАржирж╛ рж╢ржмрзНржж
ЁЯИ╕ => ЁЯИ╕, ржЪрзАржирж╛ рж╢ржмрзНржж
ЁЯИ┤ => ЁЯИ┤, ржЪрзАржирж╛ рж╢ржмрзНржж
ЁЯИ│ => ЁЯИ│, ржЪрзАржирж╛ рж╢ржмрзНржж
ЁЯИ║ => ЁЯИ║, ржЪрзАржирж╛ рж╢ржмрзНржж
ЁЯИ╡ => ЁЯИ╡, ржЪрзАржирж╛ рж╢ржмрзНржж
ЁЯФ╢ => ЁЯФ╢, ржбрж╛ржЩрз░ рж╣рзАрз░рж╛, ржбрж╛ржЩрз░ ржХржорж▓рж╛ рж╣рзАрз░рж╛, рж╣рзАрз░рж╛
ЁЯФ╖ => ЁЯФ╖, ржбрж╛ржЩрз░ рж╣рзАрз░рж╛, ржбрж╛ржЩрз░ ржирзАрж▓рж╛ рж╣рзАрз░рж╛, рж╣рзАрз░рж╛
ЁЯФ╕ => ЁЯФ╕, рж╕рз░рзБ рж╣рзАрз░рж╛, рж╕рз░рзБ ржХржорж▓рж╛ рж╣рзАрз░рж╛, рж╣рзАрз░рж╛
ЁЯФ╣ => ЁЯФ╣, рж╕рз░рзБ рж╣рзАрз░рж╛, рж╕рз░рзБ ржирзАрж▓рж╛ рж╣рзАрз░рж╛, рж╣рзАрз░рж╛
ЁЯФ║ => ЁЯФ║, ржЙрз░рзНржзржорзБржЦрзА рждрзНрз░рж┐ржнрзБржЬ, ржЙрз░рзНржзржорзБржЦрзА рз░ржЩрж╛ рждрзНрз░рж┐ржнрзБржЬ, рждрзНрз░рж┐ржнрзБржЬ
ЁЯФ╗ => ЁЯФ╗, ржирж┐ржорзНржиржорзБржЦрзА рждрзНрз░рж┐ржнрзБржЬ, ржирж┐ржорзНржиржорзБржЦрзА рз░ржЩрж╛ рждрзНрз░рж┐ржнрзБржЬ, рждрзНрз░рж┐ржнрзБржЬ
ЁЯТа => ЁЯТа, ржлрзБрж▓рз░ ржкрж╛рж╣рж┐, рж╣рзАрз░рж╛рз░ ржЖржХрзГрждрж┐, ржЖржмрзЗржЧ
ЁЯФШ => ЁЯФШ, рз░рзЗржбрж┐ржЕтАЩ ржмрзБржЯрж╛ржо, ржмрзБржЯрж╛ржо, рз░рзЗржбрж┐ржЕтАЩ
ЁЯФ▓ => ЁЯФ▓, ржмрз░рзНржЧрж╛ржХрж╛рз░ ржмрзБржЯрж╛ржо, ржмрз░рзНржЧ, ржмрзБржЯрж╛ржо
ЁЯФ│ => ЁЯФ│, ржмрз░рзНржЧрж╛ржХрж╛рз░ ржмрзБржЯрж╛ржо, ржмрз░рзНржЧ, ржмрзБржЯрж╛ржо
ЁЯФ┤ => ЁЯФ┤, ржбрж╛ржЩрз░ ржмрзГрждрзНржд, ржбрж╛ржЩрз░ рз░ржЩрж╛ ржмрзГрждрзНржд, ржмрзГрждрзНржд
ЁЯФ╡ => ЁЯФ╡, ржбрж╛ржЩрз░ ржмрзГрждрзНржд, ржбрж╛ржЩрз░ ржирзАрж▓рж╛ ржмрзГрждрзНржд, ржмрзГрждрзНржд

ЁЯЗжЁЯЗ╢ => ЁЯЗжЁЯЗ╢, ржПржирзНржЯрж╛рз░рзНржЯрж┐ржХрж╛
ЁЯЗзЁЯЗ╖ => ЁЯЗзЁЯЗ╖, ржмрзНрз░рж╛ржЬрж┐рж▓
ЁЯЗзЁЯЗ╗ => ЁЯЗзЁЯЗ╗, ржмржнрзЗржЯ ржжрзНржмрзАржк
ЁЯЗиЁЯЗ│ => ЁЯЗиЁЯЗ│, ржЪрзАржи
ЁЯЗйЁЯЗк => ЁЯЗйЁЯЗк, ржЬрж╛рз░рзНржорж╛ржирж┐
ЁЯЗлЁЯЗ╖ => ЁЯЗлЁЯЗ╖, ржлрзНрз░рж╛ржирзНрж╕
ЁЯЗмЁЯЗз => ЁЯЗмЁЯЗз, рж╕ржВржпрзБржХрзНржд рз░рж╛ржЬрзНржп
ЁЯЗмЁЯЗ╕ => ЁЯЗмЁЯЗ╕, ржжржХрзНрж╖рж┐ржг ржЬрз░рзНржЬрж┐ржпрж╝рж╛ ржЖрз░рзБ ржжржХрзНрж╖рж┐ржг ржЪрзЗржгрзНржбрз▒рж┐ржЪрзНтАМ ржжрзНржмрзАржк
ЁЯЗнЁЯЗ▓ => ЁЯЗнЁЯЗ▓, рж╣рж╛рз░рзНржб ржжрзНржмрзАржк ржЖрз░рзБ ржорзЗржХрзНтАМржбрзЛржирж╛рж▓рзНржб ржжрзНржмрзАржк
ЁЯЗоЁЯЗ│ => ЁЯЗоЁЯЗ│, ржнрж╛рз░ржд
ЁЯЗоЁЯЗ┤ => ЁЯЗоЁЯЗ┤, ржмрзНрз░рж┐ржЯрж┐рж╢рзНржм ржЗржгрзНржбрж┐ржпрж╝рж╛ржи ржорж╣рж╛рж╕рж╛ржЧрз░рз░ ржЕржЮрзНржЪрж▓
ЁЯЗоЁЯЗ╣ => ЁЯЗоЁЯЗ╣, ржЗржЯрж╛рж▓рж┐
ЁЯЗпЁЯЗ╡ => ЁЯЗпЁЯЗ╡, ржЬрж╛ржкрж╛ржи
ЁЯЗ╖ЁЯЗ║ => ЁЯЗ╖ЁЯЗ║, рз░рзБржЪ
ЁЯЗ╣ЁЯЗл => ЁЯЗ╣ЁЯЗл, ржжржХрзНрж╖рж┐ржг ржлрзНрз░рж╛ржирзНрж╕рз░ ржЕржЮрзНржЪрж▓
ЁЯЗ║ЁЯЗ╕ => ЁЯЗ║ЁЯЗ╕, ржпрзБржХрзНрждрз░рж╛рж╖рзНржЯрзНрз░
ЁЯЗ┐ЁЯЗ┐ => ЁЯЗ┐ЁЯЗ┐, ржЕржЬрзНржЮрж╛ржд ржмрж╛ ржЕржмрзИржз ржЕржЮрзНржЪрж▓