ЁЯША => ЁЯША, рджрд╛рдВрдд, рджрд╛рдВрдд рджрд┐рдЦрд╛рдирд╛, рд╕реНрдорд╛рдЗрд▓реА, рдЪреЗрд╣рд░рд╛, рд╣рдВрд╕реА, lol, рдордЬрд╝реЗрджрд╛рд░
ЁЯШБ => ЁЯШБ, рджрд╛рдВрдд, рд╣рдВрд╕рддреА рдЖрдВрдЦреЗрдВ, рджрд╛рдВрдд рджрд┐рдЦрд╛рдирд╛, рдореБрд╕реНрдХрд╛рди, рд╕реНрдорд╛рдЗрд▓реА, рдореБрд╕реНрдХрд╛рдирд╛, рдЪреЗрд╣рд░рд╛, рд╣рдВрд╕реА, lol, рдордЬрд╝реЗрджрд╛рд░
ЁЯШВ => ЁЯШВ, рдЦреБрд╢реА рдХреЗ рдЖрдВрд╕реВ, рдЖрдирдВрдж, рдЖрдВрд╕реВ, рдЪреЗрд╣рд░рд╛
ЁЯШГ => ЁЯШГ, рдЦреБрд▓реЗ рдореБрдВрд╣ рд╡рд╛рд▓реА рдореБрд╕реНрдХрд╛рди, рдореБрд╕реНрдХрд╛рдирд╛, рд╕реНрдорд╛рдЗрд▓реА, рдЪреЗрд╣рд░рд╛, рд╣рдВрд╕реА, lol, рдордЬрд╝реЗрджрд╛рд░
ЁЯШД => ЁЯШД, рдЦреБрд▓реЗ рдореБрдВрд╣ рд╡рд╛рд▓реА рдореБрд╕реНрдХрд╛рди, рдореБрд╕реНрдХрд╛рди, рд╕реНрдорд╛рдЗрд▓реА, рдЦреБрд▓рд╛ рдореБрдВрд╣, рдореБрд╕реНрдХрд╛рддреА рдЖрдВрдЦреЗрдВ, рд╣рдВрд╕реА, lol, рдордЬрд╝реЗрджрд╛рд░
ЁЯШЕ => ЁЯШЕ, рдардВрдбреЗ рдкрд╕реАрдиреЗ рд╡рд╛рд▓реА рдореБрд╕реНрдХрд╛рди, рдореБрд╕реНрдХрд╛рди рд▓реЗрдХрд┐рди рдардВрдбрд╛ рдкрд╕реАрдирд╛, рдардВрдбрд╛ рдкрд╕реАрдирд╛
ЁЯШЖ => ЁЯШЖ, рдЦреБрд▓реЗ рдореБрдВрд╣ рд╡рд╛рд▓реА рдореБрд╕реНрдХрд╛рди, рдмрдВрдж рдЖрдВрдЦреЛрдВ рд╡рд╛рд▓реА рдореБрд╕реНрдХрд╛рди, рдЦреБрд▓рд╛ рдореБрдВрд╣, рдмрдВрдж рдЖрдВрдЦреЗрдВ, рдЪреЗрд╣рд░рд╛
ЁЯШЙ => ЁЯШЙ, рдЖрдВрдЦ рдорд╛рд░рдирд╛, рдЪреЗрд╣рд░рд╛
ЁЯШК => ЁЯШК, рдореБрд╕реНрдХрд╛рди, рдореБрд╕реНрдХрд╛рддреА рдЖрдВрдЦреЗрдВ, рдореБрд╕реНрдХрд╛рддрд╛ рдЪреЗрд╣рд░рд╛ рдФрд░ рдЖрдВрдЦреЗрдВ, рдореБрд╕реНрдХрд╛рддрд╛ рдЪреЗрд╣рд░рд╛, рдЪреЗрд╣рд░рд╛
ЁЯШЛ => ЁЯШЛ, рд╕реНрд╡рд╛рджрд┐рд╖реНрдЯ рдЪреЗрд╣рд░рд╛, рд╕реНрд╡рд╛рджрд┐рд╖реНрдЯ, рдордЬрд╝реЗрджрд╛рд░, рдореБрд╕реНрдХрд╛рддрд╛ рдЪреЗрд╣рд░рд╛, рд╕реНрд╡рд╛рджрд┐рд╖реНрдЯ рдЦрд╛рдирд╛, рдЪреЗрд╣рд░рд╛
ЁЯШО => ЁЯШО, рд╢рд╛рдирджрд╛рд░, рдХреВрд▓, рдзреВрдк, рдЪрд╢реНрдореЗ рдХреЗ рд╕рд╛рде рдореБрд╕реНрдХрд╛рдирд╛, рдореБрд╕реНрдХрд╛рдирд╛, рдЪрд╢реНрдорд╛, рдЪреЗрд╣рд░рд╛
ЁЯШН => ЁЯШН, рдореБрд╕реНрдХрд╛рддрд╛ рдЪреЗрд╣рд░рд╛, рдЖрдВрдЦреЛрдВ рдореЗрдВ рджрд┐рд▓, рдкреНрдпрд╛рд░, рдкреНрд░реЗрдордордп, рджрд┐рд▓, рдЖрдВрдЦреЗрдВ, рдЪреЗрд╣рд░рд╛, рдЖрдВрдЦреЗрдВ рдЪрд╛рд░ рд╣реЛрдирд╛
ЁЯШШ => ЁЯШШ, рдЪреБрдВрдмрди рдлреЗрдВрдХрдирд╛, рдЪреЗрд╣рд░рд╛
ЁЯШЧ => ЁЯШЧ, рдЪреБрдВрдмрди рдЪреЗрд╣рд░рд╛, рдЪреБрдВрдмрди, рдЪреЗрд╣рд░рд╛
ЁЯШЩ => ЁЯШЩ, рдЪреБрдВрдмрди рдФрд░ рдореБрд╕реНрдХрд╛рди, рдЪреЗрд╣рд░рд╛, рдореБрд╕реНрдХрд╛рди, рдореБрд╕реНрдХрд╛рддреА рдЖрдВрдЦреЗрдВ
ЁЯШЪ => ЁЯШЪ, рдЖрдВрдЦ рдмрдВрдж рдХрд░рдХреЗ рдЪреВрдордирд╛, рдЪреВрдордирд╛, рдмрдВрдж рдЖрдВрдЦреЗрдВ, рдЪреЗрд╣рд░рд╛
тШ║ => тШ║, рд╕реНрдорд╛рдЗрд▓реА, рд╢рд░реНрдо рд╕реЗ рд▓рд╛рд▓ рдЪреЗрд╣рд░рд╛, рдЪреЗрд╣рд░рд╛
ЁЯЩВ => ЁЯЩВ, рд╣рд▓реНрдХреА рдореБрд╕реНрдХрд╛рди рд╡рд╛рд▓рд╛ рдЪреЗрд╣рд░рд╛, рд╕реНрдорд╛рдЗрд▓реА, рд╣реМрд▓реЗ рд╕реЗ рдореБрд╕реНрдХрд╛рдирд╛
ЁЯдЧ => ЁЯдЧ, рдЪреЗрд╣рд░рд╛, рдЧрд▓реЗ рд▓рдЧрд╛рдирд╛, рдЧрд▓реЗ рд▓рдЧрд╛рддрд╛ рд╣реБрдЖ
ЁЯШЗ => ЁЯШЗ, рдкреНрд░рднрд╛рдордВрдбрд▓ рд╡рд╛рд▓реА рдореБрд╕реНрдХрд╛рди, рдореБрд╕реНрдХрд╛рди, рдкреНрд░рднрд╛рдордВрдбрд▓, рдЪреЗрд╣рд░рд╛
ЁЯдФ => ЁЯдФ, рдЪреЗрд╣рд░рд╛, рд╡рд┐рдЪрд╛рд░рдордЧреНрди рдЪреЗрд╣рд░рд╛
ЁЯШР => ЁЯШР, рдЙрджрд╛рд╕реАрди рдЪреЗрд╣рд░рд╛, рднрд╛рд╡рд╣реАрди, рдЙрджрд╛рд╕реАрди, рдЪреЗрд╣рд░рд╛, рдХреЛрдИ рдЯрд┐рдкреНрдкрдгреА рдирд╣реАрдВ
ЁЯШС => ЁЯШС, рднрд╛рд╡рд╢реВрдиреНрдп, рдЪреЗрд╣рд░рд╛, рдХреЛрдИ рдЯрд┐рдкреНрдкрдгреА рдирд╣реАрдВ
ЁЯШ╢ => ЁЯШ╢, рдореБрдВрд╣ рд░рд╣рд┐рдд, рдЪреЗрд╣рд░рд╛
ЁЯЩД => ЁЯЩД, рдЖрдВрдЦреЗрдВ, рдЪреЗрд╣рд░рд╛, рдКрдкрд░ рджреЗрдЦрддреА рдЖрдВрдЦреЗрдВ
ЁЯШП => ЁЯШП, рдмрдирд╛рд╡рдЯреА рд╣рдВрд╕реА, рдХреГрддреНрд░рд┐рдо рд╣рдВрд╕реА, рдЪреЗрд╣рд░рд╛
ЁЯШг => ЁЯШг, рдЪрд╛рдВрдЯрд╛ рдорд╛рд░реЛ, рдореИрдВрдиреЗ рдЪрд╛рдВрдЯрд╛ рдорд╛рд░рд╛ рдЪреЗрд╣рд░рд╛, рд╣рда, рдЪреЗрд╣рд░рд╛
ЁЯШе => ЁЯШе, рдЖрд╣!, рдирд┐рд░рд╛рд╢ рдФрд░ рдЪрд┐рдВрддрд╛рдореБрдХреНрдд, рдЪрд┐рдВрддрд╛рдореБрдХреНрдд, рдирд┐рд░рд╛рд╢, рдЪреЗрд╣рд░рд╛
ЁЯШо => ЁЯШо, рдЦреБрд▓рд╛ рдореБрдВрд╣, рдореБрдВрд╣, рдЪреЗрд╣рд░рд╛
ЁЯдР => ЁЯдР, рдЪреЗрд╣рд░рд╛, рдореБрдВрд╣
ЁЯШп => ЁЯШп, рдирд┐рд╕реНрддрдмреНрдз рдЪреЗрд╣рд░рд╛, рдЕрд╡рд╛рдХ, рдЕрдЪрдВрднрд┐рдд, рдЖрд╢реНрдЪрд░реНрдпрдЪрдХрд┐рдд, рдЪреЗрд╣рд░рд╛
ЁЯШк => ЁЯШк, рдЙрдиреАрдВрджрд╛, рдЪреЗрд╣рд░рд╛
ЁЯШл => ЁЯШл, рдердХрд╛ рд╣реБрдЖ, рдЪреЗрд╣рд░рд╛
ЁЯШ┤ => ЁЯШ┤, рд╕реЛрддрд╛ рд╣реБрдЖ рдЪреЗрд╣рд░рд╛, рдЪреЗрд╣рд░рд╛
ЁЯШМ => ЁЯШМ, рдЪрд┐рдВрддрд╛рдореБрдХреНрдд, рдЪреЗрд╣рд░рд╛
ЁЯдУ => ЁЯдУ, рдЪреЗрд╣рд░рд╛, рдмреЗрд╡рдХреВрдлреА рдХреЗ рднрд╛рд╡ рд╡рд╛рд▓рд╛ рдЪреЗрд╣рд░рд╛
ЁЯШЫ => ЁЯШЫ, рдЬреАрдн рдмрд╛рд╣рд░, рдЬреАрдн рдмрд╛рд╣рд░ рд░рд╣рдирд╛, рдЪреЗрд╣рд░рд╛
ЁЯШЬ => ЁЯШЬ, рдЬреАрдн рдмрд╛рд╣рд░, рдЫреЗрдбрд╝рдирд╛, рдЖрдВрдЦ рдорд╛рд░рддреЗ рд╣реБрдП рдЬреАрдн рдмрд╛рд╣рд░, рдЖрдВрдЦ рдорд╛рд░рдирд╛, рдЪреБрдЯрдХреБрд▓рд╛, рдЪреЗрд╣рд░рд╛
ЁЯШЭ => ЁЯШЭ, рдпрдХ, рдмрдВрдж рдЖрдВрдЦреЛрдВ рдХреЗ рд╕рд╛рде рдЬреАрдн рдмрд╛рд╣рд░, рдбрд░рд╛рд╡рдирд╛, рдЬреАрдн рдмрд╛рд╣рд░, рдЖрдВрдЦреЗрдВ рдмрдВрдж, рдЪреЗрд╣рд░рд╛
тШ╣ => тШ╣, рдЪреЗрд╣рд░рд╛
ЁЯЩБ => ЁЯЩБ, рдЪреЗрд╣рд░рд╛
ЁЯШТ => ЁЯШТ, рдЕрдкреНрд░рд╕рдиреНрди, рдирд╛рдЦреБрд╢, рдЪреЗрд╣рд░рд╛
ЁЯШУ => ЁЯШУ, рдардВрдбрд╛ рдкрд╕реАрдирд╛, рдЪреЗрд╣рд░рд╛
ЁЯШФ => ЁЯШФ, рд╡рд┐рдЪрд╛рд░рдордЧреНрди рдЪреЗрд╣рд░рд╛, рдирд┐рд░реБрддреНрд╕рд╛рд╣рд┐рдд, рд╡рд┐рдЪрд╛рд░рдордЧреНрди, рдЪреЗрд╣рд░рд╛
ЁЯШХ => ЁЯШХ, рднреНрд░рдорд┐рдд рдЪреЗрд╣рд░рд╛, рдЕрд╕рдордВрдЬрд╕ рдореЗрдВ, рдЪреЗрд╣рд░рд╛
ЁЯШЦ => ЁЯШЦ, рднреМрдВрдЪрдХ, рдЪреЗрд╣рд░рд╛
ЁЯЩГ => ЁЯЩГ, рдЪреЗрд╣рд░рд╛
ЁЯШ╖ => ЁЯШ╖, рдорд╛рд╕реНрдХ рд╡рд╛рд▓рд╛ рдЪреЗрд╣рд░рд╛, рдардВрдб, рдореМрд╕рдо рдХреЗ рдЕрдВрддрд░реНрдЧрдд, рдЪрд┐рдХрд┐рддреНрд╕рд╛ рдорд╛рд╕реНрдХ, рдирдХрд╛рдм, рдЪреЗрд╣рд░рд╛
ЁЯдТ => ЁЯдТ, рдЪреЗрд╣рд░рд╛, рдмреАрдорд╛рд░, рдерд░реНрдорд╛рдореАрдЯрд░, рдмреАрдорд╛рд░ рдЪреЗрд╣рд░рд╛
ЁЯдХ => ЁЯдХ, рд╕рд┐рд░ рдкрд░ рдкрдЯреНрдЯреА, рдЪреЗрд╣рд░рд╛, рджреБрд░реНрдШрдЯрдирд╛рдЧреНрд░рд╕реНрдд, рдЪреЛрдЯ
ЁЯдС => ЁЯдС, рдЪреЗрд╣рд░рд╛
ЁЯШ▓ => ЁЯШ▓, рд╣реИрд░рд╛рди рдЪреЗрд╣рд░рд╛, рднреМрдВрдЪрдХ, рдкреВрд░реА рддрд░рд╣ рд╕реНрддрдВрднрд┐рдд, рдЭрдЯрдХрд╛, рдЪреЗрд╣рд░рд╛
ЁЯШЮ => ЁЯШЮ, рдирд┐рд░рд╛рд╢, рдирд┐рд░рд╛рд╢рд╛, рдЪреЗрд╣рд░рд╛
ЁЯШЯ => ЁЯШЯ, рдЪрд┐рдВрддрд┐рдд, рдЪреЗрд╣рд░рд╛
ЁЯШд => ЁЯШд, рд╡рд┐рдЬрдпреА рдореБрджреНрд░рд╛, рдЬреАрдд рдЧрдпрд╛ рдЪреЗрд╣рд░рд╛, рдореИрдВ рдЬреАрддрд╛, рд╡рд┐рдЬрдп, рдЪреЗрд╣рд░рд╛
ЁЯШв => ЁЯШв, рд░реЛрдирд╛, рджреБрдЦреА, рдЖрдВрд╕реВ, рдЪреЗрд╣рд░рд╛
ЁЯШн => ЁЯШн, рдЬрд╝реЛрд░тАУрдЬрд╝реЛрд░ рд╕реЗ рд░реЛрдирд╛, рдЖрдВрд╕реВ, рд░реЛрдирд╛, рд░реЛрддрд╛ рд╣реБрдЖ, рдЪреЗрд╣рд░рд╛
ЁЯШж => ЁЯШж, рддреНрдпреМрд░реА рдЪрдврд╝рд╛рдирд╛, рдЦреБрд▓реЗ рдореБрдВрд╣ рд╕реЗ рддреНрдпреМрд░реА рдЪрдврд╝рд╛рдирд╛, рддреНрдпреМрд░реА, рдЦреБрд▓рд╛ рдореБрдВрд╣, рдЪреЗрд╣рд░рд╛
ЁЯШз => ЁЯШз, рджреБрдЦрдордп, рдкреАрдбрд╝рд╛, рдЪреЗрд╣рд░рд╛
ЁЯШи => ЁЯШи, рдбрд░рд╛, рднрдпрднреАрдд, рдЪреЗрд╣рд░рд╛
ЁЯШй => ЁЯШй, рдШрдмрд░рд╛рдпрд╛, рдердХрд╛ рд╣реБрдЖ, рдЪреЗрд╣рд░рд╛
ЁЯШм => ЁЯШм, рдореБрдВрд╣ рдмрдирд╛рдирд╛, рджрд╛рдВрдд рдирд┐рдХрд╛рд▓рдирд╛, рдЪреЗрд╣рд░рд╛, рдЦрд┐рд╕рд┐рдпрд╛рддрд╛ рдЪреЗрд╣рд░рд╛
ЁЯШ░ => ЁЯШ░, рдШрдмрд░рд╛рдпрд╛ рдЪреЗрд╣рд░рд╛, рдЦреБрд▓рд╛ рдореБрдВрд╣, рдардВрдбрд╛ рдкрд╕реАрдирд╛, рдЪреЗрд╣рд░рд╛
ЁЯШ▒ => ЁЯШ▒, рдбрд░рд╛ рд╣реБрдЖ рдЪреЗрд╣рд░рд╛, рдбрд░ рд╕реЗ рдЪрд┐рд▓реНрд▓рд╛рдирд╛, рдбрд░, рднрдпрднреАрдд, рдбрд░рд╛ рд╣реБрдЖ, рдЪреЗрд╣рд░рд╛
ЁЯШ│ => ЁЯШ│, рдЙрддреНрддреЗрдЬрд┐рдд, рдЙрддреНрддреЗрдЬрд┐рдд рдЪреЗрд╣рд░рд╛, рд╡рд┐рд╕реНрдордп, рдЪреЗрд╣рд░рд╛
ЁЯШ╡ => ЁЯШ╡, рдЪрдХреНрдХрд░, рдЪреЗрд╣рд░рд╛
ЁЯШб => ЁЯШб, рдЦреАрдЭ, рдЧреБрд╕реНрд╕рд╛, рдкрд╛рдЧрд▓рдкрди, рд▓рд╛рд▓ рдЪреЗрд╣рд░рд╛, рдЪреЗрд╣рд░рд╛
ЁЯШа => ЁЯШа, рдЧреБрд╕реНрд╕рд╛, рдкрд╛рдЧрд▓, рдЪреЗрд╣рд░рд╛
ЁЯШИ => ЁЯШИ, рд╕реАрдВрдЧ рд╡рд╛рд▓реА рдореБрд╕реНрдХрд╛рди, рдореБрд╕реНрдХрд╛рди, рд╕реАрдВрдЧ, рдЪреЗрд╣рд░рд╛
ЁЯС┐ => ЁЯС┐, рд╢реИрддрд╛рди, рдкрд┐рд╢рд╛рдЪ, рд░рд╛рдХреНрд╖рд╕, рдЪреЗрд╣рд░рд╛
ЁЯС╣ => ЁЯС╣, рд░рд╛рдХреНрд╖рд╕, рджреИрддреНрдп, рдУрдиреА, рдкрд░реА рдХрдерд╛, рдЪреЗрд╣рд░рд╛
ЁЯС║ => ЁЯС║, рдкрд┐рд╢рд╛рдЪ, рджреИрддреНрдп, рдЯреЗрдВрдЧреВ, рдкрд░реА рдХрдерд╛, рдЪреЗрд╣рд░рд╛
ЁЯТА => ЁЯТА, рдкрд░реА рдХрдерд╛, рд╢рд░реАрд░, рдЪреЗрд╣рд░рд╛
тШа => тШа, рдЦреЛрдкреЬреА
ЁЯС╗ => ЁЯС╗, рдкрд░реА рдХрдерд╛, рдкреНрд░реЗрдд, рдЪреЗрд╣рд░рд╛
ЁЯС╜ => ЁЯС╜, рдПрд▓рд┐рдпрди, рдпреВрдПрдлрд╝рдУ, рдкрд░реА рдХрдерд╛, рдЪреЗрд╣рд░рд╛
ЁЯС╛ => ЁЯС╛, рдПрд▓рд┐рдпрди рджреИрддреНрдп, рджреИрддреНрдп, рдпреВрдПрдлрд╝рдУ, рдкрд░реА рдХрдерд╛, рдЪреЗрд╣рд░рд╛
ЁЯдЦ => ЁЯдЦ, рдЪреЗрд╣рд░рд╛, рд░реЛрдмреЛрдЯ, рд░рд╛рдХреНрд╖рд╕
ЁЯТй => ЁЯТй, рдорд▓, рдкреВ, рд╡рд┐рд╖реНрдард╛, рдвреЗрд░
ЁЯШ║ => ЁЯШ║, рдореБрд╕реНрдХрд╛рддреА рдмрд┐рд▓реНрд▓реА рдХрд╛ рдЪреЗрд╣рд░рд╛, рдмрд┐рд▓реНрд▓реА рдХрд╛ рдЪреЗрд╣рд░рд╛, рдЦреБрд▓рд╛ рдореБрдВрд╣, рдЦреБрд▓рд╛, рдореБрдВрд╣, рдмрд┐рд▓реНрд▓реА, рдЪреЗрд╣рд░рд╛
ЁЯШ╕ => ЁЯШ╕, рдЦрд┐рд╕рд┐рдпрд╛рддреА рдмрд┐рд▓реНрд▓реА рд╡рд╛рд▓рд╛ рдЪреЗрд╣рд░рд╛, рджрд╛рдВрдд рдирд┐рдХрд╛рд▓рдирд╛, рдмрд┐рд▓реНрд▓реА рдХрд╛ рдЪреЗрд╣рд░рд╛, рдмрд┐рд▓реНрд▓реА, рдЪреЗрд╣рд░рд╛
ЁЯШ╣ => ЁЯШ╣, рдЦреБрд╢реА рдХреЗ рдЖрдВрд╕реВ, рдмрд┐рд▓реНрд▓реА рдХрд╛ рдЪреЗрд╣рд░рд╛, рдмрд┐рд▓реНрд▓реА, рдЪреЗрд╣рд░рд╛
ЁЯШ╗ => ЁЯШ╗, рдореБрд╕реНрдХрд╛рддреА рдмрд┐рд▓реНрд▓реА рдХрд╛ рдЪреЗрд╣рд░рд╛, рдкреНрдпрд╛рд░ рдореЗрдВ, рдкреНрдпрд╛рд░, рджрд┐рд▓, рдЖрдВрдЦреЗрдВ, рдмрд┐рд▓реНрд▓реА рдХрд╛ рдЪреЗрд╣рд░рд╛, рдмрд┐рд▓реНрд▓реА, рдЪреЗрд╣рд░рд╛
ЁЯШ╝ => ЁЯШ╝, рдмрд┐рд▓реНрд▓реА рдХрд╛ рдЯреЗрдврд╝рд╛ рдЪреЗрд╣рд░рд╛, рдЯреЗрдврд╝рд╛, рд╡реНрдпрдВрдЧреНрдпрдкреВрд░реНрдг рдореБрд╕реНрдХрд╛рди, рдмрд┐рд▓реНрд▓реА рдХрд╛ рдЪреЗрд╣рд░рд╛, рдмрд┐рд▓реНрд▓реА, рдЪреЗрд╣рд░рд╛
ЁЯШ╜ => ЁЯШ╜, рдЪреВрдорддреА рдмрд┐рд▓реНрд▓реА, рдЖрдВрдЦреЗрдВ рдмрдВрдж, рдЪреВрдордирд╛, рдЪреБрдВрдмрди, рдЖрдВрдЦреЗрдВ, рдмрдВрдж, рдмрд┐рд▓реНрд▓реА, рдЪреЗрд╣рд░рд╛
ЁЯЩА => ЁЯЩА, рд╕реБрд╕реНрдд рдмрд┐рд▓реНрд▓реА рдХрд╛ рдЪреЗрд╣рд░рд╛, рд╣реЗ рднрдЧрд╡рд╛рди, рд╕рдЪ рдореЗрдВ рдЖрд╢реНрдЪрд░реНрдпрдЪрдХрд┐рдд, рдмрд┐рд▓реНрд▓реА, рдЪреЗрд╣рд░рд╛
ЁЯШ┐ => ЁЯШ┐, рд░реЛрдирд╛, рд░реЛрддрд╛ рд╣реБрдЖ, рдмрд┐рд▓реНрд▓реА рдХрд╛ рдЪреЗрд╣рд░рд╛, рдмрд┐рд▓реНрд▓реА, рдЪреЗрд╣рд░рд╛
ЁЯШ╛ => ЁЯШ╛, рдЦреАрдЭрдирд╛, рдмрд┐рд▓реНрд▓реА рдХрд╛ рдЪреЗрд╣рд░рд╛, рдмрд┐рд▓реНрд▓реА, рдЪреЗрд╣рд░рд╛
ЁЯЩИ => ЁЯЩИ, рдмреБрд░рд╛ рдордд рджреЗрдЦреЛ, рдмреБрд░рд╛ рдордд рджреЗрдЦреЛ рдмрдВрджрд░, рдмрдВрджрд░, рдЧрд╛рдВрдзреА рдЬреА рдХрд╛ рдмрдиреНрджрд░
ЁЯЩЙ => ЁЯЩЙ, рдмреБрд░рд╛ рдордд рд╕реБрдиреЛ, рдмреБрд░рд╛ рдордд рд╕реБрдиреЛ рдмрдВрджрд░, рдмрдВрджрд░, рдЧрд╛рдВрдзреА рдЬреА рдХрд╛ рдмрдиреНрджрд░
ЁЯЩК => ЁЯЩК, рдмреБрд░рд╛ рдордд рдмреЛрд▓реЛ, рдмреБрд░рд╛ рдордд рдмреЛрд▓реЛ рдмрдВрджрд░, рдмрдВрджрд░, рдЧрд╛рдВрдзреА рдЬреА рдХрд╛ рдмрдиреНрджрд░
ЁЯСж => ЁЯСж, рд▓реЛрдЧ
ЁЯСз => ЁЯСз, рд▓реЛрдЧ
ЁЯСи => ЁЯСи, рд▓реЛрдЧ
ЁЯСй => ЁЯСй, рд▓реЛрдЧ
ЁЯС┤ => ЁЯС┤, рдкреБрд░реБрд╖, рдмреБрдЬреБрд░реНрдЧ, рд▓реЛрдЧ
ЁЯС╡ => ЁЯС╡, рдорд╣рд┐рд▓рд╛, рдмреБрдЬреБрд░реНрдЧ, рд▓реЛрдЧ
ЁЯС╢ => ЁЯС╢, рд▓реЛрдЧ
ЁЯС▒ => ЁЯС▒, рд╕реБрдирд╣рд░реЗ рдмрд╛рд▓, рд▓реЛрдЧ
ЁЯСо => ЁЯСо, рдкреБрд▓рд┐рд╕, рдЕрдзрд┐рдХрд╛рд░реА, рд▓реЛрдЧ
ЁЯС▓ => ЁЯС▓, рдкреБрд░реБрд╖, рдЧреБрдЖ рдкрд╛рдИ рдорд╛рдУ, рд▓реЛрдЧ
ЁЯС│ => ЁЯС│, рдкреБрд░реБрд╖, рдкрдЧрдбрд╝реА, рд▓реЛрдЧ
ЁЯС╖ => ЁЯС╖, рдирд┐рд░реНрдорд╛рдг рдХрд╛рд░реНрдп, рдирд┐рд░реНрдорд╛рдг, рд▓реЛрдЧ
тЫС => тЫС, рд╕рд╣рд╛рдпрддрд╛
ЁЯС╕ => ЁЯС╕, рдкрд░реА рдХрдерд╛, рд▓реЛрдЧ
ЁЯТВ => ЁЯТВ, рдЧрд╛рд░реНрдб, рд▓реЛрдЧ
ЁЯХ╡ => ЁЯХ╡, рдЧреБрдкреНрддрдЪрд░
ЁЯОЕ => ЁЯОЕ, рд╕рд╛рдВрддрд╛, рдлрд╝рд╛рджрд░ рдХреНрд░рд┐рд╕рдорд╕, рдХреНрд░рд┐рд╕рдорд╕, рд╕рдорд╛рд░реЛрд╣
ЁЯС╝ => ЁЯС╝, рдкрд░реА, рдкрд░реА рдХрдерд╛, рдЪреЗрд╣рд░рд╛
ЁЯТЖ => ЁЯТЖ, рдорд╛рд▓рд┐рд╢, рд╕реИрд▓реВрди
ЁЯТЗ => ЁЯТЗ, рдмреНрдпреВрдЯреА рдкрд╛рд░реНрд▓рд░, рд╕реБрдВрджрд░рддрд╛, рдкрд╛рд░реНрд▓рд░
ЁЯС░ => ЁЯС░, рджреБрд▓реНрд╣рди, рдШреВрдВрдШрдЯ, рд╢рд╛рджреА, рд╡рд┐рд╡рд╛рд╣, рд▓реЛрдЧ
ЁЯЩН => ЁЯЩН, рдирд╛рдХтАУрднреМрдВ рдЪрдврд╝рд╛рдирд╛, рд╡реНрдпрдХреНрддрд┐, рд╣рд╛рд╡рднрд╛рд╡
ЁЯЩО => ЁЯЩО, рдЦреАрдЭ, рд╡реНрдпрдХреНрддрд┐, рд╣рд╛рд╡рднрд╛рд╡
ЁЯЩЕ => ЁЯЩЕ, рдХреБрдЫ рдЕрдЪреНрдЫрд╛ рдирд╣реАрдВ рд╣реИ рднрд╛рд╡, рдХреБрдЫ рдареАрдХ рдирд╣реАрдВ, рдирд╣реАрдВ, рдирд┐рд╖рд┐рджреНрдз, рд╣рд╛рд╡рднрд╛рд╡, рдЪреЗрд╣рд░рд╛
ЁЯЩЖ => ЁЯЩЖ, рдареАрдХ рднрд╛рд╡, рдареАрдХ рд╣реИ, рд╣рд╛рд╡рднрд╛рд╡, рдЗрд╢рд╛рд░рд╛, рдЪреЗрд╣рд░рд╛
ЁЯТБ => ЁЯТБ, рд╕реВрдЪрдирд╛ рдХреЗрдВрджреНрд░, рд╕рд╣рд╛рдпрддрд╛, рд╕реВрдЪрдирд╛, рд▓реЛрдЧ
ЁЯЩЛ => ЁЯЩЛ, рдЦреБрд╢ рд╡реНрдпрдХреНрддрд┐, рд╣рд╛рде рдЙрдард╛рдирд╛, рд╣рд╛рде рдЙрдард╛рддрд╛ рд╡реНрдпрдХреНрддрд┐, рдЦреБрд╢, рд╡реНрдпрдХреНрддрд┐, рд╣рд╛рд╡рднрд╛рд╡
ЁЯЩЗ => ЁЯЩЗ, рдореБрдЭреЗ рдХреНрд╖рдорд╛ рдХрд░реЗрдВ, рдкреВрд░реА рддрд░рд╣ рдЭреБрдХрдирд╛, рдХреНрд╖рдорд╛ рдХрд░реЗрдВ, рдШреБрдЯрдиреЛрдВ рдкрд░ рдмреИрдардирд╛, рд╣рд╛рд╡рднрд╛рд╡, рд╡реНрдпрдХреНрддрд┐
ЁЯЩМ => ЁЯЩМ, рд╣реБрд░реНрд░реЗ, рджреЛрдиреЛрдВ рд╣рд╛рде, рдЙрддреНрд╕рд╡
ЁЯЩП => ЁЯЩП, рд╣рд╛рде рдЬреЛрдбрд╝рдирд╛, рдкреНрд░рд╛рд░реНрдердирд╛, рдкреНрд░рд╛рд░реНрдердирд╛ рдХрд░рдирд╛, рдкреВрдЬрд╛, рд╣рд╛рде, рдирдорд╕реНрддреЗ, рд╣рд╛рд╡рднрд╛рд╡
ЁЯЧг => ЁЯЧг, рдЪреЗрд╣рд░реЗ рдХрд╛ рдЖрдХрд╛рд░
ЁЯСд => ЁЯСд, рдКрдкрд░ рдХрд╛ рд╢рд░реАрд░, рдЫрд╛рдпрд╛, рд▓реЛрдЧ
ЁЯСе => ЁЯСе, рдКрдкрд░ рдХреЗ рд╢рд░реАрд░ рдХреА рдЫрд╛рдпрд╛, рдКрдкрд░ рдХрд╛ рд╢рд░реАрд░, рдЫрд╛рдпрд╛, рд▓реЛрдЧ
ЁЯЪ╢ => ЁЯЪ╢, рдкреИрджрд▓
ЁЯПГ => ЁЯПГ, рджреМрдбрд╝, рдореИрд░рд╛рдерди, рдЦреЗрд▓
ЁЯСп => ЁЯСп, рдЦрд░рдЧреЛрд╢ рд▓рдбрд╝рдХреА, рдЦрд░рдЧреЛрд╢ рдХреЗ рдХрд╛рди, рдорд╣рд┐рд▓рд╛, рд▓реЛрдЧ
ЁЯТГ => ЁЯТГ, рдирд░реНрддрдХ, рдиреГрддреНрдп, рд▓реЛрдЧ
ЁЯХ┤ => ЁЯХ┤, рд╡реНрдпрд╡рд╕рд╛рдп, рд╡реНрдпрдХреНрддрд┐
ЁЯТП => ЁЯТП, рдЪреВрдордирд╛, рд▓реЛрдЧ, рдкреНрдпрд╛рд░
ЁЯТС => ЁЯТС, рдЬреЛрдбрд╝реА, рджрд┐рд▓, рд▓реЛрдЧ, рдкреНрдпрд╛рд░
ЁЯСк => ЁЯСк, рдкрд┐рддрд╛, рдорд╛рддрд╛, рдмрдЪреНрдЪрд╛, рд▓реЛрдЧ
ЁЯСл => ЁЯСл, рдорд╣рд┐рд▓рд╛ рдФрд░ рдкреБрд░реБрд╖, рдЬреЛрдбрд╝реА, рд╣рд╛рде рдкрдХрдбрд╝рдирд╛, рд▓реЛрдЧ
ЁЯСм => ЁЯСм, рджреЛ рдкреБрд░реБрд╖, рдЬреЛрдбрд╝реА, рдкреБрд░реБрд╖, рд╣рд╛рде рдкрдХрдбрд╝рдирд╛, рд▓реЛрдЧ
ЁЯСн => ЁЯСн, рджреЛ рдорд╣рд┐рд▓рд╛рдПрдВ, рдЬреЛрдбрд╝реА, рдорд╣рд┐рд▓рд╛рдПрдВ, рд╣рд╛рде рдкрдХрдбрд╝рдирд╛, рд▓реЛрдЧ
ЁЯТк => ЁЯТк, рджреНрд╡рд┐рд╢рд┐рд░, рдбреЛрд▓реЗ, рдорд╛рдВрд╕рдкреЗрд╢реА, рдмрд▓рд╢рд╛рд▓реА, рд▓рдЪреАрд▓рд╛, рдХреЙрдорд┐рдХ
ЁЯСИ => ЁЯСИ, рдмрд╛рдПрдВ рдЕрдВрдЧреБрд▓рд┐, рдмрд╛рдПрдВ рдЗрд╢рд╛рд░рд╛ рдХрд░рддреА рдКрдВрдЧрд▓реА, рддрд░реНрдЬрдиреА рдЕрдВрдЧреБрд▓рд┐, рдкреАрдЫреЗ рдХрд╛ рд╣рд╛рде, рдЕрдВрдЧреБрд▓рд┐
ЁЯСЙ => ЁЯСЙ, рджрд╛рдПрдВ рдЕрдВрдЧреБрд▓рд┐, рджрд╛рдПрдВ рдЗрд╢рд╛рд░рд╛ рдХрд░рддреА рдКрдВрдЧрд▓реА, рддрд░реНрдЬрдиреА рдЕрдВрдЧреБрд▓рд┐, рдкреАрдЫреЗ рдХрд╛ рд╣рд╛рде, рдЕрдВрдЧреБрд▓рд┐
ЁЯСЖ => ЁЯСЖ, рдЕрдВрдЧреБрд▓рд┐ рдКрдкрд░, рдКрдкрд░ рдЗрд╢рд╛рд░рд╛ рдХрд░рддреА рдКрдВрдЧрд▓реА, рддрд░реНрдЬрдиреА рдЕрдВрдЧреБрд▓рд┐, рдкреАрдЫреЗ рдХрд╛ рд╣рд╛рде, рдЕрдВрдЧреБрд▓рд┐
ЁЯЦХ => ЁЯЦХ, рдкреАрдЫреЗ рдХрд╛ рд╣рд╛рде
ЁЯСЗ => ЁЯСЗ, рдЕрдВрдЧреБрд▓рд┐ рдиреАрдЪреЗ, рдиреАрдЪреЗ рдЗрд╢рд╛рд░рд╛ рдХрд░рддреА рдКрдВрдЧрд▓реА, рддрд░реНрдЬрдиреА рдЕрдВрдЧреБрд▓рд┐, рдкреАрдЫреЗ рдХрд╛ рд╣рд╛рде, рдЕрдВрдЧреБрд▓рд┐
тЬМ => тЬМ, рдХреИрдВрдЪреА, рд╡рд┐рдЬрдп, рдЬреАрдд
ЁЯЦЦ => ЁЯЦЦ, рд╡рд▓реНрдХрди рд╕реЗрд▓реНрдпреВрдЯ, рд░реЛрдорди рдЕрдЧреНрдирд┐рджреЗрд╡рддрд╛, рд╡рд┐рд╢реНрд╡рдХрд░реНрдорд╛
ЁЯЦР => ЁЯЦР, рд╣рд╛рде рдХрд╛ рдкрдВрдЬрд╛, рд░реЛрдХрдирд╛, рдмрд╕
тЬЛ => тЬЛ, рдХрд╛рдЧрдЬ
ЁЯСМ => ЁЯСМ, рдареАрдХ рдЪрд┐рд╣реНрди, рдареАрдХ, рд╣рд╛рде, рдЪрд┐рд╣реНрди
ЁЯСН => ЁЯСН, рдЕрдВрдЧреВрдард╛, рдКрдкрд░, рд╣рд╛рде, рдЪрд┐рд╣реНрди
ЁЯСО => ЁЯСО, рдЕрдВрдЧреВрдард╛, рдиреАрдЪреЗ, рд╣рд╛рде, рдЪрд┐рд╣реНрди
тЬК => тЬК, рд╣рд┐рд▓рд╛ рджрд┐рдпрд╛
ЁЯСК => ЁЯСК, рдореБрдЯреНрдареА, рд╣рд╛рде
ЁЯСЛ => ЁЯСЛ, рд╣рд╛рде, рд╣рд┐рд▓рд╛рдирд╛
ЁЯСП => ЁЯСП, рд╣рд╛рде рдХреА рддрд╛рд▓реА, рд╣рд╛рде, рддрд╛рд▓реА, рдЪрд┐рд╣реНрди
ЁЯСР => ЁЯСР, рдЦреБрд▓реЗ рд╣рд╛рде рдХрд╛ рдЪрд┐рд╣реНрди, рд╣рд╛рде, рдЦреБрд▓рд╛, рдЪрд┐рд╣реНрди
ЁЯТЕ => ЁЯТЕ, рдирд╛рдЦреВрдиреЛрдВ рдХреА рджреЗрдЦрд░реЗрдЦ, рдирд╛рдЦреВрди, рдирдЦ рдкреНрд░рд╕рд╛рдзрди, рдХреЙрд╕реНрдореЗрдЯрд┐рдХ
ЁЯСВ => ЁЯСВ, рд╢рд░реАрд░
ЁЯСГ => ЁЯСГ, рдЪреЗрд╣рд░рд╛, рд╢рд░реАрд░
ЁЯСг => ЁЯСг, рдкреИрд░, рдЫрд╛рдк, рд╢рд░реАрд░
ЁЯСА => ЁЯСА, рдЪреЗрд╣рд░рд╛
ЁЯСЕ => ЁЯСЕ, рдЪреЗрд╣рд░рд╛, рд╢рд░реАрд░
ЁЯСД => ЁЯСД, рд╣реЛрдВрда, рдЪреЗрд╣рд░рд╛, рд╢рд░реАрд░
ЁЯТЛ => ЁЯТЛ, рдЪреБрдВрдмрди рдХрд╛ рдЪрд┐рд╣реНрди, рд╣реЛрдВрда, рдкреНрдпрд╛рд░
ЁЯТШ => ЁЯТШ, рджрд┐рд▓, рддреАрд░, рдкреНрдпрд╛рд░, рднрд╛рд╡рдирд╛
ЁЯТУ => ЁЯТУ, рдзрдбрд╝рдХрдирд╛, рдзрдбрд╝рдХрди, рджрд┐рд▓, рдкреНрдпрд╛рд░, рднрд╛рд╡рдирд╛
ЁЯТФ => ЁЯТФ, рджрд┐рд▓ рдЯреВрдЯрдирд╛, рдЯреВрдЯрдирд╛, рджрд┐рд▓, рдЯреВрдЯрд╛ рд╣реБрдЖ, рднрд╛рд╡рдирд╛
ЁЯТХ => ЁЯТХ, рдкреНрд░реЗрдореА, рдкреНрдпрд╛рд░, рднрд╛рд╡рдирд╛
ЁЯТЦ => ЁЯТЦ, рдЪрдордХрджрд╛рд░ рджрд┐рд▓, рд░реЛрдорд╛рдВрдЪрд┐рдд, рдЪрдордХрдирд╛, рдкреНрдпрд╛рд░, рднрд╛рд╡рдирд╛
ЁЯТЧ => ЁЯТЧ, рдШрдмрд░рд╛рдпрд╛, рд░реЛрдорд╛рдВрдЪрд┐рдд, рджрд┐рд▓, рдкреНрдпрд╛рд░, рднрд╛рд╡рдирд╛
ЁЯТЩ => ЁЯТЩ, рдиреАрд▓рд╛, рджрд┐рд▓, рднрд╛рд╡рдирд╛
ЁЯТЪ => ЁЯТЪ, рд╣рд░рд╛, рджрд┐рд▓, рднрд╛рд╡рдирд╛
ЁЯТЫ => ЁЯТЫ, рдкреАрд▓рд╛, рджрд┐рд▓, рднрд╛рд╡рдирд╛
ЁЯТЬ => ЁЯТЬ, рдмреИрдВрдЧрдиреА, рджрд┐рд▓, рднрд╛рд╡рдирд╛
ЁЯТЭ => ЁЯТЭ, рджрд┐рд▓, рд░рд┐рдмрди, рд╡реИрд▓реЗрдВрдЯрд╛рдЗрди, рднрд╛рд╡рдирд╛
ЁЯТЮ => ЁЯТЮ, рджрд┐рд▓, рдШреВрдордирд╛, рдЖрдХрд░реНрд╖рдХ, рдХрд╛рд╡рд╛рдИ, рдкреНрдпрд╛рд░, рдкреНрдпрд╛рд░рд╛, рднрд╛рд╡рдирд╛
ЁЯТЯ => ЁЯТЯ, рджрд┐рд▓
тЭг => тЭг, рдЧрд╣рдирд╛
ЁЯТМ => ЁЯТМ, рджрд┐рд▓ рдХреЗ рдЪрд┐рд╣реНрди рд╡рд╛рд▓рд╛ рдкрддреНрд░, рдкрддреНрд░, рджрд┐рд▓, рдкреНрдпрд╛рд░
ЁЯТд => ЁЯТд, Zzz, рд╕реЛрдирд╛, рдЦрд░реНрд░рд╛рдЯреЗ рднрд░рдирд╛, рдХреЙрдорд┐рдХ, рднрд╛рд╡рдирд╛
ЁЯТв => ЁЯТв, рдЧреБрд╕реНрд╕рд╛, рдЧреБрд╕реНрд╕реИрд▓, рдХреЙрдорд┐рдХ, рднрд╛рд╡рдирд╛
ЁЯТг => ЁЯТг, рдХреЙрдорд┐рдХ, рднрд╛рд╡рдирд╛
ЁЯТе => ЁЯТе, рдЯрдХреНрдХрд░ рдХрд╛ рдЪрд┐рд╣реНрди, рдХреЙрдорд┐рдХ, рднрд╛рд╡рдирд╛
ЁЯТж => ЁЯТж, рдкрд╕реАрдирд╛, рдкрд╕реАрдиреЗрджрд╛рд░, рдХреЙрдорд┐рдХ, рднрд╛рд╡рдирд╛
ЁЯТи => ЁЯТи, рддреЗрдЬрд╝ рджреМрдбрд╝, рднрд╛рдЧрдирд╛, рджреМрдбрд╝, рдХреЙрдорд┐рдХ, рднрд╛рд╡рдирд╛
ЁЯТл => ЁЯТл, рдЪрдХреНрдХрд░, рддрд╛рд░реЗ, рдХреЙрдорд┐рдХ, рднрд╛рд╡рдирд╛
ЁЯТм => ЁЯТм, рдмреЛрд▓рдиреЗ рдХрд╛ рдЧреБрдмреНрдмрд╛рд░рд╛, рд╡рд╛рдХ рдмреБрд▓рдмреБрд▓рд╛, рдЧреБрдмреНрдмрд╛рд░рд╛, рдмреБрд▓рдмреБрд▓рд╛, рд╕рдВрд╡рд╛рдж, рдХреЙрдорд┐рдХ
ЁЯТн => ЁЯТн, рд╡рд┐рдЪрд╛рд░ рдЧреБрдмреНрдмрд╛рд░рд╛, рд╡рд┐рдЪрд╛рд░, рдмреБрд▓рдмреБрд▓рд╛, рдХреЙрдорд┐рдХ
ЁЯХ│ => ЁЯХ│, рдЧрдбреНрдврд╛
ЁЯСУ => ЁЯСУ, рдкреЛрд╖рд╛рдХ
ЁЯСФ => ЁЯСФ, рдЯрд╛рдИ, рдкреЛрд╖рд╛рдХ
ЁЯСХ => ЁЯСХ, рд╢рд░реНрдЯ, рдкреЛрд╖рд╛рдХ
ЁЯСЦ => ЁЯСЦ, рдЯреНрд░рд╛рдЙрдЬрд╝рд░, рдкреИрдВрдЯреНрд╕, рдкреЛрд╖рд╛рдХ
ЁЯСЧ => ЁЯСЧ, рдбреНрд░реЗрд╕, рд╡рди рдкреАрд╕
ЁЯСШ => ЁЯСШ, рдбреНрд░реЗрд╕, рдкреЛрд╖рд╛рдХ
ЁЯСЩ => ЁЯСЩ, рдмрд╛рдерд┐рдВрдЧ рд╕реВрдЯ, рдкреЛрд╖рд╛рдХ
ЁЯСЪ => ЁЯСЪ, рдорд╣рд┐рд▓рд╛рдУрдВ рдХреЗ рдкрд░рд┐рдзрд╛рди, рдХрдкрдбрд╝реЗ, рдкреЛрд╖рд╛рдХ
ЁЯСЫ => ЁЯСЫ, рдХреЙрдЗрди рдкрд░реНрд╕, рд╕рд┐рдХреНрдХрд╛, рдкреЛрд╖рд╛рдХ
ЁЯСЬ => ЁЯСЬ, рдмреИрдЧ, рдкреЛрд╖рд╛рдХ
ЁЯСЭ => ЁЯСЭ, рдмреИрдЧ, рдкреЛрд╖рд╛рдХ
ЁЯОТ => ЁЯОТ, рд╕реНрдХреВрд▓ рдмреИрдЧ, рдмрд╕реНрддрд╛, рд╡рд┐рджреНрдпрд╛рд▓рдп
ЁЯСЮ => ЁЯСЮ, рдкреБрд░реБрд╖реЛрдВ рдХреЗ рдЬреВрддреЗ, рдЬреВрддреЗ, рдкреЛрд╖рд╛рдХ
ЁЯСЯ => ЁЯСЯ, рдПрдерд▓реЗрдЯрд┐рдХ рдЬреВрддреЗ, рд╕реНрдиреАрдХрд░, рдЬреВрддреЗ, рдкреЛрд╖рд╛рдХ
ЁЯСа => ЁЯСа, рд╣рд╛рдИтАУрд╣реАрд▓, рдЬреВрддреЗ, рдкреЛрд╖рд╛рдХ
ЁЯСб => ЁЯСб, рдорд╣рд┐рд▓рд╛рдУрдВ рдХреЗ рд╕реИрдВрдбрд▓, рд╕реИрдВрдбрд▓, рдорд╣рд┐рд▓рд╛, рдкреЛрд╖рд╛рдХ
ЁЯСв => ЁЯСв, рдорд╣рд┐рд▓рд╛рдУрдВ рдХреЗ рдмреВрдЯ, рдмреВрдЯ, рдорд╣рд┐рд▓рд╛, рдкреЛрд╖рд╛рдХ
ЁЯСС => ЁЯСС, рдХреНрд░рд╛рдЙрди, рдкреЛрд╖рд╛рдХ
ЁЯСТ => ЁЯСТ, рдЯреЛрдк, рдкреЛрд╖рд╛рдХ
ЁЯОй => ЁЯОй, рдЯреЛрдкреА, рдордиреЛрд░рдВрдЬрди
ЁЯОУ => ЁЯОУ, рдЯреЛрдкреА, рд╕реНрдирд╛рддрдХ, рд╕рдорд╛рд░реЛрд╣
ЁЯТД => ЁЯТД, рдореЗрдХрдЕрдк, рдХреЙрд╕реНрдореЗрдЯрд┐рдХ
ЁЯТН => ЁЯТН, рдкреНрдпрд╛рд░
ЁЯТО => ЁЯТО, рд░рддреНрди, рдордгрд┐, рд╣реАрд░рд╛, рдкреНрдпрд╛рд░
ЁЯР╡ => ЁЯР╡, рдмрдВрджрд░, рдЪреЗрд╣рд░рд╛, рдкрд╢реБ
ЁЯРТ => ЁЯРТ, рдкрд╢реБ
ЁЯР╢ => ЁЯР╢, рдХреБрддреНрддрд╛, рдЪреЗрд╣рд░рд╛, рдкрд╢реБ
ЁЯРХ => ЁЯРХ, рдкрдкреА, рдкрд╢реБ
ЁЯРй => ЁЯРй, рдХреБрддреНрддрд╛, рдкрд╢реБ
ЁЯР║ => ЁЯР║, рд╕рд┐рдпрд╛рд░, рдЪреЗрд╣рд░рд╛, рдкрд╢реБ
ЁЯР▒ => ЁЯР▒, рдмрд┐рд▓реНрд▓реА, рдЪреЗрд╣рд░рд╛, рдкрд╢реБ
ЁЯРИ => ЁЯРИ, рдкрд╢реБ
ЁЯРп => ЁЯРп, рд╢реЗрд░, рдкрд╢реБ
ЁЯРЕ => ЁЯРЕ, рдкрд╢реБ
ЁЯРЖ => ЁЯРЖ, рдкрд╢реБ
ЁЯР┤ => ЁЯР┤, рдШреЛрдбрд╝рд╛, рдЪреЗрд╣рд░рд╛, рдкрд╢реБ
ЁЯРО => ЁЯРО, рдШреЛрдбрд╝рд╛, рдкрд╢реБ
ЁЯРо => ЁЯРо, рдЧрд╛рдп, рдЪреЗрд╣рд░рд╛, рдкрд╢реБ
ЁЯРВ => ЁЯРВ, рдкрд╢реБ, рд░рд╛рд╢рд┐рдЪрдХреНрд░
ЁЯРГ => ЁЯРГ, рдкрд╛рдиреА, рдЬрд▓рднреИрдВрд╕, рдкрд╢реБ
ЁЯРД => ЁЯРД, рдкрд╢реБ
ЁЯР╖ => ЁЯР╖, рд╕реБрдЕрд░, рдЪреЗрд╣рд░рд╛, рдкрд╢реБ
ЁЯРЦ => ЁЯРЦ, рдкрд╢реБ
ЁЯРЧ => ЁЯРЧ, рд╡рд░рд╛рд╣, рдкрд╢реБ
ЁЯР╜ => ЁЯР╜, рдирд╛рдХ, рд╕реБрдЕрд░, рдЪреЗрд╣рд░рд╛, рдкрд╢реБ
ЁЯРП => ЁЯРП, рдкрд╢реБ
ЁЯРС => ЁЯРС, рдкрд╢реБ
ЁЯРР => ЁЯРР, рдкрд╢реБ
ЁЯРк => ЁЯРк, рдПрдХ рдХреВрдмрдбрд╝ рд╡рд╛рд▓рд╛ рдКрдВрдЯ, рдХреВрдмрдбрд╝, рдПрдХ рдХреБрдХрдж рдКрдВрдЯ, рдкрд╢реБ
ЁЯРл => ЁЯРл, рдХреВрдмрдбрд╝, рдКрдВрдЯ, рджреЛ рдХреБрдХрдж рдКрдВрдЯ, рдкрд╢реБ
ЁЯРШ => ЁЯРШ, рдкрд╢реБ
ЁЯРн => ЁЯРн, рдЪреВрд╣реЗ рдХрд╛ рдЪреЗрд╣рд░рд╛, рдЪреВрд╣рд╛, рдЪреЗрд╣рд░рд╛, рдкрд╢реБ
ЁЯРБ => ЁЯРБ, рдкрд╢реБ
ЁЯРА => ЁЯРА, рдкрд╢реБ
ЁЯР╣ => ЁЯР╣, рдЪреВрд╣рд╛, рдЪреЗрд╣рд░рд╛, рдкрд╢реБ
ЁЯР░ => ЁЯР░, рдЦрд░рдЧреЛрд╢, рдЪреЗрд╣рд░рд╛, рдкрд╢реБ
ЁЯРЗ => ЁЯРЗ, рдмрдиреНрдиреА, рдкрд╢реБ
ЁЯР╗ => ЁЯР╗, рднрд╛рд▓реВ, рдЪреЗрд╣рд░рд╛, рдкрд╢реБ
ЁЯРи => ЁЯРи, рдХреЛрдЖрд▓рд╛ рднрд╛рд▓реВ, рдкрд╢реБ
ЁЯР╝ => ЁЯР╝, рдкрд╛рдВрдбрд╛, рдЪреЗрд╣рд░рд╛, рдкрд╢реБ
ЁЯР╛ => ЁЯР╛, рдкрдВрдЬрд╛, рдЫрд╛рдк, рдкрд╢реБ
ЁЯРФ => ЁЯРФ, рдкрд╢реБ
ЁЯРУ => ЁЯРУ, рдкрд╢реБ
ЁЯРг => ЁЯРг, рдЪреВрдЬрд╛, рдЕрдВрдбрд╛ рдлреВрдЯрдирд╛, рдмрдЪреНрдЪрд╛, рдЫреЛрдЯрд╛ рдЪреВрдЬрд╛, рдЪрд┐рдХрди, рдкрд╢реБ
ЁЯРд => ЁЯРд, рдЪреВрдЬрд╛, рд╢рд┐рд╢реБ, рдЪрд┐рдХрди, рдкрд╢реБ
ЁЯРе => ЁЯРе, рдЪреВрдЬрд╛, рд╢рд┐рд╢реБ, рдореБрд░реНрдЧреА рдХрд╛ рдмрдЪреНрдЪрд╛, рдЪрд┐рдХрди, рдкрд╢реБ
ЁЯРж => ЁЯРж, рдкрд╢реБ
ЁЯРз => ЁЯРз, рдкрд╢реБ
ЁЯХК => ЁЯХК, рдкрдХреНрд╖реА
ЁЯР╕ => ЁЯР╕, рдореЗрдврд╝рдХ, рдЪреЗрд╣рд░рд╛, рдкрд╢реБ
ЁЯРК => ЁЯРК, рдкрд╢реБ
ЁЯРв => ЁЯРв, рдкрд╢реБ
ЁЯРН => ЁЯРН, рдкрд╢реБ
ЁЯР▓ => ЁЯР▓, рджреИрддреНрдп, рдЪреЗрд╣рд░рд╛, рдкрд╢реБ
ЁЯРЙ => ЁЯРЙ, рдкрд╢реБ
ЁЯР│ => ЁЯР│, рдлреБрд╣рд╛рд░ рдЫреЛрдбрд╝рдирд╛, рд╡реНрд╣реЗрд▓, рдкрд╢реБ
ЁЯРЛ => ЁЯРЛ, рдкрд╢реБ
ЁЯРм => ЁЯРм, рдкрд╢реБ
ЁЯРЯ => ЁЯРЯ, рдкрд╢реБ
ЁЯРа => ЁЯРа, рдордЫрд▓реА, рдкрд╢реБ
ЁЯРб => ЁЯРб, рдордЫрд▓реА, рдкрд╢реБ
ЁЯРЩ => ЁЯРЩ, рдСрдХреНрдЯреЛрдкрд╕, рдкрд╢реБ
ЁЯРЪ => ЁЯРЪ, рд╢рдВрдЦ, рдкрд╢реБ
ЁЯжА => ЁЯжА, рдХрд░реНрдХ рд░рд╛рд╢рд┐
ЁЯРМ => ЁЯРМ, рдкрд╢реБ
ЁЯРЫ => ЁЯРЫ, рдХреАрдбрд╝рд╛, рдХрдирдЦрдЬреВрд░рд╛, рдкрд╢реБ
ЁЯРЬ => ЁЯРЬ, рдкрд╢реБ
ЁЯРЭ => ЁЯРЭ, рдордХреНрдЦреА, рдкрд╢реБ
ЁЯРЮ => ЁЯРЮ, рдЗрдВрджреНрд░рдЧреЛрдк, рд╕реНрддреНрд░реА, рднреГрдВрдЧ, рдкрд╢реБ
ЁЯХ╖ => ЁЯХ╖, рдХреАрдЯ
ЁЯХ╕ => ЁЯХ╕, рдЬрд╛рд▓рд╛
ЁЯжВ => ЁЯжВ, рдкрд╢реВ, рдмрд┐рдЪреНрдЫреВ, рд╡реГрд╢реНрдЪрд┐рдХ рд░рд╛рд╢рд┐
ЁЯТР => ЁЯТР, рдмреБрдХреЗ, рдлреВрд▓, рдлреВрд▓рдЧреБрдЪреНрдЫ, рдкреНрдпрд╛рд░
ЁЯМ╕ => ЁЯМ╕, рдЪреИрд░реА, рдлреВрд▓ рджреЗрдЦрдирд╛, рдлреВрд▓
ЁЯТо => ЁЯТо, рдмрд╣реБрдд рдЕрдЪреНрдЫреЗ рдХрд╛рдо рдХреА рдЫрд╛рдк, рдлреВрд▓, рдЫрд╛рдк
ЁЯП╡ => ЁЯП╡, рдкреБрд╖реНрдк, рд░рд┐рдмрди рдХрд╛ рдкреБрд╖реНрдк
ЁЯМ╣ => ЁЯМ╣, рдЧреБрд▓рд╛рдм, рдлреВрд▓
ЁЯМ║ => ЁЯМ║, рдЧреБрдбрд╝рд╣рд▓, рдЕрдбрд╝рд╣реБрд▓, рдЬрдкрд╛рдкреБрд╖реНрдк, рд╣рд┐рдмрд┐рд╕реНрдХрд╕, рдлреВрд▓
ЁЯМ╗ => ЁЯМ╗, рд╕рдирдлрд╝реНрд▓реЙрд╡рд░, рдлреВрд▓
ЁЯМ╝ => ЁЯМ╝, рдлреВрд▓, рдкреБрд╖реНрдк рдкреБрдВрдЬ
ЁЯМ╖ => ЁЯМ╖, рдЯреНрдпреВрд▓рд┐рдк, рдлреВрд▓
ЁЯМ▒ => ЁЯМ▒, рдпреБрд╡рд╛ рдкреМрдзрд╛, рдпреБрд╡рд╛
ЁЯМ▓ => ЁЯМ▓, рд╕рджрд╛рдмрд╣рд╛рд░, рд╡реГрдХреНрд╖, рдкреЗрдбрд╝
ЁЯМ│ => ЁЯМ│, рдЫрд╛рдпрд╛, рдкрд░реНрдгрдкрд╛рддреА, рд╡реГрдХреНрд╖
ЁЯМ┤ => ЁЯМ┤, рддрд╛рдбрд╝, рд╡реГрдХреНрд╖
ЁЯМ╡ => ЁЯМ╡, рдкреМрдзрд╛
ЁЯМ╛ => ЁЯМ╛, рдЪрд╛рд╡рд▓ рдХреА рдмрд╛рд▓реА, рдЪрд╛рд╡рд▓, рдмрд╛рд▓реА
ЁЯМ┐ => ЁЯМ┐, рдЬрдбрд╝реАтАУрдмреВрдЯреА, рдкрддреНрддреА
тШШ => тШШ, рдкреМрдзрд╛, рддреАрди рдкрддреНрддрд┐рдпрд╛рдВ
ЁЯНА => ЁЯНА, рдЪрд╛рд░, рдкрддреНрддреА, рддрд┐рдкрддрд┐рдпрд╛, рднрд╛рдЧреНрдпрд╢рд╛рд▓реА
ЁЯНБ => ЁЯНБ, рдЪрд┐рдирд╛рд░ рдХреА рдкрддреНрддреА, рдЧрд┐рд░реА рд╣реБрдИ рдкрддреНрддреА, рдкрддреНрддрд╛
ЁЯНВ => ЁЯНВ, рдЧрд┐рд░рддрд╛ рд╣реБрдЖ рдкрддреНрддрд╛, рдЧрд┐рд░рд╛ рд╣реБрдЖ рдкрддреНрддрд╛, рдЧрд┐рд░рддрд╛ рд╣реБрдЖ, рдЧрд┐рд░реА рд╣реБрдИ рдкрддреНрддреА, рдкрддреНрддреА, рдкрддреНрддрд┐рдпрд╛рдВ
ЁЯНГ => ЁЯНГ, рд╣рд╡рд╛ рдореЗрдВ рдкрддреНрддреА, рдЧрд┐рд░рддреА рдкрддреНрддреА, рдкрддреНрддреА, рд╣рд╡рд╛, рдЧрд┐рд░рддрд╛ рд╣реБрдЖ
ЁЯНЗ => ЁЯНЗ, рдЕрдВрдЧреВрд░, рдлрд▓
ЁЯНИ => ЁЯНИ, рдЦрд░рдмреВрдЬрд╛, рдлрд▓
ЁЯНЙ => ЁЯНЙ, рддрд░рдмреВрдЬ, рдлрд▓
ЁЯНК => ЁЯНК, рд╕рдВрддрд░рд╛, рдирд╛рд░рдВрдЧреА, рдлрд▓
ЁЯНЛ => ЁЯНЛ, рдЪрдХреЛрддрд░рд╛, рдлрд▓
ЁЯНМ => ЁЯНМ, рдХреЗрд▓рд╛, рдлрд▓
ЁЯНН => ЁЯНН, рдЕрдиреНрдирд╛рдирд╛рд╕, рдлрд▓
ЁЯНО => ЁЯНО, рд▓рд╛рд▓ рд╕реЗрдм, рд╕реЗрд╡рдлрд▓, рд▓рд╛рд▓, рдлрд▓
ЁЯНП => ЁЯНП, рд╣рд░рд╛ рд╕реЗрдм, рд╕реЗрд╡рдлрд▓, рд╣рд░рд╛, рдлрд▓
ЁЯНР => ЁЯНР, рдирд╛рд╢рдкрд╛рддреА, рдлрд▓
ЁЯНС => ЁЯНС, рдлрд▓
ЁЯНТ => ЁЯНТ, рдЖрд▓реВрдмрд╛рд▓реВ, рдлрд▓
ЁЯНУ => ЁЯНУ, рд╣рд┐рд╕рд╛рд▓реВ, рдмреЗрд░реА, рдлрд▓
ЁЯНЕ => ЁЯНЕ, рд╕рдмреНрдЬреА
ЁЯНЖ => ЁЯНЖ, рдмреЗрдВрдЧрди, рд╕рдмреНрдЬреА
ЁЯМ╜ => ЁЯМ╜, рднреБрдЯреНрдЯрд╛, рдордХрдИ рдХрд╛ рднреБрдЯреНрдЯрд╛, рдордХреНрдХрд╛
ЁЯМ░ => ЁЯМ░, рд╢рд╛рд╣рдмрд▓реВрдд
ЁЯНЮ => ЁЯНЮ, рдмреНрд░реЗрдб рд▓реЛрдлрд╝, рд░реЗрд╕реНрдЯреЛрд░реЗрдВрдЯ
ЁЯНЦ => ЁЯНЦ, рдорд╛рдВрд╕, рд░реЗрд╕реНрдЯреЛрд░реЗрдВрдЯ
ЁЯНЧ => ЁЯНЧ, рдореБрд░реНрдЧреАрдкрд╛рд▓рди, рдореБрд░реНрдЧреА рдХреА рдЯрд╛рдВрдЧ
ЁЯНФ => ЁЯНФ, рдмрд░реНрдЧрд░, рд░реЗрд╕реНрдЯреЛрд░реЗрдВрдЯ
ЁЯНЯ => ЁЯНЯ, рдлрд╝реНрд░рд╛рдЗрд╕, рд░реЗрд╕реНрдЯреЛрд░реЗрдВрдЯ
ЁЯНХ => ЁЯНХ, рдкрд┐рдЬрд╝реНрдЬрд╝рд╛, рд╕реНрд▓рд╛рдЗрд╕, рд░реЗрд╕реНрдЯреЛрд░реЗрдВрдЯ
ЁЯН▓ => ЁЯН▓, рд╕реНрдЯреНрдпреВ, рднреЛрдЬрди рдкрд╛рддреНрд░, рд░реЗрд╕реНрдЯреЛрд░реЗрдВрдЯ
ЁЯН▒ => ЁЯН▒, рдмреИрдВрдЯреЛ, рдмреИрдВрдЯреЛ рдмреЙрдХреНрд╕, рдмреЙрдХреНрд╕, рд░реЗрд╕реНрдЯреЛрд░реЗрдВрдЯ
ЁЯНШ => ЁЯНШ, рдЪрд╛рд╡рд▓
ЁЯНЩ => ЁЯНЩ, рдУрдирд┐рдЧрд┐рд░реА, рдЪрд╛рд╡рд▓, рд░реЗрд╕реНрдЯреЛрд░реЗрдВрдЯ
ЁЯНЪ => ЁЯНЪ, рдЪрд╛рд╡рд▓, рд░реЗрд╕реНрдЯреЛрд░реЗрдВрдЯ
ЁЯНЫ => ЁЯНЫ, рдХрдбрд╝реАтАУрдЪрд╛рд╡рд▓, рдХрдбрд╝реА, рдЪрд╛рд╡рд▓, рд░реЗрд╕реНрдЯреЛрд░реЗрдВрдЯ
ЁЯНЬ => ЁЯНЬ, рд░реИрдорди, рдиреВрдбрд▓ рдмрд╛рдЙрд▓, рдиреВрдбрд▓, рдЙрдмрд▓реЗ рдиреВрдбрд▓, рднрд╛рдк, рдмрд╛рдЙрд▓, рд░реЗрд╕реНрдЯреЛрд░реЗрдВрдЯ
ЁЯНЭ => ЁЯНЭ, рд╕реБрдзрд┐рд░рд╛, рдкрд╛рд╕реНрддрд╛, рд░реЗрд╕реНрдЯреЛрд░реЗрдВрдЯ
ЁЯНа => ЁЯНа, рд╕рд┐рдХреЗ рдЖрд▓реВ, рд╢рдХрд░рдХрдВрдж, рдореАрдард╛, рд╕рд┐рдХрд╛ рд╣реБрдЖ, рд░реЗрд╕реНрдЯреЛрд░реЗрдВрдЯ
ЁЯНв => ЁЯНв, рд╕реАрдлрд╝реВрдб рд╕реНрдЯрд┐рдХ, рд╕рдореБрджреНрд░реА рднреЛрдЬрди, рд╕реНрдЯрд┐рдХ, рд░реЗрд╕реНрдЯреЛрд░реЗрдВрдЯ
ЁЯНг => ЁЯНг, рд░реЗрд╕реНрдЯреЛрд░реЗрдВрдЯ
ЁЯНд => ЁЯНд, рддрд▓реЗ рдЭреАрдВрдЧреЗ, рдЭреАрдВрдЧрд╛, рд░реЗрд╕реНрдЯреЛрд░реЗрдВрдЯ, рд╢реНрд░рд┐рдВрдк
ЁЯНе => ЁЯНе, рдлрд╝рд┐рд╢ рдХреЗрдХ, рдордЫрд▓реА, рд░реЗрд╕реНрдЯреЛрд░реЗрдВрдЯ
ЁЯНб => ЁЯНб, рдореЛрдЪреА, рдореЛрдЪреА рдмреЙрд▓, рдореЛрдЪреА рдмреЙрд▓ рд╕реНрдЯрд┐рдХ, рд░реЗрд╕реНрдЯреЛрд░реЗрдВрдЯ
ЁЯНж => ЁЯНж, рдирд░рдо рдЖрдЗрд╕рдХреНрд░реАрдо, рдЖрдЗрд╕рдХреНрд░реАрдо, рд╕реЙрдлрд╝реНрдЯ рд╕рд░реНрд╡, рдХреНрд░реАрдо, рд░реЗрд╕реНрдЯреЛрд░реЗрдВрдЯ
ЁЯНз => ЁЯНз, рдЪреВрд░рд╛, рд░реЗрд╕реНрдЯреЛрд░реЗрдВрдЯ
ЁЯНи => ЁЯНи, рдЖрдЗрд╕, рдХреНрд░реАрдо, рд░реЗрд╕реНрдЯреЛрд░реЗрдВрдЯ
ЁЯНй => ЁЯНй, рд░реЗрд╕реНрдЯреЛрд░реЗрдВрдЯ
ЁЯНк => ЁЯНк, рд░реЗрд╕реНрдЯреЛрд░реЗрдВрдЯ
ЁЯОВ => ЁЯОВ, рдЬрдиреНрдорджрд┐рди, рдХреЗрдХ, рд╕рдорд╛рд░реЛрд╣
ЁЯН░ => ЁЯН░, рдХреЗрдХ рд╕реНрд▓рд╛рдЗрд╕, рдХреЗрдХ, рд░реЗрд╕реНрдЯреЛрд░реЗрдВрдЯ
ЁЯНл => ЁЯНл, рдЪреЙрдХрд▓реЗрдЯ, рдмрд╛рд░, рд░реЗрд╕реНрдЯреЛрд░реЗрдВрдЯ
ЁЯНм => ЁЯНм, рд░реЗрд╕реНрдЯреЛрд░реЗрдВрдЯ
ЁЯНн => ЁЯНн, рдХреИрдВрдбреА, рд░реЗрд╕реНрдЯреЛрд░реЗрдВрдЯ
ЁЯНо => ЁЯНо, рдкреБрдбрд┐рдВрдЧ, рд░реЗрд╕реНрдЯреЛрд░реЗрдВрдЯ
ЁЯНп => ЁЯНп, рд╢рд╣рдж, рд╣рдиреАрдкреЙрдЯ, рд░реЗрд╕реНрдЯреЛрд░реЗрдВрдЯ
ЁЯН╝ => ЁЯН╝, рдмреЗрдмреА рдмреЛрддрд▓, рджреВрдз, рдмреЛрддрд▓, рдкреЗрдп
тШХ => тШХ, рдЧрд░реНрдо рдкреЗрдп, рдХреЙреЮреА, рднрд╛рдк рд╡рд╛рд▓рд╛ рдЧрд░реНрдо рдкреЗрдп
ЁЯН╡ => ЁЯН╡, рдЪрд╛рдп рдХрд╛ рдкреНрдпрд╛рд▓рд╛, рдЪрд╛рдп, рдкреЗрдп
ЁЯН╢ => ЁЯН╢, рд╕реЗрдХ, рд╕реЗрдХ рдмреЛрддрд▓ рдФрд░ рдХрдк, рдХрдк, рдмреЛрддрд▓, рдкреЗрдп, рд░реЗрд╕реНрдЯреЛрд░реЗрдВрдЯ, рдмрд╛рд░
ЁЯН╛ => ЁЯН╛, рдЬрд╢реНрди, рдкрд╛рд░реНрдЯреА
ЁЯН╖ => ЁЯН╖, рд╢рд░рд╛рдм, рдорджрд┐рд░рд╛, рд╡рд╛рдЗрди, рдЧрд┐рд▓рд╛рд╕, рдкреЗрдп, рд░реЗрд╕реНрдЯреЛрд░реЗрдВрдЯ, рдмрд╛рд░
ЁЯН╕ => ЁЯН╕, рдХреЙрдХрдЯреЗрд▓, рд░реЗрд╕реНрдЯреЛрд░реЗрдВрдЯ, рдмрд╛рд░
ЁЯН╣ => ЁЯН╣, рдКрд╖реНрдгрдХрдЯрд┐рдмрдВрдзреАрдп, рдкреЗрдп, рд░реЗрд╕реНрдЯреЛрд░реЗрдВрдЯ, рдмрд╛рд░
ЁЯН║ => ЁЯН║, рдмрд┐рдпрд░, рдмрд┐рдпрд░ рдордЧ, рдордЧ, рд░реЗрд╕реНрдЯреЛрд░реЗрдВрдЯ, рдмрд╛рд░
ЁЯН╗ => ЁЯН╗, рдмрд┐рдпрд░ рдХреЗ рдордЧ, рдмрд┐рдпрд░, рдордЧ, рджреЛ рдордЧ, рд░реЗрд╕реНрдЯреЛрд░реЗрдВрдЯ, рдмрд╛рд░
ЁЯН┤ => ЁЯН┤, рдЫреБрд░реАтАУрдЪрд╛рдХреВ, рдлрд╝реЛрд░реНрдХ, рдирд╛рдЗрдлрд╝, рд░реЗрд╕реНрдЯреЛрд░реЗрдВрдЯ
ЁЯН│ => ЁЯН│, рдлрд╝реНрд░рд╛рдЗрдВрдЧ рдкреИрди, рд░реЗрд╕реНрдЯреЛрд░реЗрдВрдЯ
ЁЯП║ => ЁЯП║, рд╢рд░рд╛рдм рдХрд╛ рдХрдВрдЯреЗрдирд░, рдЬрдЧ
ЁЯМН => ЁЯМН, рдЧреНрд▓реЛрдм, рдкреГрдереНрд╡реА, рдпреВрд░реЛрдк, рдЕрдлрд╝реНрд░реАрдХрд╛
ЁЯМО => ЁЯМО, рдЧреНрд▓реЛрдм, рдкреГрдереНрд╡реА, рдЕрдореЗрд░рд┐рдХрд╛рдЬрд╝, рдЕрдореЗрд░рд┐рдХрд╛
ЁЯМП => ЁЯМП, рдЧреНрд▓реЛрдм, рдкреГрдереНрд╡реА, рдПрд╢рд┐рдпрд╛, рдСрд╕реНрдЯреНрд░реЗрд▓рд┐рдпрд╛
ЁЯМР => ЁЯМР, рдЧреНрд▓реЛрдм, рд╡рд┐рд╢реНрд╡ рд░реЗрдЦрд╛рдПрдВ
ЁЯЧ║ => ЁЯЧ║, рд╡рд┐рд╢реНрд╡ рдорд╛рдирдЪрд┐рддреНрд░, рд╡рд┐рд╢реНрд╡
ЁЯПФ => ЁЯПФ, рдмрд░реНрдлреАрд▓реЗ рд╢рд┐рдЦрд░ рд╡рд╛рд▓рд╛ рдкрд░реНрд╡рдд, рдмрд░реНрдл
ЁЯМЛ => ЁЯМЛ, рдЬреНрд╡рд╛рд▓рд╛рдореБрдЦреА, рдЬреНрд╡рд╛рд▓рд╛рдореБрдЦреА рд╡рд┐рд╕реНрдлреЛрдЯ
ЁЯЧ╗ => ЁЯЧ╗, рдкрд╣рд╛рдбрд╝реА
ЁЯПХ => ЁЯПХ, рддрдВрдмреВ, рддрдВрдмреВ рд▓рдЧрд╛рдирд╛
ЁЯПЦ => ЁЯПЦ, рдЫрд╛рддреЗ рдХреЗ рд╕рд╛рде рд╕рдореБрджреНрд░реА рдХрд┐рдирд╛рд░рд╛, рдЫрд╛рддрд╛
ЁЯПЬ => ЁЯПЬ, рд░реЗрдЧрд┐рд╕реНрддрд╛рди, рдорд░реБрд╕реНрдерд▓
ЁЯПЭ => ЁЯПЭ, рд░реЗрдЧрд┐рд╕реНрддрд╛рди рдореЗрдВ рджреНрд╡реАрдк, рджреНрд╡реАрдк
ЁЯПЮ => ЁЯПЮ, рдмрдЧреАрдЪрд╛, рдЙрджреНрдпрд╛рди
ЁЯПШ => ЁЯПШ, рдШрд░ рдХреА рдЗрдорд╛рд░рддреЗрдВ, рднрд╡рди
ЁЯПЪ => ЁЯПЪ, рд╡реАрд░рд╛рди рдШрд░ рдХрд╛ рднрд╡рди, рдЕрдХреЗрд▓реА рдЗрдорд╛рд░рдд
ЁЯПа => ЁЯПа, рдШрд░, рднрд╡рди
ЁЯПб => ЁЯПб, рдШрд░, рдЧреГрд╣, рдмрдЧреАрдЪрд╛, рднрд╡рди
тЫк => тЫк, рдЪрд░реНрдЪ, рднрд╡рди
ЁЯХЛ => ЁЯХЛ, рдХрд╛рдмрд╛, рдореБрд╕реНрд▓рд┐рдо, рдзрд░реНрдо
ЁЯХМ => ЁЯХМ, рдорд╕реНрдЬрд┐рдж, рдЗрд╕реНрд▓рд╛рдо, рдзрд░реНрдо
ЁЯХН => ЁЯХН, рдордВрджрд┐рд░
тЫй => тЫй, рд╢рд┐рдВрдЯреЛ рд╢реНрд░рд╛рдЗрди, рдЬрд╛рдкрд╛рдиреА рдзрд░реНрдо рд╕реНрдерд▓
ЁЯПв => ЁЯПв, рдХрд╛рд░реНрдпрд╛рд▓рдп рдХрд╛ рднрд╡рди, рдХрд╛рд░реНрдпрд╛рд▓рдп, рднрд╡рди
ЁЯПг => ЁЯПг, рдбрд╛рдХрдШрд░, рдЬрд╛рдкрд╛рдиреА рдбрд╛рдХрдШрд░, рдЬрд╛рдкрд╛рдиреА, рдбрд╛рдХ, рднрд╡рди
ЁЯПд => ЁЯПд, рдбрд╛рдХрдШрд░, рдпреВрд░реЛрдкреАрдп рдбрд╛рдХрдШрд░, рдпреВрд░реЛрдкреАрдп, рдбрд╛рдХ, рднрд╡рди
ЁЯПе => ЁЯПе, рднрд╡рди
ЁЯПж => ЁЯПж, рдмреИрдВрдХ, рднрд╡рди
ЁЯПи => ЁЯПи, рд╣реЛрдЯрд▓, рднрд╡рди
ЁЯПй => ЁЯПй, рдкреНрдпрд╛рд░, рд╣реЛрдЯрд▓, рднрд╡рди
ЁЯПк => ЁЯПк, рд╕реБрд╡рд┐рдзрд╛, рджреБрдХрд╛рди, рднрд╡рди
ЁЯПл => ЁЯПл, рд╕реНрдХреВрд▓ рднрд╡рди, рднрд╡рди
ЁЯПм => ЁЯПм, рдХрд┐рд░рд╛рдирд╛, рд╕реНрдЯреЛрд░
ЁЯПн => ЁЯПн, рдлрд╝реИрдХреНрдЯрд░реА, рднрд╡рди
ЁЯПп => ЁЯПп, рджреБрд░реНрдЧ, рднрд╡рди
ЁЯП░ => ЁЯП░, рджреБрд░реНрдЧ, рднрд╡рди
ЁЯТТ => ЁЯТТ, рд╡рд┐рд╡рд╛рд╣, рдкреНрд░рд╛рд░реНрдердирд╛рд▓рдп, рдкреНрдпрд╛рд░
ЁЯЧ╝ => ЁЯЧ╝, рдЯреЛрдХреНрдпреЛ, рдЯреЙрд╡рд░
ЁЯЧ╜ => ЁЯЧ╜, рдореВрд░реНрддрд┐, рд▓рд┐рдмрд░реНрдЯреА
ЁЯЧ╛ => ЁЯЧ╛, рдирдХреНрд╢рд╛, рдЬрд╛рдкрд╛рди
тЫ║ => тЫ║, рдЯреЗрдВрдЯ, рдХреИрдВрдкрд┐рдВрдЧ
ЁЯМБ => ЁЯМБ, рдХреБрд╣рд╛рд╕рд╛, рдХреЛрд╣рд░рд╛
ЁЯМГ => ЁЯМГ, рд░рд╛рдд рдХреЗ рддрд╛рд░реЗ, рддрд╛рд░реЗ, рд░рд╛рдд
ЁЯМД => ЁЯМД, рд╕реВрд░реНрдпреЛрджрдп, рд╕реБрдмрд╣ рдХрд╛ рд╕реВрд░реНрдп, рдкрд╣рд╛рдбрд╝, рд╕реБрдкреНрд░рднрд╛рдд
ЁЯМЕ => ЁЯМЕ, рд╕реВрд░реНрдпреЛрджрдп, рд╕реБрдмрд╣ рдХрд╛ рд╕реВрд░рдЬ
ЁЯМЖ => ЁЯМЖ, рдЧреЛрдзреВрд▓рд┐, рд╢рд╛рдо, рд╕реВрд░реНрдпрд╛рд╕реНрдд, рд╢рд╣рд░, рдЗрдорд╛рд░рдд, рднрд╡рди, рд▓реИрдВрдбрд╕реНрдХреЗрдк
ЁЯМЗ => ЁЯМЗ, рд╕рдВрдзреНрдпрд╛рдХрд╛рд▓, рдЗрдорд╛рд░рддреЛрдВ рдХреЗ рдкреАрдЫреЗ рд╕реВрд░реНрдпрд╛рд╕реНрдд, рднрд╡рди
ЁЯМЙ => ЁЯМЙ, рдкреБрд▓ рдФрд░ рд░рд╛рдд, рд░рд╛рдд
тЩи => тЩи, рднрд╛рдк рдпреБрдХреНрдд, рдЧрд░реНрдо
ЁЯММ => ЁЯММ, рджреВрдзрд┐рдпрд╛
ЁЯОа => ЁЯОа, рдЭреВрд▓рд╛, рдШреЛрдбрд╝рд╛, рдордиреЛрд░рдВрдЬрди
ЁЯОб => ЁЯОб, рдмрдбрд╝рд╛ рдКрдВрдЪрд╛ рдЭреВрд▓рд╛, рдлрд╝реЗрд░реАрдЬ, рдЭреВрд▓рд╛, рдордиреЛрд░рдВрдЬрди рдкрд╛рд░реНрдХ, рдордиреЛрд░рдВрдЬрди
ЁЯОв => ЁЯОв, рд░реЛрд▓рд░, рдХреЛрд╕реНрдЯрд░, рдордиреЛрд░рдВрдЬрди рдкрд╛рд░реНрдХ, рдордиреЛрд░рдВрдЬрди
ЁЯТИ => ЁЯТИ, рдирд╛рдИ рдХреА рджреБрдХрд╛рди, рдирд╛рдИ, рдкреЛрд▓
ЁЯОк => ЁЯОк, рд╕рд░реНрдХрд╕, рдЯреЗрдВрдЯ, рдордиреЛрд░рдВрдЬрди
ЁЯОн => ЁЯОн, рдирдХрд╛рдм, рдорд╛рд╕реНрдХ, рдкреНрд░рджрд░реНрд╢рди рдХрд▓рд╛, рдореБрдЦреМрдЯрд╛, рдХрд▓рд╛, рдордиреЛрд░рдВрдЬрди, рдкреНрд░рджрд░реНрд╢рди
ЁЯЦ╝ => ЁЯЦ╝, рдЪрд┐рддреНрд░, рдкреЗрдВрдЯрд┐рдВрдЧ
ЁЯОи => ЁЯОи, рд░рдВрдЧ рдкрдЯреНрдЯрд┐рдХрд╛, рдХрд▓рд╛рдХрд╛рд░ рдкреИрд▓реЗрдЯ, рдкреИрд▓реЗрдЯ, рдХрд▓рд╛рдХрд╛рд░, рдкреЗрдВрдЯ, рдХрд▓рд╛
ЁЯО░ => ЁЯО░, рд╕реНрд▓реЙрдЯ, рдЧреЗрдо
ЁЯЪВ => ЁЯЪВ, рднрд╛рдк рдЗрдВрдЬрди, рд▓реЛрдХреЛрдореЛрдЯрд┐рд╡, рдЯреНрд░реЗрди, рд╡рд╛рд╣рди
ЁЯЪГ => ЁЯЪГ, рдЯреНрд░реЗрди, рдмрд┐рдЬрд▓реА рд╡рд╛рд▓реА рдЯреНрд░реЗрди, рд░реЗрд▓рд╡реЗ рдХрд╛рд░, рдмрд┐рдЬрд▓реА, рд░реЗрд▓рд╡реЗ, рдЯреНрд░рд╛рдо, рд╡рд╛рд╣рди
ЁЯЪД => ЁЯЪД, рддреЗрдЬрд╝ рдЧрддрд┐ рд╡рд╛рд▓реА рдЯреНрд░реЗрди, рд╢рд┐рдВрдХрд╛рдирд╕реЗрди, рдЯреНрд░реЗрди, рд░реЗрд▓, рд╡рд╛рд╣рди
ЁЯЪЕ => ЁЯЪЕ, рддреЗрдЬрд╝ рдЧрддрд┐ рд╡рд╛рд▓реА рдЯреНрд░реЗрди, рдмреБрд▓реЗрдЯ рдиреЛрдЬрд╝, рдмреБрд▓реЗрдЯ рдиреЛрдЬрд╝ рдХреЗ рд╕рд╛рде рд╢рд┐рдВрдХрд╛рдирд╕реЗрди, рдЯреНрд░реЗрди, рд░реЗрд▓, рд╡рд╛рд╣рди
ЁЯЪЖ => ЁЯЪЖ, рд░реЗрд▓рд╡реЗ, рд╡рд╛рд╣рди
ЁЯЪЗ => ЁЯЪЗ, рд╕рдмрд╡реЗ, рдореЗрдЯреНрд░реЛ, рд╡рд╛рд╣рди
ЁЯЪИ => ЁЯЪИ, рд╣рд▓реНрдХреА, рд░реЗрд▓, рд╡рд╛рд╣рди
ЁЯЪЙ => ЁЯЪЙ, рдЯреНрд░реЗрди, рд╕реНрдЯреЗрд╢рди
ЁЯЪК => ЁЯЪК, рд╡рд╛рд╣рди
ЁЯЪЭ => ЁЯЪЭ, рд╡рд╛рд╣рди
ЁЯЪЮ => ЁЯЪЮ, рдкрд╣рд╛рдбрд╝реА рдХреЗрдмрд▓ рдХрд╛рд░, рдкрд╣рд╛рдбрд╝реА рд░реЗрд▓рд╡реЗ, рдХрд╛рд░, рд╡рд╛рд╣рди
ЁЯЪЛ => ЁЯЪЛ, рдЯреНрд░рд╛рдо, рдХрд╛рд░, рд╡рд╛рд╣рди
ЁЯЪМ => ЁЯЪМ, рд╡рд╛рд╣рди
ЁЯЪН => ЁЯЪН, рдмрд╕, рдЖрддреА рд╣реБрдИ, рд╡рд╛рд╣рди
ЁЯЪО => ЁЯЪО, рдмрд╕, рдЯреНрд░реЙрд▓реА, рд╡рд╛рд╣рди
ЁЯЪП => ЁЯЪП, рд╕реНрдЯреЙрдк, рдмрд╕
ЁЯЪР => ЁЯЪР, рдмрд╕, рд╡рд╛рд╣рди
ЁЯЪС => ЁЯЪС, рд╡рд╛рд╣рди
ЁЯЪТ => ЁЯЪТ, рдЕрдЧреНрдирд┐рд╢рд╛рдордХ, рджрдордХрд▓, рдлрд╝рд╛рдпрд░ рдЯреНрд░рдХ, рдЖрдЧ, рдЗрдВрдЬрди, рд╡рд╛рд╣рди
ЁЯЪУ => ЁЯЪУ, рдЧрд╢реНрддреА рджрд▓, рдкреБрд▓рд┐рд╕, рд╡рд╛рд╣рди
ЁЯЪФ => ЁЯЪФ, рдкреБрд▓рд┐рд╕ рдХрд╛рд░, рдкреБрд▓рд┐рд╕, рд╡рд╛рд╣рди
ЁЯЪХ => ЁЯЪХ, рд╡рд╛рд╣рди
ЁЯЪЦ => ЁЯЪЦ, рдЯреИрдХреНрд╕реА, рд╡рд╛рд╣рди
ЁЯЪЧ => ЁЯЪЧ, рдХрд╛рд░, рдСрдЯреЛрдореЛрдмрд╛рдЗрд▓, рд╡рд╛рд╣рди
ЁЯЪШ => ЁЯЪШ, рдЖрддрд╛ рд╣реБрдЖ рдСрдЯреЛрдореЛрдмрд╛рдЗрд▓, рдХрд╛рд░, рдСрдЯреЛрдореЛрдмрд╛рдЗрд▓, рдЖрддрд╛ рд╣реБрдЖ, рд╡рд╛рд╣рди
ЁЯЪЩ => ЁЯЪЩ, рдЖрд░рд╡реА, рдХрд╛рд░, рд╡рд╛рд╣рди
ЁЯЪЪ => ЁЯЪЪ, рдЯреНрд░рдХ, рд╡рд╛рд╣рди
ЁЯЪЫ => ЁЯЪЫ, рд▓реЙрд░реА, рд╕реЗрдореА, рдЖрд░реНрдЯрд┐рдХреНрдпреВрд▓реЗрдЯреЗрдб рд▓реЙрд░реА, рдЯреНрд░рдХ, рдЯреНрд░реЗрд▓рд░, рд╡рд╛рд╣рди
ЁЯЪЬ => ЁЯЪЬ, рд╡рд╛рд╣рди
ЁЯЪ▓ => ЁЯЪ▓, рдмрд╛рдЗрдХ, рд╕рд╛рдЗрдХрд┐рд▓, рд╡рд╛рд╣рди
тЫ╜ => тЫ╜, рдЧреИрд╕ рд╕реНрдЯреЗрд╢рди, рдкреЗрдЯреНрд░реЛрд▓ рдкрдВрдк, рдИрдВрдзрди, рдкреЗрдЯреНрд░реЛрд▓, рдбреАрдЬрд▓, рдЧреИрд╕, рд╕реНрдЯреЗрд╢рди
ЁЯЫг => ЁЯЫг, рд╣рд╛рдЗрд╡реЗ, рдореЛрдЯрд░ рдХрд╛ рд░рд╛рд╕реНрддрд╛, рд╕реЬрдХ
ЁЯЫд => ЁЯЫд, рд░реЗрд▓ рдХреА рдкрдЯрд░реА, рдЯреНрд░реЗрди
ЁЯЪи => ЁЯЪи, рдШреВрдордиреЗ рд╡рд╛рд▓реА рд▓рд╛рдЗрдЯ, рдкреБрд▓рд┐рд╕ рд▓рд╛рдЗрдЯ, рдкреБрд▓рд┐рд╕ рдмреАрдХрди, рдкреБрд▓рд┐рд╕ рдХрд╛рд░
ЁЯЪе => ЁЯЪе, рдЯреНрд░реИрдлрд╝рд┐рдХ рд▓рд╛рдЗрдЯ, рдпрд╛рддрд╛рдпрд╛рдд рд╕рдВрдХреЗрдд, рдХреНрд╖реИрддрд┐рдЬ рдЯреНрд░реИрдлрд╝рд┐рдХ рд▓рд╛рдЗрдЯ, рд▓рд╛рдЗрдЯ, рдпрд╛рддрд╛рдпрд╛рдд
ЁЯЪж => ЁЯЪж, рдЯреНрд░реИрдлрд╝рд┐рдХ рд▓рд╛рдЗрдЯ, рдпрд╛рддрд╛рдпрд╛рдд рд╕рдВрдХреЗрдд, рдЙрд░реНрдзреНрд╡рд╛рдзрд░ рдЯреНрд░реИрдлрд╝рд┐рдХ рд▓рд╛рдЗрдЯ, рд▓рд╛рдЗрдЯ, рдпрд╛рддрд╛рдпрд╛рдд
ЁЯЪз => ЁЯЪз, рдирд┐рд░реНрдорд╛рдг рдЪрд╛рд▓реВ, рдирд┐рд░реНрдорд╛рдг рдХрд╛ рд╕рдВрдХреЗрдд, рдирд┐рд░реНрдорд╛рдг, рд╕рдВрдХреЗрдд
тЪУ => тЪУ, рдПрдВрдХрд░, рдЪрд┐рд╣реНрди
тЫ╡ => тЫ╡, рд╕реЗрд▓рдмреЛрдЯ, рдмреЛрдЯ, рдирд╛рд╡, рдпрд╛рдЪ, рд╕реА рд░реАрд╕реЛрд░реНрдЯ, рд░реАрд╕реЛрд░реНрдЯ
ЁЯЪг => ЁЯЪг, рд░реЛ рдмреЛрдЯ, рдирд╛рд╡, рдмреЛрдЯ, рд╡рд╛рд╣рди
ЁЯЪд => ЁЯЪд, рд╕реНрдкреАрдбрдмреЛрдЯ, рдирд╛рд╡, рд╡рд╛рд╣рди
ЁЯЪв => ЁЯЪв, рдЬрд╣рд╛рдЬрд╝, рд╡рд╛рд╣рди
тЬИ => тЬИ, рд╡рд╛рд╣рди
ЁЯЫй => ЁЯЫй, рд╡рд╛рд╣рди
ЁЯЫл => ЁЯЫл, рд╣рд╡рд╛рдИ рдЬрд╣рд╛реЫ, рд╣рд╡рд╛рдИ рдЬрд╣рд╛реЫ рдХрд╛ рдЬрд╛рдирд╛
ЁЯЫм => ЁЯЫм, рд╣рд╡рд╛рдИ рдЬрд╣рд╛реЫ, рд╣рд╡рд╛рдИ рдЬрд╣рд╛реЫ рдХрд╛ рдЖрдирд╛
ЁЯТ║ => ЁЯТ║, рд╕реАрдЯ, рдХреБрд░реНрд╕реА
ЁЯЪБ => ЁЯЪБ, рд╣реЗрд▓реАрдХреЙрдкреНрдЯрд░, рд╡рд╛рд╣рди
ЁЯЪЯ => ЁЯЪЯ, рд╕рд╕реНрдкреЗрдВрд╢рди рд░реЗрд▓рд╡реЗ, рд░реЗрд▓рд╡реЗ, рд╕рд╕реНрдкреЗрдВрд╢рди, рд╡рд╛рд╣рди
ЁЯЪа => ЁЯЪа, рдорд╛рдЙрдВрдЯреЗрди рдХреЗрдмрд▓рд╡реЗ, рдкрд╣рд╛рдбрд╝реА рдХреЗрдмрд▓ рдХрд╛рд░, рдХреЗрдмрд▓, рдХрд╛рд░, рдкрд╣рд╛рдбрд╝реА, рд╡рд╛рд╣рди
ЁЯЪб => ЁЯЪб, рдХреЗрдмрд▓ рдХрд╛рд░, рдПрд░рд┐рдпрд▓ рдЯреНрд░рд╛рдорд╡реЗ, рд░реЛрдкрд╡реЗ, рдПрд░рд┐рдпрд▓, рдЯреНрд░рд╛рдорд╡реЗ, рдЧреЛрдВрдбреЛрд▓рд╛, рд╡рд╛рд╣рди
ЁЯЪА => ЁЯЪА, рд░реЙрдХреЗрдЯ, рд╡рд╛рд╣рди
ЁЯЫ░ => ЁЯЫ░, рдЙрдкрдЧреНрд░рд╣, рд╡рд╛рд╣рди, рдЕрдВрддрд░рд┐рдХреНрд╖
ЁЯЫО => ЁЯЫО, рдмреЗрд▓рд╣реЙрдк рдШрдВрдЯреА, рд╣реЛрдЯрд▓
ЁЯЫМ => ЁЯЫМ, рд╣реЛрдЯрд▓
ЁЯЫП => ЁЯЫП, рд╣реЛрдЯрд▓
ЁЯЫЛ => ЁЯЫЛ, рд╕реЛреЮрд╛, рд▓реИрдВрдк, рд╣реЛрдЯрд▓
ЁЯЫА => ЁЯЫА, рдмрд╛рде
тМЫ => тМЫ, рд░реЗрддрдШрдбрд╝реА, рд░реЗрдд, рдШрдВрдЯрд╛рдШрдбрд╝реА, рд╕рдордп
тП│ => тП│, рд░реЗрддрдШрдбрд╝реА, рд░реЗрдд рдШрдВрдЯрд╛рдШрдбрд╝реА, рдШрдВрдЯрд╛ рдШрдбрд╝реА, рдЯрд╛рдЗрдорд░, рд╕рдордп
тМЪ => тМЪ, рдШрдбрд╝реА, рд╣рд╛рдердШрдбрд╝реА, рд╕рдордп
тП░ => тП░, рдЕрд▓рд╛рд░реНрдо рдШрдбрд╝реА, рдЕрд▓рд╛рд░реНрдо, рдШрдбрд╝реА, рд╕рдордп
тП▒ => тП▒, рд╕реНрдЯреЙрдкрд╡реЙрдЪ, рдШреЬреА, рд╕рдордп
тП▓ => тП▓, рдЯрд╛рдЗрдорд░ рдШреЬреА, рдШреЬреА, рд╕рдордп
ЁЯХ░ => ЁЯХ░, рдШреЬреА, рд╕рдордп
ЁЯХЫ => ЁЯХЫ, 12 рдмрдЬреЗ, рдШрдбрд╝реА, рдмрд╛рд░рд╣, 12:00
ЁЯХз => ЁЯХз, рд╕рд╛рдврд╝реЗ рдмрд╛рд░рд╣, рдШрдбрд╝реА, 12:30
ЁЯХР => ЁЯХР, 1 рдмрдЬреЗ, рдШрдбрд╝реА, рдПрдХ, 1:00
ЁЯХЬ => ЁЯХЬ, рдбреЗрдврд╝, рдШрдбрд╝реА, 1:30
ЁЯХС => ЁЯХС, 2 рдмрдЬреЗ, рдШрдбрд╝реА, рджреЛ, 2:00
ЁЯХЭ => ЁЯХЭ, рдврд╛рдИ, рдШрдбрд╝реА, 2:30
ЁЯХТ => ЁЯХТ, 3 рдмрдЬреЗ, рдШрдбрд╝реА, рддреАрди, 3:00
ЁЯХЮ => ЁЯХЮ, рд╕рд╛рдврд╝реЗ рддреАрди, рдШрдбрд╝реА, 3:30
ЁЯХУ => ЁЯХУ, 4 рдмрдЬреЗ, рдШрдбрд╝реА, рдЪрд╛рд░, 4:00
ЁЯХЯ => ЁЯХЯ, рд╕рд╛рдврд╝реЗ рдЪрд╛рд░, рдШрдбрд╝реА, 4:30
ЁЯХФ => ЁЯХФ, 5 рдмрдЬреЗ, рдШрдбрд╝реА, рдкрд╛рдВрдЪ, 5:00
ЁЯХа => ЁЯХа, рд╕рд╛рдврд╝реЗ рдкрд╛рдВрдЪ, рдШрдбрд╝реА, 5:30
ЁЯХХ => ЁЯХХ, 6 рдмрдЬреЗ, рдШрдбрд╝реА, рдЫрд╣, 6:00
ЁЯХб => ЁЯХб, рд╕рд╛рдврд╝реЗ рдЫрд╣, рдШрдбрд╝реА, 6:30
ЁЯХЦ => ЁЯХЦ, 7 рдмрдЬреЗ, рдШрдбрд╝реА, рд╕рд╛рдд, 7:00
ЁЯХв => ЁЯХв, рд╕рд╛рдврд╝реЗ рд╕рд╛рдд, рдШрдбрд╝реА, 7:30
ЁЯХЧ => ЁЯХЧ, 8 рдмрдЬреЗ, рдШрдбрд╝реА, рдЖрда, 8:00
ЁЯХг => ЁЯХг, рд╕рд╛рдврд╝реЗ рдЖрда, рдШрдбрд╝реА, 8:30
ЁЯХШ => ЁЯХШ, 9 рдмрдЬреЗ, рдШрдбрд╝реА, рдиреМ, 9:00
ЁЯХд => ЁЯХд, рд╕рд╛рдврд╝реЗ рдиреМ, рдШрдбрд╝реА, 9:30
ЁЯХЩ => ЁЯХЩ, 10 рдмрдЬреЗ, рдШрдбрд╝реА, рджрд╕, 10:00
ЁЯХе => ЁЯХе, рд╕рд╛рдврд╝реЗ рджрд╕, рдШрдбрд╝реА, 10:30
ЁЯХЪ => ЁЯХЪ, 11 рдмрдЬреЗ, рдШрдбрд╝реА, рдЧреНрдпрд╛рд░рд╣, 11:00
ЁЯХж => ЁЯХж, рд╕рд╛рдврд╝реЗ рдЧреНрдпрд╛рд░рд╣, рдШрдбрд╝реА, 11:30
ЁЯМС => ЁЯМС, рдЧрд╣рд░рд╛ рдЪрд╛рдВрдж, рдЧрд╣рд░рд╛, рдирдпрд╛, рдЪрд╛рдВрдж
ЁЯМТ => ЁЯМТ, рдирд╡рдЪрдВрджреНрд░, рдмрд╛рд▓рдЪрдВрджреНрд░, рд╡рд░реНрдзрдорд╛рди рдЪрд╛рдВрдж, рд╡рд░реНрдзрдорд╛рди, рдЪрд╛рдВрдж
ЁЯМУ => ЁЯМУ, рдЪреМрдерд╛рдИ рдорд╛рд╣ рдХрд╛ рдЪрд╛рдВрдж, рдЪрд╛рдВрдж, рдЪреМрдерд╛рдИ рдорд╛рд╣
ЁЯМФ => ЁЯМФ, рд╡рд░реНрдзрдорд╛рди, рдХреБрдмрдбрд╝рд╛ рдЪрд╛рдВрдж, рдХреБрдмрдбрд╝рд╛, рдЪрд╛рдВрдж
ЁЯМХ => ЁЯМХ, рдкреВрд░реНрдг рдЪрдВрджреНрд░, рдкреВрд░рд╛, рдкреВрд░реНрдгрд┐рдорд╛ рдХрд╛ рдЪрд╛рдВрдж, рдЪрдордХрджрд╛рд░, рдЪрд╛рдВрдж
ЁЯМЦ => ЁЯМЦ, рдШрдЯрддрд╛ рд╣реБрдЖ, рдХреБрдмрдбрд╝рд╛ рдЪрд╛рдВрдж, рдХреБрдмрдбрд╝рд╛, рдЪрд╛рдВрдж
ЁЯМЧ => ЁЯМЧ, рдЖрдзрд╛ рдЪрд╛рдВрдж, рдЪреМрдерд╛рдИ, рдЪрд╛рдВрдж
ЁЯМШ => ЁЯМШ, рдЪрд╛рдкрд╛рдХрд╛рд░ рдЪрдВрджреНрд░, рдмрд╛рд▓рдЪрдВрджреНрд░, рдШрдЯрддрд╛ рдЪрд╛рдВрдж, рдШрдЯрддрд╛ рд╣реБрдЖ, рдЪрд╛рдВрдж
ЁЯМЩ => ЁЯМЩ, рдмрд╛рд▓рдЪрдВрджреНрд░, рдЪрд╛рдВрдж
ЁЯМЪ => ЁЯМЪ, рдирдпрд╛ рдЪрд╛рдВрдж, рдЪреЗрд╣рд░реЗ рд╡рд╛рд▓рд╛ рдЪрд╛рдВрдж, рдЪрд╛рдВрдж, рдЪреЗрд╣рд░рд╛
ЁЯМЫ => ЁЯМЫ, рдЪреМрдерд╛рдИ рдорд╛рд╣ рдХреЗ рдЪрд╛рдВрдж рд╡рд╛рд▓рд╛ рдЪреЗрд╣рд░рд╛, рдЪреЗрд╣рд░реЗ рд╡рд╛рд▓рд╛ рдЪреМрдерд╛рдИ рдЪрд╛рдВрдж, рдЪреЗрд╣рд░реЗ рд╡рд╛рд▓рд╛ рдЪрд╛рдВрдж, рдкрд╣рд▓реЗ рдЪреМрдерд╛рдИ рдорд╛рд╣ рдХрд╛ рдЪрд╛рдВрдж, рдЖрдзрд╛ рдЪрд╛рдВрдж, рдЪрд╛рдВрдж, рдЪреЗрд╣рд░рд╛
ЁЯМЬ => ЁЯМЬ, рдЪреМрдерд╛рдИ рдорд╛рд╣ рдХреЗ рдЪрд╛рдВрдж рд╡рд╛рд▓рд╛ рдЪреЗрд╣рд░рд╛, рдЪреЗрд╣рд░реЗ рд╡рд╛рд▓рд╛ рдЪреМрдерд╛рдИ рдЪрд╛рдВрдж, рдЪреЗрд╣рд░реЗ рд╡рд╛рд▓рд╛ рдЪрд╛рдВрдж, рддреАрд╕рд░реЗ рдЪреМрдерд╛рдИ рдорд╛рд╣ рдХрд╛ рдЪрд╛рдВрдж, рдЖрдзрд╛ рдЪрд╛рдВрдж, рдЪрд╛рдВрдж, рдЪреЗрд╣рд░рд╛
ЁЯМб => ЁЯМб, рдореМрд╕рдо
тША => тША, рд╕реВрд░реНрдп, рдХрд┐рд░рдгреЗрдВ, рдореМрд╕рдо
ЁЯМЭ => ЁЯМЭ, рдЪреЗрд╣рд░реЗ рд╡рд╛рд▓рд╛ рдкреВрд░рд╛ рдЪрд╛рдВрдж, рдЪреЗрд╣рд░реЗ рд╡рд╛рд▓рд╛ рдЪрд╛рдВрдж, рдкреВрд░рд╛, рдЪрд╛рдВрдж, рдЪреЗрд╣рд░рд╛
ЁЯМЮ => ЁЯМЮ, рд╕реВрд░реНрдп рдЪреЗрд╣рд░рд╛, рд╕реВрд░реНрдп, рдЪреЗрд╣рд░рд╛, рд╕реВрд░рдЬ
тнР => тнР, рддрд╛рд░рд╛
ЁЯМЯ => ЁЯМЯ, рдЪрдордХреАрд▓рд╛, рдЪрдордХрджрд╛рд░, рдЪрдордХ, рдЪрдордХреАрд▓рд╛ рддрд╛рд░рд╛, рддрд╛рд░рд╛
ЁЯМа => ЁЯМа, рддрд╛рд░рд╛ рдЧрд┐рд░рдирд╛, рдЯреВрдЯрддрд╛ рддрд╛рд░рд╛, рдЧрд┐рд░рдирд╛, рддрд╛рд░рд╛
тШБ => тШБ, рдореМрд╕рдо
тЫЕ => тЫЕ, рдмрд╛рджрд▓реЛрдВ рд╡рд╛рд▓рд╛ рд╕реВрд░реНрдп, рд╕реВрд░рдЬ, рдмрд╛рджрд▓
тЫИ => тЫИ, рдореМрд╕рдо
ЁЯМд => ЁЯМд, рдореМрд╕рдо
ЁЯМе => ЁЯМе, рдмреЬреЗ рдмрд╛рджрд▓ рдХреЗ рдкреАрдЫреЗ рд╕реВрд░реНрдп, рдореМрд╕рдо
ЁЯМж => ЁЯМж, рдмрд╛рд░рд┐рд╢ рд╡рд╛рд▓реЗ рдмрд╛рджрд▓ рдХреЗ рдкреАрдЫреЗ, рдореМрд╕рдо
ЁЯМз => ЁЯМз, рдореМрд╕рдо
ЁЯМи => ЁЯМи, рдореМрд╕рдо
ЁЯМй => ЁЯМй, рдореМрд╕рдо
ЁЯМк => ЁЯМк, рдореМрд╕рдо
ЁЯМл => ЁЯМл, рдореМрд╕рдо
ЁЯМм => ЁЯМм, рдЪреЗрд╣рд░рд╛
ЁЯМА => ЁЯМА, рдЪрдХреНрд░рд╡рд╛рдд, рддреВрдлрд╝рд╛рди, рдмрд╡рдВрдбрд░, рдЪрдХреНрдХрд░
ЁЯМВ => ЁЯМВ, рдЫрд╛рддрд╛, рд╡рд░реНрд╖рд╛, рдмрд╛рд░рд┐рд╢
тШВ => тШВ, рдЫрд╛рддрд╛, рдореМрд╕рдо
тЪб => тЪб, рдЙрдЪреНрдЪ рд╡реЛрд▓реНрдЯреЗрдЬ рдЦрддрд░рд╛, рдЙрдЪреНрдЪ рд╡реЛрд▓реНрдЯреЗрдЬ рдХрд╛ рдЪрд┐рд╣реНрди, рдЦрддрд░рд╛, рдЙрдЪреНрдЪ, рд╡реЛрд▓реНрдЯреЗрдЬ, рдЪрд┐рд╣реНрди
тЭД => тЭД, рд╢реАрдд, рдмрд░реНрдл, рдореМрд╕рдо
тШГ => тШГ, рд╢реАрдд, рдмрд░реНрдл, рдореМрд╕рдо
тЫД => тЫД, рд╕реНрдиреЛрдореИрди, рдмрд┐рдирд╛ рдмрд░реНрдл рдХрд╛ рдмрд░реНрдлреАрд▓рд╛ рдЖрджрдореА, рдмрд░реНрдл
тШД => тШД, рдзреВрдордХреЗрддреБ, рдЕрдВрддрд░рд┐рдХреНрд╖
ЁЯФе => ЁЯФе, рд▓рдкрдЯ
ЁЯТз => ЁЯТз, рдкрд╕реАрдирд╛, рдкрд╕реАрдиреЗрджрд╛рд░, рдХреЙрдорд┐рдХ
ЁЯМК => ЁЯМК, рд▓рд╣рд░, рддрд░рдВрдЧ, рдкрд╛рдиреА рдХреА рд▓рд╣рд░
ЁЯОГ => ЁЯОГ, рдЬреИрдХтАУрдУтАУрд▓реИрдВрдЯрд░реНрди, рдЬреИрдХ, рдХрдВрджреАрд▓, рд▓рд╛рд▓рдЯреЗрди, рд╣реИрд▓реЛрд╡реАрди, рдХрджреНрджреВ, рд╕рдорд╛рд░реЛрд╣
ЁЯОД => ЁЯОД, рдкреЗрдбрд╝, рд╕рдорд╛рд░реЛрд╣, рдЙрддреНрд╕рд╡
ЁЯОЖ => ЁЯОЖ, рдЖрддрд┐рд╢рдмрд╛рдЬреА, рд╕рдорд╛рд░реЛрд╣
ЁЯОЗ => ЁЯОЗ, рдлреБрд▓рдЭрдбрд╝реА, рдЖрддрд┐рд╢рдмрд╛рдЬреА, рдлреБрд▓рдЭрдбрд╝реА рдкрдЯрд╛рдЦрд╛, рд╕рдорд╛рд░реЛрд╣
тЬи => тЬи, рдЪрдордХ, рдЪрдордЪрдо, рддрд╛рд░реЗ
ЁЯОИ => ЁЯОИ, рд╕рдорд╛рд░реЛрд╣
ЁЯОЙ => ЁЯОЙ, рдкрд╛рд░реНрдЯреА, рдкреЙрдкрд░, рд╕рдорд╛рд░реЛрд╣
ЁЯОК => ЁЯОК, рдХреЙрдирдлрд╝реЗрдЯреА, рдЧреЗрдВрдж, рд╕рдорд╛рд░реЛрд╣
ЁЯОЛ => ЁЯОЛ, рд╕реНрдЯрд╛рд░ рддреНрдпреЛрд╣рд╛рд░, рдкреЗрдбрд╝, рдХрд╛рдЧрдЬ рдХреА рдкрдЯреНрдЯрд┐рдпрд╛рдВ, рд╕рдорд╛рд░реЛрд╣
ЁЯОМ => ЁЯОМ, рдХреНрд░реЙрд╕ рдЭрдВрдбреЗ, рдЬрд╛рдкрд╛рди рдХреЗ рдХреНрд░реЙрд╕ рдЭрдВрдбреЗ, рдзреНрд╡рдЬ, рд╕рдорд╛рд░реЛрд╣
ЁЯОН => ЁЯОН, рдкрд╛рдЗрди рд╕рдЬрд╛рд╡рдЯ, рдирд╡рд╡рд░реНрд╖, рдЬрд╛рдкрд╛рдиреА, рджреЗрд╡рджрд╛рд░, рд╕рдорд╛рд░реЛрд╣
ЁЯОО => ЁЯОО, рдЧреБрдбрд╝рд┐рдпрд╛, рдЧреБрдбрд╝рд┐рдпрд╛ рддреНрдпреЛрд╣рд╛рд░, рддреНрдпреЛрд╣рд╛рд░, рдЬрд╛рдкрд╛рдиреА, рд╕рдорд╛рд░реЛрд╣
ЁЯОП => ЁЯОП, рд╕реНрдЯреНрд░реАрдорд░, рд╕рдорд╛рд░реЛрд╣
ЁЯОР => ЁЯОР, рд╡рд┐рдВрдб рдЪрд╛рдЗрдо, рдШрдВрдЯреА
ЁЯОС => ЁЯОС, рдЪрд╛рдВрдж рджреЗрдЦрдирд╛, рдЪрд╛рдВрдж, рджреЗрдЦрдирд╛, рд╕рдорд╛рд░реЛрд╣
ЁЯОА => ЁЯОА, рд╕рдорд╛рд░реЛрд╣, рдЙрддреНрд╕рд╡
ЁЯОБ => ЁЯОБ, рдЙрдкрд╣рд╛рд░, рдЧрд┐рдлрд╝реНрдЯ, рдкреИрдХ рдХрд┐рдпрд╛ рд╣реБрдЖ рдЙрдкрд╣рд╛рд░, рд▓рдкреЗрдЯрд╛ рд╣реБрдЖ, рд╕рдорд╛рд░реЛрд╣
ЁЯОЦ => ЁЯОЦ, рд╕реЗрдирд╛ рдХрд╛ рдкрджрдХ, рд╕реЗрдирд╛, рдкрджрдХ
ЁЯОЧ => ЁЯОЧ, рдЙрддреНрд╕рд╡
ЁЯОЮ => ЁЯОЮ, реЮрд┐рд▓реНрдо реЮреНрд░реЗрдо, рд╕рд┐рдиреЗрдорд╛, реЮреНрд░реЗрдо
ЁЯОЯ => ЁЯОЯ, рдкреНрд░рд╡реЗрд╢ рдЯрд┐рдХрдЯ, рдЯрд┐рдХрдЯ
ЁЯОл => ЁЯОл, рдордиреЛрд░рдВрдЬрди
тЪ╜ => тЪ╜, рд╕реЙрдХрд░ рдмреЙрд▓, рд╕реЙрдХрд░, рдлреБрдЯрдмреЙрд▓, рдЧреЗрдВрдж
ЁЯПА => ЁЯПА, рдмрд╛рд╕реНрдХреЗрдЯрдмреЙрд▓, рдмрд╛рд╕реНрдХреЗрдЯрдмреЙрд▓ рд╣реВрдк, рдЧреЗрдВрдж, рд╣реВрдк, рдЦреЗрд▓
ЁЯПИ => ЁЯПИ, рдЕрдореЗрд░рд┐рдХреА, рдЧреЗрдВрдж, рдЦреЗрд▓
ЁЯПЙ => ЁЯПЙ, рд╕реЙрдХрд░, рд╕реЙрдХрд░ рдЧреЗрдВрдж, рдмреЙрд▓, рдЦреЗрд▓
ЁЯО╛ => ЁЯО╛, рдЯреЗрдирд┐рд╕ рдмреЙрд▓, рдЯреЗрдирд┐рд╕ рд░реИрдХреЗрдЯ рдФрд░ рдмреЙрд▓, рдмреЙрд▓, рдЦреЗрд▓
ЁЯО▒ => ЁЯО▒, рдЖрда рдЧреЗрдВрдж, рдЧреЗрдо
ЁЯО│ => ЁЯО│, рдмрд╛рдЙрд▓рд┐рдВрдЧ рдмреЙрд▓, рдЧреЗрдВрдж, рдЧреЗрдо
тЫ│ => тЫ│, рдЧреЛрд▓реНрдлрд╝, рдЧреЛрд▓реНрдлрд╝ рдХрд╛ рдЭрдВрдбрд╛, рд╣реЛрд▓, рдЫреЗрдж
ЁЯПМ => ЁЯПМ, рдЧреЛрд▓реНреЮ рдХрд╛ рдЦрд┐рд▓рд╛реЬреА, рдЧреЛрд▓реНреЮ, рдЧреЗрдВрдж
тЫ╕ => тЫ╕, рдЖрдЗрд╕ рд╕реНрдХреЗрдЯ, рд╕реНрдХреЗрдЯ
ЁЯОг => ЁЯОг, рдордЫрд▓реА рдкрдХрдбрд╝рдирд╛, рдордЫрд▓реА, рд░реЙрдб, рдордиреЛрд░рдВрдЬрди
ЁЯО╜ => ЁЯО╜, рдкрдЯреНрдЯреЗ рд╡рд╛рд▓реА рд░рдирд┐рдВрдЧ рд╢рд░реНрдЯ, рдкрдЯреНрдЯреА, рдЦреЗрд▓
ЁЯО┐ => ЁЯО┐, рд╕реНрдХреА, рд╕реНрдХреА рдФрд░ рдмреВрдЯ, рдмреВрдЯ, рдЦреЗрд▓
тЫ╖ => тЫ╖, рд╕реНрдХреА рдЦрд┐рд▓рд╛реЬреА, рдмрд░реНрдл рдХреЗ рдЦреЗрд▓
ЁЯПВ => ЁЯПВ, рд╕реНрдиреЛрдмреЛрд░реНрдбрд░, рд╕реНрдиреЛрдмреЛрд░реНрдбрд┐рдВрдЧ, рд╕реНрдиреЛрдмреЛрд░реНрдб, рдЦреЗрд▓
ЁЯПД => ЁЯПД, рд╕рд░реНрдлрд╝рд┐рдВрдЧ, рдЦреЗрд▓
ЁЯПЗ => ЁЯПЗ, рджреМрдбрд╝ рдХрд╛ рдШреЛрдбрд╝рд╛, рдЬреЙрдХреА, рд░реЗрд╕, рдШреЛрдбрд╝рд╛, рдЦреЗрд▓
ЁЯПК => ЁЯПК, рддреИрд░рд╛рдХреА, рддреИрд░рдирд╛, рдЦреЗрд▓
тЫ╣ => тЫ╣, рдЦреЗрд▓
ЁЯПЛ => ЁЯПЛ, рднрд╛рд░реЛрддреНрддреЛрд▓рдХ, рд╡реЫрди, рднрд╛рд░
ЁЯЪ┤ => ЁЯЪ┤, рд╕рд╛рдЗрдХрд▓рд┐рд╕реНрдЯ, рдмрд╛рдЗрдХ
ЁЯЪ╡ => ЁЯЪ╡, рдмрд╛рдЗрдХ, рд╕рд╛рдЗрдХрд▓рд┐рд╕реНрдЯ, рдкрд╣рд╛рдбрд╝реА
ЁЯПО => ЁЯПО, рдХрд╛рд░
ЁЯПН => ЁЯПН, рдмрд╛рдЗрдХ
ЁЯПЕ => ЁЯПЕ, рдкрджрдХ
ЁЯПЖ => ЁЯПЖ, рдЯреНрд░реЙрдлрд╝реА, рдкреБрд░рд╕реНрдХрд╛рд░
ЁЯПП => ЁЯПП, рдмреЙрд▓, рдЧреЗрдо
ЁЯПР => ЁЯПР, рдЧреЗрдо
ЁЯПС => ЁЯПС, рд╣реЙрдХреА, рд╕реНрдЯрд┐рдХ
ЁЯПТ => ЁЯПТ, рд╕реНрдЯрд┐рдХ, рдЧреЗрдо
ЁЯПУ => ЁЯПУ, рдЯреЗрдмрд▓ рдЯреЗрдирд┐рд╕, рдмреЙрд▓, рдмреЗрдЯ
ЁЯП╕ => ЁЯП╕, рдмреИрдбрдорд┐рдВрдЯрди, рд░реИрдХреЗрдЯ, рд╢рдЯрд▓рдХреЙрдХ, рдЧреЗрдо
ЁЯОп => ЁЯОп, рдЪрд╛рдВрджрдорд╛рд░реА, рд╕реАрдзрд╛ рдирд┐рд╢рд╛рдирд╛, рд▓рдХреНрд╖реНрдп, рдирд┐рд╢рд╛рдирд╛, рдЧреЗрдо
ЁЯОо => ЁЯОо, рд╡реАрдбрд┐рдпреЛ рдЧреЗрдо, рдЧреЗрдо рдХрдВрдЯреНрд░реЛрд▓рд░, рдХрдВрдЯреНрд░реЛрд▓рд░, рдЧреЗрдо
ЁЯХ╣ => ЁЯХ╣, рдЬреЙрдпрд╕реНрдЯрд┐рдХ, рдЧреЗрдо, рд╡реАрдбрд┐рдпреЛ рдЧреЗрдо
ЁЯО▓ => ЁЯО▓, рдкрд╛рд╕реЗ, рдбрд╛рдИ, рдбрд╛рдЗрд╕, рдЧреЗрдо
тЩа => тЩа, рдХрд╛рд░реНрдб, рддрд╛рд╢
тЩе => тЩе, рдкрд╛рди рдХрд╛ рдкрддреНрддрд╛, рдХрд╛рд░реНрдб, рддрд╛рд╢
тЩж => тЩж, рдХрд╛рд░реНрдб, рддрд╛рд╢
тЩг => тЩг, рдХрд╛рд░реНрдб, рддрд╛рд╢
ЁЯГП => ЁЯГП, рдЬреЛрдХрд░, рддрд╛рд╢ рдХрд╛ рдкрддреНрддрд╛, рдХрд╛рд░реНрдб
ЁЯАД => ЁЯАД, рдорд╛рд╣рдЬреЛрдВрдЧ рдЯрд╛рдЗрд▓, рд▓рд╛рд▓ рджреИрддреНрдп, рджреИрддреНрдп, рдорд╛рд╣рдЬреЛрдВрдЧ, рдЯрд╛рдЗрд▓
ЁЯО┤ => ЁЯО┤, рддрд╛рд╢ рдХрд╛ рдкрддреНрддрд╛, рдлреВрд▓, рдХрд╛рд░реНрдб рдЧреЗрдо, рдХрд╛рд░реНрдб, рдЧреЗрдо, рд╣рд╛рдирд╛рдлреВрдбрд╛
ЁЯФЗ => ЁЯФЗ, рди рдмреЛрд▓реЗрдВ, рдХреГрдкрдпрд╛ рд╢рд╛рдВрдд рдХрд░реЗрдВ
ЁЯФИ => ЁЯФИ, рд╕реНрдкреАрдХрд░, рд▓рд╛рдЙрдбрд╕реНрдкреАрдХрд░
ЁЯФЙ => ЁЯФЙ, рд╕реНрдкреАрдХрд░, рдХрдо рдЖрд╡рд╛рдЬрд╝, рдХрдо, рдХрдо рдЖрд╡рд╛рдЬрд╝ рдореЗрдВ рд╕реНрдкреАрдХрд░
ЁЯФК => ЁЯФК, рд╕реНрдкреАрдХрд░, рдЕрдзрд┐рдХ рдЖрд╡рд╛рдЬрд╝, рдЕрдзрд┐рдХ
ЁЯУв => ЁЯУв, рдЖрдо рд╕рднрд╛, рд╣реИрдВрдб рд╕реНрдкреАрдХрд░, рд╕рдВрдЪрд╛рд░
ЁЯУг => ЁЯУг, рдЙрддреНрд╕рд╛рд╣рд╡рд░реНрдзрди, рд╕рдВрдЪрд╛рд░
ЁЯУп => ЁЯУп, рдбрд╛рдХ, рд╣реЙрд░реНрди
ЁЯФФ => ЁЯФФ, рдШрдВрдЯреА, рдЧрд┐рд░рдЬрд╛рдШрд░
ЁЯФХ => ЁЯФХ, рдШрдВрдЯреА рдирд╣реАрдВ, рдЖрд╡рд╛рдЬрд╝ рдирд╣реАрдВ, рдШрдВрдЯреА
ЁЯО╝ => ЁЯО╝, рд╕рдВрдЧреАрдд, рд╕реНрдХреЛрд░
ЁЯО╡ => ЁЯО╡, рд╕рдВрдЧреАрдд рд╕реНрд╡рд░, рд╕рдВрдЧреАрдд, рд╕реНрд╡рд░
ЁЯО╢ => ЁЯО╢, рд╕рдВрдЧреАрдд рдХреЗ рд╕реНрд╡рд░, рд╕рдВрдЧреАрдд, рдиреЛрдЯ, рд╕реНрд╡рд░
ЁЯОЩ => ЁЯОЩ, рдорд╛рдЗрдХреНрд░реЛреЮреЛрди, рд╕реНрдЯреВрдбрд┐рдпреЛ рдорд╛рдЗрдХреНрд░реЛреЮреЛрди, рд╕рдВрдЧреАрдд, рдорд╛рдЗрдХ
ЁЯОЪ => ЁЯОЪ, рд╕рдВрдЧреАрдд, рд╕реНрд▓рд╛рдЗрдбрд░
ЁЯОЫ => ЁЯОЫ, рдХрдВрдЯреНрд░реЛрд▓, рд╕рдВрдЧреАрдд
ЁЯОд => ЁЯОд, рдорд╛рдЗрдХ, рдорд╛рдЗрдХреНрд░реЛрдлрд╝реЛрди, рдХрд░рд╛рдУрдХреЗ, рдордиреЛрд░рдВрдЬрди
ЁЯОз => ЁЯОз, рдордиреЛрд░рдВрдЬрди
ЁЯО╖ => ЁЯО╖, рд╕реИрдХреНрд╕, рд╕рдВрдЧреАрдд рд╡рд╛рджреНрдп, рд╕рдВрдЧреАрдд, рд╡рд╛рджреНрдпрдпрдВрддреНрд░
ЁЯО╕ => ЁЯО╕, рд╕рдВрдЧреАрдд рд╡рд╛рджреНрдп, рд╕рдВрдЧреАрдд, рд╡рд╛рджреНрдпрдпрдВрддреНрд░
ЁЯО╣ => ЁЯО╣, рдкрд┐рдпрд╛рдиреЛ, рдХреАрдмреЛрд░реНрдб, рд╕рдВрдЧреАрдд рд╡рд╛рджреНрдп, рд╡рд╛рджреНрдпрдпрдВрддреНрд░
ЁЯО║ => ЁЯО║, рд╕рдВрдЧреАрдд рд╡рд╛рджреНрдп, рд╕рдВрдЧреАрдд, рд╡рд╛рджреНрдпрдпрдВрддреНрд░
ЁЯО╗ => ЁЯО╗, рд╕рдВрдЧреАрдд рд╡рд╛рджреНрдп, рд╕рдВрдЧреАрдд, рд╡рд╛рджреНрдпрдпрдВрддреНрд░
ЁЯУ▒ => ЁЯУ▒, рд╕реЗрд▓ рдлрд╝реЛрди, рдореЛрдмрд╛рдЗрд▓ рдлрд╝реЛрди, рдлрд╝реЛрди
ЁЯУ▓ => ЁЯУ▓, рдХреЙрд▓ рдХрд░реЗрдВ, рдореЛрдмрд╛рдЗрд▓ рдлрд╝реЛрди, рдлрд╝реЛрди
тШО => тШО, рдЯреЗрд▓реАреЮреЛрди, реЮреЛрди
ЁЯУЮ => ЁЯУЮ, рдлрд╝реЛрди, рдЯреЗрд▓реАрдлрд╝реЛрди, рдлрд╝реЛрди рд░рд┐рд╕реАрд╡рд░, рд╕рдВрдЪрд╛рд░
ЁЯУЯ => ЁЯУЯ, рд╕рдВрдЪрд╛рд░
ЁЯУа => ЁЯУа, рдлрд╝реИрдХреНрд╕ рдорд╢реАрди, рд╕рдВрдЪрд╛рд░
ЁЯФМ => ЁЯФМ, рдмрд┐рдЬрд▓реА
ЁЯТ╗ => ЁЯТ╗, рдкреАрд╕реА, рдкрд░реНрд╕рдирд▓ рдХрдВрдкреНрдпреВрдЯрд░, рдХрдВрдкреНрдпреВрдЯрд░, рдирд┐рдЬреА
ЁЯЦе => ЁЯЦе, рдбреЗрд╕реНрдХрдЯреЙрдк, рдХрдВрдкреНрдпреВрдЯрд░
ЁЯЦи => ЁЯЦи, рдХрдВрдкреНрдпреВрдЯрд░
тМи => тМи, рдХрдВрдкреНрдпреВрдЯрд░
ЁЯЦ▒ => ЁЯЦ▒, рдХрдВрдкреНрдпреВрдЯрд░ рдорд╛рдЙрд╕
ЁЯЦ▓ => ЁЯЦ▓, рдХрдВрдкреНрдпреВрдЯрд░
ЁЯТ╜ => ЁЯТ╜, рдПрдордбреА, рдбрд┐рд╕реНрдХ
ЁЯТ╛ => ЁЯТ╛, рдлрд╝реНрд▓реЙрдкреА, рдбрд┐рд╕реНрдХ
ЁЯТ┐ => ЁЯТ┐, рдмреНрд▓реВтАУрд░реЗ, рдбреАрд╡реАрдбреА, рд╕реАрдбреА, рдбрд┐рд╕реНрдХ
ЁЯУА => ЁЯУА, рдбреАрд╡реАрдбреА рдбрд┐рд╕реНрдХ, рдбрд┐рд╕реНрдХ
ЁЯОе => ЁЯОе, рдореВрд╡реА, рд╕рд┐рдиреЗрдорд╛, рдордиреЛрд░рдВрдЬрди
ЁЯОм => ЁЯОм, рдХреНрд▓реИрдкрд░рдмреЛрд░реНрдб, рдХреНрд▓реИрдкрд░, рдореВрд╡реА, рдордиреЛрд░рдВрдЬрди
ЁЯУ╜ => ЁЯУ╜, реЮрд┐рд▓реНрдо рдкреНрд░реЛрдЬреЗрдХреНрдЯрд░, рд╕рд┐рдиреЗрдорд╛, реЮрд┐рд▓реНрдо, рд╡реАрдбрд┐рдпреЛ
ЁЯУ║ => ЁЯУ║, рдЯреАрд╡реА, рдЯреЗрд▓реАрд╡рд┐рдЬрд╝рди
ЁЯУ╕ => ЁЯУ╕, реЮреНрд▓реИрд╢ рд╡рд╛рд▓рд╛ рдХреИрдорд░рд╛, рдХреИрдорд░рд╛, рд╡реАрдбрд┐рдпреЛ
ЁЯУ╣ => ЁЯУ╣, рд╡реАрдбрд┐рдпреЛ рдХреИрдорд░рд╛, рдХреИрдорд░рд╛, рд╡реАрдбрд┐рдпреЛ
ЁЯУ╝ => ЁЯУ╝, рд╡реАрдбрд┐рдпреЛ, рдЯреЗрдк
ЁЯФН => ЁЯФН, рдЖрд╡рд░реНрдзрдХ рдХрд╛рдВрдЪ, рдЦреЛрдЬ, рдмрд╛рдИрдВ рдУрд░ рдЗрд╢рд╛рд░рд╛, рдХрд╛рдВрдЪ
ЁЯФО => ЁЯФО, рдЖрд╡рд░реНрдзрдХ рдХрд╛рдВрдЪ, рдЦреЛрдЬ, рджрд╛рдИрдВ рдУрд░ рдЗрд╢рд╛рд░рд╛, рдХрд╛рдВрдЪ
ЁЯУб => ЁЯУб, рд╕реИрдЯреЗрд▓рд╛рдЗрдЯ рдбрд┐рд╢, рдбрд┐рд╢, рдЙрдкрдЧреНрд░рд╣, рд╕рдВрдЪрд╛рд░
ЁЯХп => ЁЯХп, рдкреНрд░рдХрд╛рд╢
ЁЯТб => ЁЯТб, рд▓рд╛рдЗрдЯ рдмрд▓реНрдм, рд╡рд┐рдЪрд╛рд░ рдЖрдпрд╛, рдмрд┐рдЬрд▓реА, рдкреНрд░рдХрд╛рд╢, рдмрд▓реНрдм, рдХреЙрдорд┐рдХ
ЁЯФж => ЁЯФж, рдлрд╝реНрд▓реИрд╢рд▓рд╛рдЗрдЯ, рдкреНрд░рдХрд╛рд╢, рдЯреЙрд░реНрдЪ, рдмрд┐рдЬрд▓реА
ЁЯПо => ЁЯПо, рд▓рд╛рд▓ рд▓рд╛рд▓рдЯреЗрди, рд▓рд╛рд▓, рдХрдВрджреАрд▓, рдЗрдЬрд╝рд╛рдХрд╛рдпрд╛, рдмрд╛рд░, рд░реЗрд╕реНрдЯреЛрд░реЗрдВрдЯ
ЁЯУФ => ЁЯУФ, рд╕рдЬреА рд╣реБрдИ рдиреЛрдЯрдмреБрдХ, рдиреЛрдЯрдмреБрдХ, рдХрд╡рд░
ЁЯУХ => ЁЯУХ, рдкреБрд╕реНрддрдХ
ЁЯУЦ => ЁЯУЦ, рдкреБрд╕реНрддрдХ
ЁЯУЧ => ЁЯУЧ, рдкреБрд╕реНрддрдХ
ЁЯУШ => ЁЯУШ, рдкреБрд╕реНрддрдХ
ЁЯУЩ => ЁЯУЩ, рдкреБрд╕реНрддрдХ
ЁЯУЪ => ЁЯУЪ, рдкреБрд╕реНрддрдХ
ЁЯУТ => ЁЯУТ, рд▓реЗрдЬрд░, рдиреЛрдЯрдмреБрдХ
ЁЯУГ => ЁЯУГ, рджрд╕реНрддрд╛рд╡реЗрдЬрд╝, рдкреГрд╖реНрда
ЁЯУЬ => ЁЯУЬ, рд╕реНрдХреНрд░реЙрд▓, рдкреЗрдкрд░ рд╕реНрдХреНрд░реЙрд▓
ЁЯУД => ЁЯУД, рджрд╕реНрддрд╛рд╡реЗрдЬрд╝, рдЖрдЧреЗ рдХреА рдУрд░, рдкреГрд╖реНрда
ЁЯУ░ => ЁЯУ░, рд╕рдорд╛рдЪрд╛рд░рдкрддреНрд░, рдЕрдЦрдмрд╛рд░, рд╕рдорд╛рдЪрд╛рд░, рдкреЗрдкрд░
ЁЯЧЮ => ЁЯЧЮ, рдореЛреЬрд╛ рд╣реБрдЖ рд╕рдорд╛рдЪрд╛рд░-рдкрддреНрд░, рд╕рдорд╛рдЪрд╛рд░, рд╕рдорд╛рдЪрд╛рд░-рдкрддреНрд░
ЁЯУС => ЁЯУС, рдорд╛рд░реНрдХрд░, рдЯреИрдм, рдмреБрдХрдорд╛рд░реНрдХ
ЁЯТ░ => ЁЯТ░, рдкреИрд╕реЛрдВ рдХреА рдереИрд▓реА, рдбреЙрд▓рд░ рдмреИрдЧ, рдкреИрд╕реЗ, рдереИрд▓реА
ЁЯТ┤ => ЁЯТ┤, рдпреЗрди рдиреЛрдЯ, рдмреИрдВрдХрдиреЛрдЯ, рдпреЗрди, рдкреИрд╕реЗ, рдмрд┐рд▓, рдиреЛрдЯ
ЁЯТ╡ => ЁЯТ╡, рдбреЙрд▓рд░ рдиреЛрдЯ, рдмреИрдВрдХрдиреЛрдЯ, рдбреЙрд▓рд░, рдкреИрд╕реЗ, рдмрд┐рд▓, рдиреЛрдЯ
ЁЯТ╢ => ЁЯТ╢, рдпреВрд░реЛ рдиреЛрдЯ, рдпреВрд░реЛ, рдмреИрдВрдХ рдиреЛрдЯ, рдкреИрд╕реЗ, рдмрд┐рд▓, рдиреЛрдЯ
ЁЯТ╖ => ЁЯТ╖, рдкрд╛рдЙрдВрдб рдиреЛрдЯ, рдкрд╛рдЙрдВрдб, рдмреИрдВрдХрдиреЛрдЯ, рдкреИрд╕реЗ
ЁЯТ╕ => ЁЯТ╕, рдЙрдбрд╝рддреЗ рдкреИрд╕реЗ, рдЙрдбрд╝рддрд╛ рдмреИрдВрдХрдиреЛрдЯ, рдмреИрдВрдХ, рдиреЛрдЯ, рдкреИрд╕реЗ
ЁЯТ│ => ЁЯТ│, рдХрд╛рд░реНрдб, рдХреНрд░реЗрдбрд┐рдЯ
ЁЯТ╣ => ЁЯТ╣, рдмрдврд╝рддрд╛ рдмрд╛рдЬрд╝рд╛рд░, рдКрдкрд░ рдЬрд╛рддрд╛ рдЪрд╛рд░реНрдЯ, рдКрдкрд░ рдХреА рдФрд░, рдЪрд╛рд░реНрдЯ, рдмрд╛рдЬрд╝рд╛рд░
тЬЙ => тЬЙ, рд▓рд┐рдлрд╝рд╛рдлрд╝рд╛, рдИрдореЗрд▓, рдореЗрд▓
ЁЯУз => ЁЯУз, рдИрдореЗрд▓, рдореЗрд▓, рдкрддреНрд░, рд╕рдВрдЪрд╛рд░
ЁЯУи => ЁЯУи, рдЖрд╡рдХ рдореЗрд▓, рдкреНрд░рд╛рдкреНрдд рдореЗрд▓, рдЖрд╡рдХ, рдИрдореЗрд▓, рдореЗрд▓, рдкрддреНрд░, рд▓рд┐рдлрд╛рдлрд╛, рд╕рдВрдЪрд╛рд░
ЁЯУй => ЁЯУй, рдЬрд╛рд╡рдХ рдореЗрд▓, рдкреНрд░реЗрд╖рд┐рдд рдореЗрд▓, рдЬрд╛рд╡рдХ, рдИрдореЗрд▓, рдореЗрд▓, рдкрддреНрд░, рд▓рд┐рдлрд╛рдлрд╛, рд╕рдВрдЪрд╛рд░
ЁЯУд => ЁЯУд, рдкреНрд░реЗрд╖рд┐рдд рдореЗрд▓, рдкреНрд░реЗрд╖рд┐рдд рдмреЙрдХреНрд╕, рдореЗрд▓, рднреЗрдЬреА рдЧрдИ, рдмреЙрдХреНрд╕, рдЖрдЙрдЯрдмреЙрдХреНрд╕, рдЯреНрд░реЗ, рд╕рдВрдЪрд╛рд░
ЁЯУе => ЁЯУе, рдЗрдирдмреЙрдХреНрд╕, рдкреНрд░рд╛рдкреНрдд рдореЗрд▓, рдореЗрд▓, рдкреНрд░рд╛рдкреНрдд, рдмреЙрдХреНрд╕, рдЯреНрд░реЗ, рд╕рдВрдЪрд╛рд░
ЁЯУж => ЁЯУж, рдкреИрдХреЗрдЬ, рдкрд╛рд░реНрд╕рд▓, рдмреЙрдХреНрд╕
ЁЯУл => ЁЯУл, рдореЗрд▓рдмреЙрдХреНрд╕, рдмрдВрдж, рдореЗрд▓, рдЭрдВрдбрд╛
ЁЯУк => ЁЯУк, рдореЗрд▓рдмреЙрдХреНрд╕, рдмрдВрдж, рдореЗрд▓, рдЭрдВрдбрд╛
ЁЯУм => ЁЯУм, рдореЗрд▓рдмреЙрдХреНрд╕, рдЦреБрд▓рд╛, рдореЗрд▓, рдЭрдВрдбрд╛
ЁЯУн => ЁЯУн, рдореЗрд▓рдмреЙрдХреНрд╕, рдЦреБрд▓рд╛, рдореЗрд▓, рдЭрдВрдбрд╛
ЁЯЧ│ => ЁЯЧ│, рдмреЙрдХреНрд╕
тЬТ => тЬТ, рдХрд╛рд▓реА рдирд┐рдм, рдкреЗрди
ЁЯЦЛ => ЁЯЦЛ, рд╕реНрдпрд╛рд╣реА рдкреЗрди, рдкреЗрди
ЁЯЦК => ЁЯЦК, рдкреЗрди
ЁЯЦМ => ЁЯЦМ, рдкреЗрдВрдЯрдмреНрд░рд╢, рдкреЗрдВрдЯрд┐рдВрдЧ
ЁЯЦН => ЁЯЦН, рдореЛрдо рдХреЗ рд░рдВрдЧ, рдХреНрд░реЗрдпреЙрди
ЁЯУЭ => ЁЯУЭ, рдореЗрдореЛ, рдореЗрдореЛ рдкреБрд╕реНрддрдХ, рд╕рдВрдЪрд╛рд░
ЁЯТ╝ => ЁЯТ╝, рдмреНрд░реАрдлрд╝рдХреЗрд╕, рд╕реВрдЯрдХреЗрд╕
ЁЯУБ => ЁЯУБ, рдлрд╝рд╛рдЗрд▓, рдлрд╝реЛрд▓реНрдбрд░
ЁЯУВ => ЁЯУВ, рдЦреБрд▓рд╛ рдлрд╝реЛрд▓реНрдбрд░, рдЦреБрд▓рд╛, рдлрд╝рд╛рдЗрд▓, рдлрд╝реЛрд▓реНрдбрд░
ЁЯЧВ => ЁЯЧВ, рдХрд╛рд░реНрдб рд╡рд┐рднрд╛рдЬрдХ, рдХрд╛рд░реНрдб, рдЕрдиреБрдХреНрд░рдо
ЁЯУЖ => ЁЯУЖ, рдХреИрд▓реЗрдВрдбрд░
ЁЯЧТ => ЁЯЧТ, рд╕реНрдкрд╛рдЗрд░рд▓ рдиреЛрдЯрдкреИрдб, рдиреЛрдЯ, рдкреИрдб
ЁЯЧУ => ЁЯЧУ, рд╕реНрдкрд╛рдЗрд░рд▓ рдХреИрд▓реЗрдВрдбрд░, рдкреИрдб
ЁЯУЗ => ЁЯУЗ, рд░реЛрд▓реЛрдбреЗрдХреНрд╕, рдЗрдВрдбреЗрдХреНрд╕
ЁЯУИ => ЁЯУИ, рдмрдврд╝рддрд╛ рд░реБрдЭрд╛рди, рдЪрд╛рд░реНрдЯ, рдЧреНрд░рд╛рдлрд╝, рдмрдврд╝рддрд╛ рд╣реБрдЖ
ЁЯУЙ => ЁЯУЙ, рдШрдЯрддрд╛ рд░реБрдЭрд╛рди, рдЪрд╛рд░реНрдЯ, рдЧреНрд░рд╛рдлрд╝, рдШрдЯрддрд╛ рд╣реБрдЖ
ЁЯУК => ЁЯУК, рдмрд╛рд░ рдЧреНрд░рд╛рдлрд╝, рдмрд╛рд░ рдЪрд╛рд░реНрдЯ, рдЪрд╛рд░реНрдЯ
ЁЯУМ => ЁЯУМ, рдкреБрд╢рдкрд┐рди, рдкрд┐рди
ЁЯУН => ЁЯУН, рдкреБрд╢рдкрд┐рди, рдкрд┐рди
ЁЯУО => ЁЯУО, рдкреЗрдкрд░рдХреНрд▓рд┐рдк, рдХреНрд▓рд┐рдк
ЁЯЦЗ => ЁЯЦЗ, рд▓рд┐рдВрдХ, рдкреЗрдкрд░рдХреНрд▓рд┐рдк
ЁЯУП => ЁЯУП, рд╕реАрдзрд╛ рд░реВрд▓рд░, рдкреИрдорд╛рдирд╛
ЁЯУР => ЁЯУР, рддрд┐рдХреЛрдирд╛ рд░реВрд▓рд░, рддреНрд░рд┐рдХреЛрдг, рдЧреБрдирд┐рдпрд╛, рдкреИрдорд╛рдирд╛
тЬВ => тЬВ, рдЯреВрд▓
ЁЯЧГ => ЁЯЧГ, рдмреЙрдХреНрд╕, реЮрд╛рдЗрд▓
ЁЯЧД => ЁЯЧД, рдХреИрдмрд┐рдиреЗрдЯ, реЮрд╛рдЗрд▓
ЁЯЧС => ЁЯЧС, рдХрдЪрд░реЗ рдХреА рдЯреЛрдХрд░реА, рдХрдЪрд░рд╛ рдкреЗрдЯреА
ЁЯФТ => ЁЯФТ, рддрд╛рд▓рд╛, рдмрдВрдж рддрд╛рд▓рд╛
ЁЯФУ => ЁЯФУ, рддрд╛рд▓рд╛, рдЦреБрд▓рд╛ рддрд╛рд▓рд╛
ЁЯФП => ЁЯФП, рддрд╛рд▓рд╛, рдЧреЛрдкрдиреАрдпрддрд╛, рд╕реНрдпрд╛рд╣реА рдХреА рдкреЗрди рдХреЗ рд╕рд╛рде рддрд╛рд▓рд╛, рд╕реНрдпрд╛рд╣реА рд╡рд╛рд▓реА рдкреЗрди
ЁЯФР => ЁЯФР, рдмрдВрдж рддрд╛рд▓рд╛, рдЪрд╛рдмреА рдХреЗ рд╕рд╛рде рддрд╛рд▓рд╛, рд╕реБрд░рдХреНрд╖рд╛
ЁЯФС => ЁЯФС, рдЪрд╛рдмреА, рдкрд╛рд╕рд╡рд░реНрдб
ЁЯЧЭ => ЁЯЧЭ, рдкреБрд░рд╛рдиреА рдЪрд╛рдмреА, рд╕рдВрдХреЗрдд, рдкреБрд░рд╛рдирд╛
ЁЯФи => ЁЯФи, рд╣рдереМрдбрд╝рд╛, рдФрдЬрд╝рд╛рд░
тЫП => тЫП, рдХреБрд▓реНрд╣рд╛реЬреА, рдЦрдирди рдЯреВрд▓
тЪТ => тЪТ, рдЯреВрд▓
ЁЯЫа => ЁЯЫа, рдЯреВрд▓, рд░реИрдВрдЪ
ЁЯФз => ЁЯФз, рдкрд╛рдирд╛, рд░реИрдВрдЪ, рдФрдЬрд╝рд╛рд░
ЁЯФй => ЁЯФй, рдирдЯ, рдмреЛрд▓реНрдЯ, рдФрдЬрд╝рд╛рд░
тЪЩ => тЪЩ, рдЯреВрд▓
ЁЯЧЬ => ЁЯЧЬ, рдЯреВрд▓
тЪЧ => тЪЧ, рд░рд╕рд╛рдпрди, рдЯреВрд▓
тЪЦ => тЪЦ, рддрд░рд╛рдЬреВ, рд╕рдВрддреБрд▓рди, рд▓рд┐рдмреНрд░рд╛, рдорд╛рдк, рд╡реЫрди, рд░рд╛рд╢рд┐, рдЯреВрд▓
ЁЯФЧ => ЁЯФЧ, рдХрдбрд╝реА рдХрд╛ рдЪрд┐рд╣реНрди, рд▓рд┐рдВрдХ, рджреЛ рдЫрд▓реНрд▓реЗ
тЫУ => тЫУ, рд╢реНрд░реГрдВрдЦрд▓рд╛, реЫрдВрдЬреАрд░
ЁЯТЙ => ЁЯТЙ, рд╢реЙрдЯ, рд╕рд┐рд░реАрдВрдЬ, рд╕реВрдИ, рджрд╡рд╛рдИ, рдбреЙрдХреНрдЯрд░
ЁЯТК => ЁЯТК, рдЧреЛрд▓реА, рджрд╡рд╛рдИ, рдбреЙрдХреНрдЯрд░
ЁЯЧб => ЁЯЧб, рдЫреБрд░реА, рдХрдЯрд╛рд░, рд╣рдерд┐рдпрд╛рд░
ЁЯФк => ЁЯФк, рдЪрд╛рдХреВ
тЪФ => тЪФ, рддрд▓рд╡рд╛рд░реЗрдВ, рд╣рдерд┐рдпрд╛рд░
ЁЯФл => ЁЯФл, рдмрдВрджреВрдХ, рдкрд┐рд╕реНрдЯрд▓, рд░рд┐рд╡реЙрд▓реНрд╡рд░
ЁЯЫб => ЁЯЫб, рд╣рдерд┐рдпрд╛рд░
ЁЯП╣ => ЁЯП╣, рдмрд╛рдг, рдзрдиреБрд╖, рд░рд╛рд╢рд┐, рдЯреВрд▓
ЁЯПБ => ЁЯПБ, рдЪреМрдЦрд╛рдиреЗ рд╡рд╛рд▓рд╛ рдЭрдВрдбрд╛, рдзреНрд╡рдЬ, рдЪреМрдЦрд╛рдиреЗ, рд░реЗрд╕рд┐рдВрдЧ, рдЦреЗрд▓
ЁЯП│ => ЁЯП│, рд▓рд╣рд░рд╛рддрд╛ рд╕реЮреЗрдж рдЭрдВрдбрд╛, рд╕реЮреЗрдж рдЭрдВрдбрд╛
ЁЯП┤ => ЁЯП┤, рд▓рд╣рд░рд╛рддрд╛ рдХрд╛рд▓рд╛ рдЭрдВрдбрд╛, рдХрд╛рд▓рд╛ рдЭрдВрдбрд╛
ЁЯЪй => ЁЯЪй, рд╕реНрдерд╛рди рдХрд╛ рдЭрдВрдбрд╛, рд╕реНрдерд╛рди рдХреА рд╕реВрдЪрдирд╛ рд╡рд╛рд▓рд╛ рдЭрдВрдбрд╛, рддрд┐рдХреЛрдирд╛ рд╕реНрдерд╛рди рдЭрдВрдбрд╛, рддрд┐рдХреЛрдирд╛ рдЭрдВрдбрд╛, рдЭрдВрдбрд╛, рд╕реНрдерд╛рди
ЁЯЪм => ЁЯЪм, рдзреВрдореНрд░рдкрд╛рди рдХреА рдЕрдиреБрдорддрд┐ рд╣реИ, рдзреВрдореНрд░рдкрд╛рди, рдЪрд┐рд╣реНрди
тЪ░ => тЪ░, рддрд╛рдмреВрдд, рдореГрддреНрдпреБ
тЪ▒ => тЪ▒, рдЕрд╕реНрдерд┐ рдХрд▓рд╢, рдореГрддреНрдпреБ, рдЕрдВрддрд┐рдо рд╕рдВрд╕реНрдХрд╛рд░
ЁЯЧ┐ => ЁЯЧ┐, рдореВрд░реНрддрд┐, рдореЛрдпрд╛рдИ
ЁЯЫв => ЁЯЫв, рддреЗрд▓ рдХреА рдЯрдВрдХреА, рддреЗрд▓
ЁЯФо => ЁЯФо, рдХреНрд░рд┐рд╕реНрдЯрд▓ рдмреЙрд▓, рднрд╡рд┐рд╖реНрдп рджреЗрдЦрдирд╛, рдХреНрд░рд┐рд╕реНрдЯрд▓, рдЧреЗрдВрдж, рднрд╡рд┐рд╖реНрдп
ЁЯПз => ЁЯПз, рдПрдЯреАрдПрдо, рдСрдЯреЛрдореИрдЯреЗрдб рдЯреЗрд▓рд░, рд╕реНрд╡рдЪрд╛рд▓рд┐рдд, рдЯреЗрд▓рд░
ЁЯЪо => ЁЯЪо, рдЧрдВрджрдЧреА рдЗрд╕рдХреЗ рд╕реНрдерд╛рди рдкрд░ рд╣реА рдХрд░реЗрдВ, рд▓рд┐рдЯрд░ рдмреЙрдХреНрд╕, рдЪрд┐рд╣реНрди
ЁЯЪ░ => ЁЯЪ░, рдкреАрдиреЗ рдХрд╛ рдкрд╛рдиреА, рдкреЗрдпрдЬрд▓, рдкреАрдиреЗ рдХреЗ рдкрд╛рдиреА рдХрд╛ рдЪрд┐рд╣реНрди
тЩ┐ => тЩ┐, рд╡реНрд╣реАрд▓рдЪреЗрдпрд░ рдПрдХреНрд╕реЗрд╕, рд╡реНрд╣реАрд▓рдЪреЗрдпрд░, рдПрдХреНрд╕реЗрд╕, рд╡реНрд╣реАрд▓рдЪреЗрдпрд░ рдХрд╛ рдкреНрд░рддреАрдХ, рдЪрд┐рд╣реНрди
ЁЯЪ╣ => ЁЯЪ╣, рдкреБрд░реБрд╖ рдХрд╛ рдЪрд┐рд╣реНрди, рдкреБрд░реБрд╖ рдХрдХреНрд╖, рдкреБрд░реБрд╖ рдХрд╛ рдкреНрд░рддреАрдХ, рдЪрд┐рд╣реНрди
ЁЯЪ║ => ЁЯЪ║, рдорд╣рд┐рд▓рд╛ рдХрд╛ рдЪрд┐рд╣реНрди, рдорд╣рд┐рд▓рд╛ рдХрдХреНрд╖, рдорд╣рд┐рд▓рд╛ рдХрд╛ рдкреНрд░рддреАрдХ, рдЪрд┐рд╣реНрди
ЁЯЪ╗ => ЁЯЪ╗, рд╕реБрд╡рд┐рдзрд╛рдШрд░ рдХрд╛ рдЪрд┐рд╣реНрди, рд╕реБрд╡рд┐рдзрд╛рдШрд░, рдмрд╛рдерд░реВрдо, рд╢реМрдЪрд╛рд▓рдп
ЁЯЪ╝ => ЁЯЪ╝, рдмрдЪреНрдЪреЗ рдХрд╛ рдЪрд┐рд╣реНрди, рдЧрд╛рдбрд╝реА рдореЗрдВ рд╢рд┐рд╢реБ рд╣реИ, рдмрдЪреНрдЪреЗ рдХреЗ рдХрдкрдбрд╝реЗ рдмрджрд▓рдиреЗ рдХрд╛ рд╕реНрдерд╛рди, рд╢рд┐рд╢реБ
ЁЯЪ╛ => ЁЯЪ╛, рд╡реЙрдЯрд░ рдХреНрд▓реЛрд╕реЗрдЯ, WC, рд╕реБрд╡рд┐рдзрд╛рдШрд░, рд▓рд╛рд╡рд╛рдЯреЛрд░реА
ЁЯЫВ => ЁЯЫВ, рдкрд╛рд╕рдкреЛрд░реНрдЯ, рдирд┐рдпрдВрддреНрд░рдг
ЁЯЫД => ЁЯЫД, рд╕рд╛рдорд╛рди рд╡рд╛рдкрд╕реА, рдмреИрдЧреЗрдЬ
ЁЯЫЕ => ЁЯЫЕ, рдЫреВрдЯрд╛ рд╕рд╛рдорд╛рди, рд╕рд╛рдорд╛рди рд╕реЗрд╡рд╛, рд╕рд╛рдорд╛рди, рдмреИрдЧ
тЪа => тЪа, рдЪреЗрддрд╛рд╡рдиреА рдХрд╛ рдЪрд┐рд╣реНрди, рдЪреЗрддрд╛рд╡рдиреА, рдЪрд┐рд╣реНрди
ЁЯЪ╕ => ЁЯЪ╕, рдмрдЪреНрдЪреЗ рдирд┐рдХрд▓ рд░рд╣реЗ рд╣реИрдВ, рдмрдЪреНрдЪреЗ, рд╕рдбрд╝рдХ рдкрд╛рд░ рдХрд░рдирд╛, рдЪрд┐рд╣реНрди
тЫФ => тЫФ, рдкреНрд░рд╡реЗрд╢ рдирд┐рд╖реЗрдз рдЪрд┐рд╣реНрди, рдкреНрд░рд╡реЗрд╢ рдирд┐рд╖реЗрдз, рдирд┐рд╖рд┐рджреНрдз, рдирд╣реАрдВ, рдЪрд┐рд╣реНрди
ЁЯЪл => ЁЯЪл, рдкреНрд░рд╡реЗрд╢ рдирд┐рд╖реЗрдз рдХрд╛ рдЪрд┐рд╣реНрди, рдкреНрд░рд╡реЗрд╢ рдирд┐рд╖реЗрдз, рдЪрд┐рд╣реНрди
ЁЯЪ│ => ЁЯЪ│, рдмрд╛рдЗрдХ рдирд┐рд╖реЗрдз, рд╕рд╛рдЗрдХрд┐рд▓ рдирд┐рд╖реЗрдз, рд╕рд╛рдЗрдХрд┐рд▓ рдХреА рдЕрдиреБрдорддрд┐ рдирд╣реАрдВ, рдмрд╛рдЗрдХ, рд╡рд╛рд╣рди
ЁЯЪн => ЁЯЪн, рдзреВрдореНрд░рдкрд╛рди рдирд┐рд╖реЗрдз рдХрд╛ рдЪрд┐рд╣реНрди, рдзреВрдореНрд░рдкрд╛рди рдирд┐рд╖реЗрдз, рдЪрд┐рд╣реНрди
ЁЯЪп => ЁЯЪп, рдЧрдВрджрдЧреА рди рдХрд░реЗрдВ рдХрд╛ рдЪрд┐рд╣реНрди, рдЧрдВрджрдЧреА рди рдХрд░реЗрдВ, рдЧрдВрджрдЧреА рдирд╣реАрдВ, рдЪрд┐рд╣реНрди
ЁЯЪ▒ => ЁЯЪ▒, рдкреАрдиреЗ рдЕрдпреЛрдЧреНрдп, рдкрд╛рдиреА, рдкреАрдиреЗ рд▓рд╛рдпрдХ рдирд╣реАрдВ
ЁЯЪ╖ => ЁЯЪ╖, рдкрджрдпрд╛рддреНрд░реА рдирд┐рд╖реЗрдз, рдкреИрджрд▓ рдЪрд▓рдиреЗ рдХреА рдЕрдиреБрдорддрд┐ рдирд╣реАрдВ, рдкрджрдпрд╛рддреНрд░реА, рдкреИрджрд▓, рдЪрд┐рд╣реНрди
тШв => тШв, рд░реЗрдбрд┐рдпреЛ
тмЖ => тмЖ, рдКрдкрд░ рддреАрд░, рддреАрд░, рдХрд╛рд░реНрдбрд┐рдирд▓, рджрд┐рд╢рд╛, рдЙрддреНрддрд░ рджрд┐рд╢рд╛
тЖЧ => тЖЧ, рдКрдкрд░-рджрд╛рдпрд╛рдВ рддреАрд░, рджрд┐рд╢рд╛, рдЗрдВрдЯрд░рдХрд╛рд░реНрдбрд┐рдирд▓, рдЙрддреНрддрд░рдкреВрд░реНрд╡ рджрд┐рд╢рд╛
тЮб => тЮб, рджрд╛рдпрд╛рдВ рддреАрд░, рдХрд╛рд░реНрдбрд┐рдирд▓, рджрд┐рд╢рд╛, рдкреВрд░реНрд╡ рджрд┐рд╢рд╛
тЖШ => тЖШ, рдиреАрдЪреЗ-рджрд╛рдпрд╛рдВ рддреАрд░, рдЗрдВрдЯрд░рдХрд╛рд░реНрдбрд┐рдирд▓, рджрдХреНрд╖рд┐рдгрдкреВрд░реНрд╡ рджрд┐рд╢рд╛
тмЗ => тмЗ, рдиреАрдЪреЗ рддреАрд░, рдХрд╛рд░реНрдбрд┐рдирд▓, рдиреАрдЪреЗ, рджрдХреНрд╖рд┐рдг рджрд┐рд╢рд╛
тЖЩ => тЖЩ, рдиреАрдЪреЗ-рдмрд╛рдпрд╛рдВ рддреАрд░, рдЗрдВрдЯрд░рдХрд╛рд░реНрдбрд┐рдирд▓, рджрдХреНрд╖рд┐рдгрдкрд╢реНрдЪрд┐рдо рджрд┐рд╢рд╛
тмЕ => тмЕ, рдмрд╛рдпрд╛рдВ рддреАрд░, рдХрд╛рд░реНрдбрд┐рдирд▓, рдкрд╢реНрдЪрд┐рдо рджрд┐рд╢рд╛
тЖЦ => тЖЦ, рдКрдкрд░-рдмрд╛рдпрд╛рдВ рддреАрд░, рдЗрдВрдЯрд░рдХрд╛рд░реНрдбрд┐рдирд▓, рдЙрддреНрддрд░ рдкрд╢реНрдЪрд┐рдо рджрд┐рд╢рд╛
тЖХ => тЖХ, рддреАрд░
тЖФ => тЖФ, рддреАрд░
тЖй => тЖй, рддреАрд░
тЖк => тЖк, рддреАрд░
тд┤ => тд┤, рддреАрд░
тд╡ => тд╡, рддреАрд░
ЁЯФГ => ЁЯФГ, рдкреБрдирдГ рд▓реЛрдб рдХрд░реЗрдВ, рдкреБрдирдГ рд▓реЛрдб рдХрд░рдиреЗ рдХрд╛ рдЪрд┐рд╣реНрди, рд▓рдВрдмрд╡рдд рджрдХреНрд╖рд┐рдгрд╛рд╡рд░реНрдд рддреАрд░, рддреАрд░
ЁЯФД => ЁЯФД, рдШрдбрд╝реА рдХреА рд╡рд┐рдкрд░реАрдд рджрд┐рд╢рд╛ рдореЗрдВ рддреАрд░, рд╡рд╛рдорд╛рд╡рд░реНрдд, рддреАрд░
ЁЯФЩ => ЁЯФЩ, рд╡рд╛рдкрд╕, рд╡рд╛рдкрд╕ рддреАрд░, рдмрд╛рдПрдВ рддреАрд░ рдХреЗ рд╕рд╛рде рд╡рд╛рдкрд╕, рдмрд╛рдпрд╛рдВ рддреАрд░, рддреАрд░
ЁЯФЪ => ЁЯФЪ, рд╕рдорд╛рдкреНрддрд┐, рд╕рдорд╛рдкреНрддрд┐ рддреАрд░, рдмрд╛рдПрдВ рддреАрд░ рдХреЗ рд╕рд╛рде рд╕рдорд╛рдкреНрддрд┐, рдмрд╛рдпрд╛рдВ рддреАрд░, рддреАрд░
ЁЯФЫ => ЁЯФЫ, рдЪрд╛рд▓реВ рддреАрд░, рд╡рд┐рд╕реНрдордп рдЪрд┐рд╣реНрди рдФрд░ рддреАрд░ рдХреЗ рд╕рд╛рде рдЪрд╛рд▓реВ, рддреАрд░, рд╡рд┐рд╕реНрдордп рдЪрд┐рд╣реНрди, рд╡рд┐рд╕реНрдордп
ЁЯФЬ => ЁЯФЬ, рдЬрд▓реНрджреА рдЪрд┐рд╣реНрди, рдЬрд▓реНрджреА, рджрд╛рдПрдВ рддреАрд░ рдХреЗ рд╕рд╛рде рдЬрд▓реНрджреА, рддреАрд░
ЁЯФЭ => ЁЯФЭ, рд╢реАрд░реНрд╖ рдЪрд┐рд╣реНрди, рд╢реАрд░реНрд╖, рдКрдкрд░ рддреАрд░ рдХреЗ рд╕рд╛рде рд╢реАрд░реНрд╖, рдКрдкрд░ рддреАрд░, рдКрдкрд░
ЁЯЫР => ЁЯЫР, рдЖрд░рд╛рдзрдирд╛ рд╕реНрдерд▓, рдкреВрдЬрд╛, рдкреНрд░рд╛рд░реНрдердирд╛, рдзрд░реНрдо
тЪЫ => тЪЫ, рдирд╛рд╕реНрддрд┐рдХ, рдЕрдгреБ
ЁЯХЙ => ЁЯХЙ, реР, рд╣рд┐рдВрджреВ, рдзрд░реНрдо
тЬб => тЬб, рдбреЗрд╡рд┐рдб, рдпрд╣реВрджреА, рдзрд░реНрдо, рддрд╛рд░рд╛
тШ╕ => тШ╕, рдзрд░реНрдо рдЪрдХреНрд░, рдзрд░реНрдо, рдЪрдХреНрд░
тШп => тШп, рдпрд┐рдВрдЧ рдпрд╛рдВрдЧ, рддрд╛рдУ, рддрд╛рдУрд╡рд╛рджреА, рдзрд░реНрдо
тЬЭ => тЬЭ, рд▓реИрдЯрд┐рди рдХреНрд░реЙрд╕, рдИрд╕рд╛рдИ, рдзрд░реНрдо
тШж => тШж, рдИрд╕рд╛рдИ, рдХреНрд░реЙрд╕, рдзрд░реНрдо
тШк => тШк, рдЪрд╛рдВрдж рдФрд░ рддрд╛рд░рд╛, рдЗрд╕реНрд▓рд╛рдо, рдзрд░реНрдо
ЁЯХО => ЁЯХО, рджреАрдкрд╛рдзрд╛рд░, рдореЛрдордмрддреНрддреА, рдзрд░реНрдо
ЁЯФп => ЁЯФп, рдЫрд╣ рдореБрдЦреА рддрд╛рд░рд╛, рднрд╡рд┐рд╖реНрдп рдмрддрд╛рдирд╛, рдЫрд╣ рд╕рд┐рд░реЗ, рддрд╛рд░рд╛, рднрд╡рд┐рд╖реНрдп
тЩ╗ => тЩ╗, рдкреБрдирд░реНрдЪрдХреНрд░реАрдХрд░рдг рдкреНрд░рддреАрдХ, рдареЛрд╕ рд╡реИрд╢реНрд╡рд┐рдХ рдкреБрдирд░реНрдЪрдХреНрд░реАрдХрд░рдг рдкреНрд░рддреАрдХ, рд░реАрд╕рд╛рдЗрдХреНрд▓рд┐рдВрдЧ, рд╡реИрд╢реНрд╡рд┐рдХ, рдЪрд┐рд╣реНрди
ЁЯУЫ => ЁЯУЫ, рдирд╛рдо рдмреИрдЬ, рдмреИрдЬ, рдмрд┐рд▓реНрд▓рд╛, рдирд╛рдо
ЁЯФ░ => ЁЯФ░, рд╣рд░реА рдФрд░ рдкреАрд▓реА рдкрддреНрддреА, рд╣рд░рд╛ рдФрд░ рдкреАрд▓рд╛, рд╢реБрд░реБрдЖрддрдХрд░реНрддрд╛ рдХреЗ рд▓рд┐рдП рдЬрд╛рдкрд╛рдиреА рдЪрд┐рд╣реНрди
ЁЯФ▒ => ЁЯФ▒, рддреНрд░рд┐рд╢реВрд▓ рдХрд╛ рдЪрд┐рд╣реНрди, рдПрдВрдХрд░, рддреНрд░рд┐рд╢реВрд▓, рдкреНрд░рддреАрдХ
тнХ => тнХ, рд╡реГрддреНрдд, рдЧреЛрд▓рд╛
тЬЕ => тЬЕ, рдЪреЗрдХ рдорд╛рд░реНрдХ, рд╕рд╣реА рдХрд╛ рдЪрд┐рд╣реНрди, рдЪреЗрдХ, рдмрдбрд╝рд╛ рдЪреЗрдХ рдорд╛рд░реНрдХ
тШС => тШС, рдЪреЗрдХ рдХреЗ рд╕рд╛рде рдорддрдкрддреНрд░, рдорддрдкрддреНрд░, рдмреЙрдХреНрд╕
тЬФ => тЬФ, рдорд╛рд░реНрдХ
тЬЦ => тЬЦ, рдмреЬрд╛ рдЧреБрдгрд╛, рдирд┐рд░рд╕реНрдд, рдХрд╛рдЯрдиреЗ рдХрд╛ рдЪрд┐рд╣реНрди
тЭМ => тЭМ, тАЬXтАЭ
тЭО => тЭО, рд╡рд░реНрдЧ рдореЗрдВ тАЬXтАЭ
тЮХ => тЮХ, рдзрди, рдзрди рдЪрд┐рд╣реНрди, рдЪрд┐рд╣реНрди
тЮЦ => тЮЦ, рдЛрдг, рдЛрдг рдЪрд┐рд╣реНрди, рдЪрд┐рд╣реНрди
тЮЧ => тЮЧ, рднрд╛рдЧ, рд╡рд┐рднрд╛рдЬрди рдХрд╛ рдЪрд┐рд╣реНрди, рдЪрд┐рд╣реНрди
тЮ░ => тЮ░, рд▓рд╣рд░рджрд╛рд░ рдлрдВрджрд╛, рдореЛрдбрд╝, рд▓реВрдк
тЮ┐ => тЮ┐, рд▓рд╣рд░рджрд╛рд░ рдлрдВрджрд╛, рд▓реВрдк, рдЬрд╛рдкрд╛рди, рдирд┐рд╢реБрд▓реНрдХ рдбрд╛рдпрд▓
тЬ│ => тЬ│, рдЪрд┐рд╣реНрди
тЬ┤ => тЬ┤, рдЪрд┐рд╣реНрди
тЭЗ => тЭЗ, рдЪрд┐рд╣реНрди
ЁЯТ▒ => ЁЯТ▒, рдореБрджреНрд░рд╛, рдкреИрд╕реЗ, рд╡рд┐рдирд┐рдордп
ЁЯТ▓ => ЁЯТ▓, рдЧрд╣рд░рд╛ рдбреЙрд▓рд░ рдЪрд┐рд╣реНрди, рдбреЙрд▓рд░, рдкреИрд╕реЗ
тА╝ => тА╝, рд╡рд┐рд░рд╛рдо рдЪрд┐рд╣реНрди
тБЙ => тБЙ, рд╡рд┐рд░рд╛рдо рдЪрд┐рд╣реНрди
тЭУ => тЭУ, рд▓рд╛рд▓ рдкреНрд░рд╢реНрди рдЪрд┐рд╣реНрди, рдкреНрд░рд╢реНрди
тЭФ => тЭФ, рдкреНрд░рд╢реНрди рдЪрд┐рд╣реНрди, рдкреНрд░рд╢реНрди
тЭХ => тЭХ, рд╡рд┐рд╕реНрдордпрд╛рджрд┐ рдмреЛрдзрдХ, рд╡рд┐рд╕реНрдордп рдЪрд┐рд╣реНрди, рд╡рд┐рд╕реНрдордп
тЭЧ => тЭЧ, рд╡рд┐рд╕реНрдордпрд╛рджрд┐рдмреЛрдзрдХ рдЪрд┐рд╣реНрди, рд╡рд┐рд░рд╛рдо рдЪрд┐рд╣реНрди
уА░ => уА░, рд▓рд╣рд░рд┐рд▓ рдбреИрд╢, рд▓рдВрдмреА рдЖрд╡рд╛рдЬрд╝ рдХрд╛ рдЪрд┐рд╣реНрди, рд▓рд╣рд░рд┐рд▓, рдбреИрд╢
┬й => ┬й, рдХреЙрдкреАрд░рд╛рдЗрдЯ рдЪрд┐рд╣реНрди
┬о => ┬о, рдкрдВрдЬреАрдХреГрдд
тДв => тДв, рд╡реНрдпрд╛рдкрд╛рд░ рдЪрд┐рд╣реНрди, рдЪрд┐рд╣реНрди
тЩИ => тЩИ, рдореЗрд╖, рд░рд╛рд╢рд┐
тЩЙ => тЩЙ, рд╡реГрд╖рдн, рд░рд╛рд╢рд┐
тЩК => тЩК, рдорд┐рдереБрди, рд░рд╛рд╢рд┐
тЩЛ => тЩЛ, рдХрд░реНрдХ, рд░рд╛рд╢рд┐
тЩМ => тЩМ, рд╕рд┐рдВрд╣, рд░рд╛рд╢рд┐
тЩН => тЩН, рдХрдиреНрдпрд╛, рд░рд╛рд╢рд┐
тЩО => тЩО, рддреБрд▓рд╛, рд░рд╛рд╢рд┐
тЩП => тЩП, рд╡реГрд╢реНрдЪрд┐рдХ, рд░рд╛рд╢рд┐
тЩР => тЩР, рдзрдиреБ, рд░рд╛рд╢рд┐
тЩС => тЩС, рдордХрд░, рд░рд╛рд╢рд┐
тЩТ => тЩТ, рдХреБрдВрдн, рд░рд╛рд╢рд┐
тЩУ => тЩУ, рдореАрди, рд░рд╛рд╢рд┐
тЫО => тЫО, рд╕рд░реНрдк, рд░рд╛рд╢рд┐
ЁЯФА => ЁЯФА, рдХрд╛рдЯрддреЗ рд╣реБрдП рддреАрд░, рддреАрд░
ЁЯФБ => ЁЯФБ, рджрдХреНрд╖рд┐рдгрд╛рд╡рд░реНрдд, рддреАрд░
ЁЯФВ => ЁЯФВ, рдШрдбрд╝реА рдХреА рджрд┐рд╢рд╛ рдореЗрдВ рддреАрд░, рджрдХреНрд╖рд┐рдгрд╛рд╡рд░реНрдд, рддреАрд░, рдЕрдВрдХ 1
тЦ╢ => тЦ╢, рдЪрд▓рд╛рдПрдВ рдмрдЯрди, рддреНрд░рд┐рдХреЛрдг
тПй => тПй, рдлрд╝рд╛рд╕реНрдЯ рдлрд╝реЙрд░реНрд╡рд░реНрдб, рджреЛрд╣рд░рд╛ рджрд╛рдпрд╛рдВ рддреАрд░, рджрд╛рдпрд╛рдВ, рддреАрд░
тПн => тПн, рджреЛрд╣рд░рд╛ рджрд╛рдпрд╛рдВ рддреАрд░, рджрд╛рдпрд╛рдВ рддреАрд░, рджрд╛рдпрд╛рдВ, рдЕрдЧрд▓рд╛ рдЯреНрд░реИрдХ
тЧА => тЧА, рдкреАрдЫреЗ рдЬрд╛рдПрдВ рдмрдЯрди, рдмрд╛рдПрдВ, рддреНрд░рд┐рдХреЛрдг
тПк => тПк, рд░реАрд╡рд╛рдЗрдВрдб, рджреЛрд╣рд░рд╛ рдмрд╛рдпрд╛рдВ рддреАрд░, рдмрд╛рдпрд╛рдВ, рддреАрд░
тПо => тПо, рд░реАрд╡рд╛рдЗрдВрдб, рджреЛрд╣рд░рд╛ рд░реАрд╡рд╛рдЗрдВрдб рддреАрд░
ЁЯФ╝ => ЁЯФ╝, рдКрдкрд░ рддреНрд░рд┐рднреБрдЬ, рддреНрд░рд┐рднреБрдЬ, рдмрдЯрди
тПл => тПл, рдКрдкрд░ рддреАрд░, рджреЛрд╣рд░рд╛ рдКрдкрд░ рддреАрд░, рдКрдкрд░, рддреАрд░
ЁЯФ╜ => ЁЯФ╜, рдиреАрдЪреЗ рддреНрд░рд┐рднреБрдЬ, рддреНрд░рд┐рднреБрдЬ, рдмрдЯрди
тПм => тПм, рдиреАрдЪреЗ рддреАрд░, рджреЛрд╣рд░рд╛ рдиреАрдЪреЗ рддреАрд░, рдиреАрдЪреЗ, рддреАрд░
тП╕ => тП╕, рдмрд╛рд░, рджреЛрд╣рд░рд╛, рд░реЛрдХреЗрдВ, рд▓рдВрдмрд╡рдд
тП╣ => тП╣, рд╡рд░реНрдЧ, рд░реЛрдХреЗрдВ
тПП => тПП, рдирд┐рдХрд╛рд▓реЗрдВ
ЁЯОж => ЁЯОж, рдореВрд╡реА, рд╕рд┐рдиреЗрдорд╛, рдореВрд╡реА рдХрд╛ рдЪрд┐рд╣реНрди, рдордиреЛрд░рдВрдЬрди
ЁЯФЕ => ЁЯФЕ, рдХрдо рдЪрдордХ, рдХрдо, рдордВрдж, рдХрдо рдЪрдордХ рдХрд╛ рдЪрд┐рд╣реНрди, рдЪрдордХ
ЁЯФЖ => ЁЯФЖ, рдЪрдордХрджрд╛рд░, рдЕрдзрд┐рдХ рдЪрдордХ рдХрд╛ рдЪрд┐рд╣реНрди, рдЪрдордХ
ЁЯУ╢ => ЁЯУ╢, рдореЛрдмрд╛рдЗрд▓ рд╕рдВрдХреЗрдд, рдмрд╛рд░ рдХреЗ рд╕рд╛рде рдПрдВрдЯреЗрдирд╛, рд╕рдВрдХреЗрдд рдкреНрд░рдмрд▓рддрд╛, рд╕рд┐рдЧреНрдирд▓, рдПрдВрдЯреАрдирд╛, рдореЛрдмрд╛рдЗрд▓, рдлрд╝реЛрди
ЁЯУ╡ => ЁЯУ╡, рд╕реЗрд▓ рдлрд╝реЛрди рдирд┐рд╖рд┐рджреНрдз, рдХреЙрд▓ рди рдХрд░реЗрдВ, рдореЛрдмрд╛рдЗрд▓, рдлрд╝реЛрди
ЁЯУ│ => ЁЯУ│, рдХрдВрдкрди рдореЛрдб, рд╡рд╛рдЗрдмреНрд░реЗрд╢рди рдореЛрдб, рд╕реЗрд▓ рдлрд╝реЛрди, рдореЛрдмрд╛рдЗрд▓, рдлрд╝реЛрди, рдореЛрдб
ЁЯУ┤ => ЁЯУ┤, рдлрд╝реЛрди рдмрдВрдж, рд╕реЗрд▓ рдлрд╝реЛрди, рдореЛрдмрд╛рдЗрд▓, рдлрд╝реЛрди, рдмрдВрдж
#тГг => #тГг, рд╣реИрд╢, рдХреАрдХреИрдк, рдкрд╛рдЙрдВрдб
*тГг => *тГг, рддрд╛рд░рдХ рдЪрд┐рд╣реНрди, рдХреАрдХреИрдк, рдПрдХреНрд╕реНрдЯрд░рд┐рд╕реНрдХ
0тГг => 0тГг, рдХреАрдХреИрдк, рд╢реВрдиреНрдп
1тГг => 1тГг, 1, рдХреАрдХреИрдк, рдПрдХ
2тГг => 2тГг, 2, рдХреАрдХреИрдк, рджреЛ
3тГг => 3тГг, 3, рдХреАрдХреИрдк, рддреАрди
4тГг => 4тГг, 4, рдХреАрдХреИрдк, рдЪрд╛рд░
5тГг => 5тГг, 5, рдХреАрдХреИрдк, рдкрд╛рдВрдЪ
6тГг => 6тГг, 6, рдХреАрдХреИрдк, рдЫрдГ
7тГг => 7тГг, 7, рдХреАрдХреИрдк, рд╕рд╛рдд
8тГг => 8тГг, 8, рдХреАрдХреИрдк, рдЖрда
9тГг => 9тГг, 9, рдХреАрдХреИрдк, рдиреМ
ЁЯФЯ => ЁЯФЯ, рдХреАрдХреИрдк рджрд╕, 10
ЁЯТп => ЁЯТп, рдкреВрд░реЗ рдЕрдВрдХ, 100, рдЕрдВрдХ
ЁЯФЮ => ЁЯФЮ, 18 рд╡рд░реНрд╖ рд╕реЗ рдЫреЛрдЯреЗ рдирд┐рд╖рд┐рджреНрдз, 18 рд╡рд░реНрд╖ рд╕реЗ рдЫреЛрдЯреЗ, 18
ЁЯФа => ЁЯФа, рдЕрдкрд░рдХреЗрд╕ рдЕрдХреНрд╖рд░, рдмрдбрд╝реЗ рдЕрдХреНрд╖рд░ рдбрд╛рд▓реЗрдВ, рдЕрдкрд░рдХреЗрд╕ рд▓реИрдЯрд┐рди, рдЕрдкрд░рдХреЗрд╕, рд▓реИрдЯрд┐рди
ЁЯФб => ЁЯФб, рд▓реЛрдЕрд░рдХреЗрд╕ рдЕрдХреНрд╖рд░, рдЫреЛрдЯреЗ рдЕрдХреНрд╖рд░ рдбрд╛рд▓реЗрдВ, рд▓реЛрдЕрд░рдХреЗрд╕ рд▓реИрдЯрд┐рди, рд▓реЛрдЕрд░рдХреЗрд╕, рд▓реИрдЯрд┐рди
ЁЯФв => ЁЯФв, рд╕рдВрдЦреНрдпрд╛рдПрдВ, рдЕрдВрдХ рджрд░реНрдЬ рдХрд░реЗрдВ
ЁЯФг => ЁЯФг, рдкреНрд░рддреАрдХ, рдкреНрд░рддреАрдХ рдбрд╛рд▓реЗрдВ
ЁЯФд => ЁЯФд, рд▓реИрдЯрд┐рди рд╡рд░реНрдгрдорд╛рд▓рд╛, рд▓реИрдЯрд┐рди, рдЕрдВрдЧреНрд░реЗрдЬрд╝реА, ABC
ЁЯЕ░ => ЁЯЕ░, рд░рдХреНрдд рдкреНрд░рдХрд╛рд░ рдП, рдкреНрд░рдХрд╛рд░ рдП, рд░рдХреНрдд рдкреНрд░рдХрд╛рд░, рдЦреВрди, рдП
ЁЯЖО => ЁЯЖО, рд░рдХреНрдд рдкреНрд░рдХрд╛рд░ рдПрдмреА, рдкреНрд░рдХрд╛рд░ рдПрдмреА, рд░рдХреНрдд рдкреНрд░рдХрд╛рд░, рдЦреВрди, рдПрдмреА
ЁЯЕ▒ => ЁЯЕ▒, рд░рдХреНрдд рдкреНрд░рдХрд╛рд░ рдмреА, рдкреНрд░рдХрд╛рд░ рдмреА, рд░рдХреНрдд рдкреНрд░рдХрд╛рд░, рдЦреВрди, рдмреА
ЁЯЖС => ЁЯЖС, рд╕рд╛рдлрд╝, рдХреНрд▓реАрдпрд░, рд╕рд╛рдлрд╝ рдЪрд┐рд╣реНрди, CL
ЁЯЖТ => ЁЯЖТ, рдардВрдбрд╛, рдардВрдбрд╛ рдЪрд┐рд╣реНрди
ЁЯЖУ => ЁЯЖУ, рдирд┐рд╢реБрд▓реНрдХ, рдирд┐рд╢реБрд▓реНрдХ рдЪрд┐рд╣реНрди, рд╢реБрд▓реНрдХ рдореБрдХреНрдд, рдЪрд┐рд╣реНрди
тД╣ => тД╣, рдЖрдИ, рдЕрдХреНрд╖рд░ рдЖрдИ, рдЬрд╛рдирдХрд╛рд░реА, рд╕реВрдЪрдирд╛
ЁЯЖФ => ЁЯЖФ, рдЖрдИрдбреА, рдЖрдИрдбреА рдЪрд┐рд╣реНрди, рдкрд╣рдЪрд╛рди, рдЪрд┐рд╣реНрди
ЁЯЖХ => ЁЯЖХ, рдирдпрд╛, рдирдпрд╛ рдЪрд┐рд╣реНрди, рдЪрд┐рд╣реНрди
ЁЯЖЦ => ЁЯЖЦ, рдареАрдХ рдирд╣реАрдВ, рдареАрдХ рдирд╣реАрдВ рдЪрд┐рд╣реНрди, рдЪрд┐рд╣реНрди
ЁЯЕ╛ => ЁЯЕ╛, рд░рдХреНрдд рдкреНрд░рдХрд╛рд░ рдУ, рдкреНрд░рдХрд╛рд░ рдУ, рд░рдХреНрдд рдкреНрд░рдХрд╛рд░, рдЦреВрди, рдУ
ЁЯЖЧ => ЁЯЖЧ, рдареАрдХ, рдареАрдХ рдЪрд┐рд╣реНрди
ЁЯЕ┐ => ЁЯЕ┐, рдкрд╛рд░реНрдХрд┐рдВрдЧ, рдкрд╛рд░реНрдХрд┐рдВрдЧ рд▓реЙрдЯ
ЁЯЖШ => ЁЯЖШ, SOS, SOS рдЪрд┐рд╣реНрди, рдорджрдж, рд╕рд╣рд╛рдпрддрд╛, рдмрдЪрд╛рдУ, рдЪрд┐рд╣реНрди
ЁЯЖЩ => ЁЯЖЩ, рдЕрдк!, рдЕрдк! рдЪрд┐рд╣реНрди, рдирдИ рдЬрд╛рдирдХрд╛рд░реА, рдЕрдкрдбреЗрдЯ, рдЪрд┐рд╣реНрди
ЁЯЖЪ => ЁЯЖЪ, рд╡рд┐рд░реБрджреНрдз, рдмрдирд╛рдо, рд╡рд┐рд░реБрджреНрдз рдЪрд┐рд╣реНрди, рдЪрд┐рд╣реНрди
ЁЯИБ => ЁЯИБ, рдЪреМрдХреЛрд░ рдореЗрдВ рдпрд╣рд╛рдВ рдХрд╛ рдЬрд╛рдкрд╛рдиреА рдЪрд┐рд╣реНрди
ЁЯИВ => ЁЯИВ, рдЬрд╛рдкрд╛рдиреА рд╢рдмреНрдж
ЁЯИ╖ => ЁЯИ╖, рдЬрд╛рдкрд╛рдиреА рд╢рдмреНрдж
ЁЯИ╢ => ЁЯИ╢, рдЬрд╛рдкрд╛рдиреА рд╢рдмреНрдж
ЁЯИп => ЁЯИп, рдЬрд╛рдкрд╛рдиреА рд╢рдмреНрдж
ЁЯЙР => ЁЯЙР, рдЬрд╛рдкрд╛рдиреА рд╢рдмреНрдж
ЁЯИ╣ => ЁЯИ╣, рдЬрд╛рдкрд╛рдиреА рд╢рдмреНрдж
ЁЯИЪ => ЁЯИЪ, рдЬрд╛рдкрд╛рдиреА рд╢рдмреНрдж
ЁЯИ▓ => ЁЯИ▓, рдЬрд╛рдкрд╛рдиреА рд╢рдмреНрдж
ЁЯЙС => ЁЯЙС, рдЪреАрдиреА рд╢рдмреНрдж
ЁЯИ╕ => ЁЯИ╕, рдЪреАрдиреА рд╢рдмреНрдж
ЁЯИ┤ => ЁЯИ┤, рдЪреАрдиреА рд╢рдмреНрдж
ЁЯИ│ => ЁЯИ│, рдЪреАрдиреА рд╢рдмреНрдж
уКЧ => уКЧ, рд╡реГрддреНрдд рдореЗрдВ рдмрдзрд╛рдИ рджреЗрддрд╛ рдЖрдЗрдбрд┐рдпреЛрдЧреНрд░рд╛рдлрд╝, рд╡реГрддреНрдд
уКЩ => уКЩ, рд╡реГрддреНрдд рдореЗрдВ рд╕реЗрдХреНрд░реЗрдЯ рдЖрдЗрдбрд┐рдпреЛрдЧреНрд░рд╛рдлрд╝, рд╡реГрддреНрдд
ЁЯИ║ => ЁЯИ║, рдЪреАрдиреА рд╢рдмреНрдж
ЁЯИ╡ => ЁЯИ╡, рдЪреАрдиреА рд╢рдмреНрдж
тЦк => тЦк, рдЬреНрдпрд╛рдорд┐рддреА
тЦл => тЦл, рдЬреНрдпрд╛рдорд┐рддреА
тЧ╗ => тЧ╗, рдЬреНрдпрд╛рдорд┐рддреА
тЧ╝ => тЧ╝, рдЬреНрдпрд╛рдорд┐рддреА
тЧ╜ => тЧ╜, рдЬреНрдпрд╛рдорд┐рддреА
тЧ╛ => тЧ╛, рдЬреНрдпрд╛рдорд┐рддреА
тмЬ => тмЬ, рдЬреНрдпрд╛рдорд┐рддреА
ЁЯФ╢ => ЁЯФ╢, рдмрдбрд╝рд╛ рд╣реАрд░рд╛, рдирд╛рд░рдВрдЧреА, рд╣реАрд░рд╛
ЁЯФ╖ => ЁЯФ╖, рдмрдбрд╝рд╛ рд╣реАрд░рд╛, рдиреАрд▓рд╛, рд╣реАрд░рд╛
ЁЯФ╕ => ЁЯФ╕, рдЫреЛрдЯрд╛ рд╣реАрд░рд╛, рдирд╛рд░рдВрдЧреА, рд╣реАрд░рд╛
ЁЯФ╣ => ЁЯФ╣, рдЫреЛрдЯрд╛ рд╣реАрд░рд╛, рдиреАрд▓рд╛, рд╣реАрд░рд╛
ЁЯФ║ => ЁЯФ║, рдКрдкрд░ рддреНрд░рд┐рднреБрдЬ, рдКрдкрд░ рд▓рд╛рд▓ рддреНрд░рд┐рднреБрдЬ, рд▓рд╛рд▓, рддреНрд░рд┐рднреБрдЬ
ЁЯФ╗ => ЁЯФ╗, рдиреАрдЪреЗ рддреНрд░рд┐рднреБрдЬ, рдиреАрдЪреЗ рд▓рд╛рд▓ рддреНрд░рд┐рднреБрдЬ, рд▓рд╛рд▓, рддреНрд░рд┐рднреБрдЬ
ЁЯТа => ЁЯТа, рдлреВрд▓ рдХреА рдкрдВрдЦреБрдбрд╝реА, рдЖрдХрд░реНрд╖рдХ, рдлреВрд▓, рд╣реАрд░реЗ рдЬреИрд╕рд╛ рдЖрдХрд╛рд░, рд╣реАрд░рд╛, рднрд╛рд╡рдирд╛
ЁЯФШ => ЁЯФШ, рдмрдЯрди, рд░реЗрдбрд┐рдпреЛ
ЁЯФ▓ => ЁЯФ▓, рд╡рд░реНрдЧ, рдмрдЯрди
ЁЯФ│ => ЁЯФ│, рд╡рд░реНрдЧ рдмрдЯрди, рд╡рд░реНрдЧ, рдмрдЯрди
тЪк => тЪк, рдЬреНрдпрд╛рдорд┐рддреА
тЪл => тЪл, рдЬреНрдпрд╛рдорд┐рддреА
ЁЯФ┤ => ЁЯФ┤, рдмрдбрд╝рд╛ рдЧреЛрд▓рд╛, рд▓рд╛рд▓, рд╡реГрддреНрдд
ЁЯФ╡ => ЁЯФ╡, рдмрдбрд╝рд╛ рдЧреЛрд▓рд╛, рдиреАрд▓рд╛, рд╡реГрддреНрдд
