ЁЯША => ЁЯША, рмжрм╛рмирнНрмд рмирм┐рмХрнБрмЯрм┐рммрм╛, рмжрм╛рмирнНрмд рмжрнЗрмЦрм╛рмЗрммрм╛, рмжрм╛рмирнНрмд рмжрнЗрмЦрм╛рмЗ рм╣рм╕рм┐рммрм╛, рм╣рм╕рм┐рммрм╛, рморнБрм╣рмБ, рм╣рм╕, рм╣рм╛ рм╣рм╛ рм╣рм╛, рмХрнМрмдрнБрмХрм┐рмЖ
ЁЯШБ => ЁЯШБ, рмжрм╛рмирнНрмд рмирм┐рмХрнБрмЯрм┐рммрм╛, рм╣рм╕рм╣рм╕рм┐рмЖ рмЖрмЦрм┐, рмжрм╛рмирнНрмд рмжрнЗрмЦрм╛рмЗрммрм╛, рм╣рм╕, рм╣рм╕рм┐рммрм╛, рм╣рм╕ рм╣рм╕рм┐рмЖ рмЖрмЦрм┐ рм╕рм╣рм┐рмд рмжрм╛рмирнНрмд рмжрнЗрмЦрм╛рмЗрммрм╛, рморнБрм╣рмБ, рм╣рм╛ рм╣рм╛ рм╣рм╛, рмХрнМрмдрнБрмХрм┐рмЖ
ЁЯШВ => ЁЯШВ, рмЦрнБрм╕рнАрм░ рм▓рнБрм╣, рмЦрнБрм╕рнА, рм▓рнБрм╣, рморнБрм╣рмБрм░рнЗ рмЦрнБрм╕рнАрм░ рм▓рнБрм╣, рморнБрм╣рмБ
ЁЯШГ => ЁЯШГ, рморнБрм╣рмБ рмЦрнЛрм▓рм╛ рм╣рм╕, рм╣рм╕рм┐рммрм╛, рм╣рм╕, рмкрм╛рмЯрм┐ рмЦрнЛрм▓рм╛ рм╣рм╕рм░ рморнБрм╣рмБ, рморнБрм╣рмБ, рм╣рм╛ рм╣рм╛ рм╣рм╛, рмХрнМрмдрнБрмХрм┐рмЖ
ЁЯШД => ЁЯШД, рморнБрм╣рмБ рмЦрнЛрм▓рм╛ рм╣рм╕, рм╣рм╕рм┐рммрм╛, рм╣рм╕, рмкрм╛рмЯрм┐ рмЦрнЛрм▓рм┐рммрм╛, рм╣рм╕ рм╣рм╕рм┐рмЖ рмЖрмЦрм┐, рм╣рм╛ рм╣рм╛ рм╣рм╛, рмХрнМрмдрнБрмХрм┐рмЖ
ЁЯШЕ => ЁЯШЕ, рмЖрм░рм╛рморм░рнЗ рм╣рм╕рм┐рммрм╛, рмермгрнНрмбрм╛ рмЭрм╛рм│ рм╕рм╣рм┐рмд рм╣рм╕, рмермгрнНрмбрм╛ рмЭрм╛рм│
ЁЯШЖ => ЁЯШЖ, рмкрм╛рмЯрм┐ рмЦрнЛрм▓рм┐ рм╣рм╕рм┐рммрм╛, рмЦрнЛрм▓рм╛ рмкрм╛рмЯрм┐рм░рнЗ рм╣рм╕рм┐рммрм╛, рмЦрнЛрм▓рм╛ рмкрм╛рмЯрм┐ рм╕рм╣рм┐рмд рм╣рм╕ рморнБрм╣рмБ, рмЦрнЛрм▓рм╛ рмкрм╛рмЯрм┐, рморнБрм╣рмБ
ЁЯШЙ => ЁЯШЙ, рмЖрмЦрм┐рморм╛рм░рм┐рммрм╛ рморнБрм╣рмБ, рмЖрмЦрм┐рморм╛рм░рм┐рммрм╛, рморнБрм╣рмБ
ЁЯШК => ЁЯШК, рм╣рм╕, рм╣рм╕ рм╣рм╕рм┐рмЖ рмЖрмЦрм┐, рм╣рм╕ рморнБрм╣рмБ рмПрммрмВ рмЖрмЦрм┐, рм╣рм╕ рморнБрм╣рмБ, рм╣рм╕рм╣рм╕рм┐рмЖ рмЖрмЦрм┐, рморнБрм╣рмБ
ЁЯШЛ => ЁЯШЛ, рморнБрм╣рмБрм░рнЗ рмкрм╛рмгрм┐ рмЖрм╕рм┐рммрм╛, рмкрм╛рмгрм┐ рмЖрм╕рм┐рммрм╛, рмЙрморнН рмЙрморнН рмнрм▓, рм╣рм╕ рморнБрм╣рмБ, рм╕рнНрм╡рм╛рмжрм┐рм╖рнНрмЯ рмЦрм╛рмжрнНрнЯ, рморнБрм╣рмБ
ЁЯШО => ЁЯШО, рммрм┐рмирмжрм╛рм╕рнН, рмЕрмдрм┐ рммрм┐рмирмжрм╛рм╕рнН, рммрм┐рмирмжрм╛рм╕рнН рморнБрм╣рмБ, рмЪрм╖рморм╛ рм╕рм╣рм┐рмд рм╣рм╕, рм╣рм╕рм╣рм╕рм┐рмЖ, рмЪрм╖рморм╛, рморнБрм╣рмБ
ЁЯШН => ЁЯШН, рм╣рм╕рм╣рм╕рм┐рмЖ рморнБрм╣рмБ, рм╣рм╛рм░рнНрмЯрнН рмпрнБрмХрнНрмд рмЖрмЦрм┐, рмкрнНрм░рнЗрмо, рм╕рнНрмирнЗрм╣рмкрнВрм░рнНрмгрнНрмг, рм╣рм╛рм░рнНрмЯрнН, рмЖрмЦрм┐, рморнБрм╣рмБ
ЁЯШШ => ЁЯШШ, рмЪрнБрморм╛ рмжрнЗрммрм╛, рморнБрм╣рмБрмХрнБ рмЪрнБрморм╛ рмжрнЗрммрм╛, рморнБрм╣рмБ
ЁЯШЧ => ЁЯШЧ, рмЪрм┐рморм╛ рмжрнЗрммрм╛ рморнБрм╣рмБ, рмЪрнБрморм╛, рморнБрм╣рмБ
ЁЯШЩ => ЁЯШЩ, рмЪрнБрморм╛ рмПрммрмВ рм╣рм╕, рм╣рм╕ рм╕рм╣рм┐рмд рмЪрнБрморм╛рмжрнЗрммрм╛ рморнБрм╣рмБ, рморнБрм╣рмБ, рм╣рм╕, рм╣рм╕рм╣рм╕рм┐рмЖ рмЖрмЦрм┐
ЁЯШЪ => ЁЯШЪ, рмЪрнБрморм╛ рмжрнЗрммрм╛, рмЖрмЦрм┐ рммрмирнНрмж рмХрм░рм┐ рмЪрнБрморм╛ рмжрнЗрммрм╛, рмЖрмЦрм┐ рммрмирнНрмж, рморнБрм╣рмБ
тШ║ => тШ║, рм╣рм╕рм╣рм╕рм┐рмЖ рморнБрм╣рмБ, рм╣рм╕рм╣рм╕рм┐рмЖ, рмЕрмг рм╣рм╕рм╣рм╕рм┐рмЖ рморнБрм╣рмБ, рморнБрм╣рмБ
ЁЯШЗ => ЁЯШЗ, рмПрмХ рм╣рм╛рм▓рнЛ рм╕рм╣рм┐рмд рм╣рм╕, рм╣рм╕, рм╣рм╛рм▓рнЛ, рморнБрм╣рмБ
ЁЯШР => ЁЯШР, рмнрм╛рммрм╢рнВрмирнНрнЯ рморнБрм╣рмБ, рмкрнНрм░рм╛рмХрнГрмдрм┐рмХ рморнБрм╣рмБ, рмнрм╛рммрм╢рнВрмирнНрнЯ, рмкрнНрм░рм╛рмХрнГрмдрм┐рмХ, рморнБрм╣рмБ, рмХрнМрмгрм╕рм┐ рмормирнНрмдрммрнНрнЯ рмирм╛рм╣рм┐рмБ
ЁЯШС => ЁЯШС, рмнрм╛рммрм╢рнВрмирнНрнЯ, рмнрм╛рммрм╢рнВрмирнНрнЯ рморнБрм╣рмБ, рморнБрм╣рмБ, рмХрнМрмгрм╕рм┐ рмормирнНрмдрммрнНрнЯ рмирм╛рм╣рм┐рмБ
ЁЯШ╢ => ЁЯШ╢, рмкрм╛рмЯрм┐ рмирмерм┐рммрм╛ рморнБрм╣рмБ, рмкрм╛рмЯрм┐ рмирм╛рм╣рм┐рмБ, рморнБрм╣рмБ
ЁЯШП => ЁЯШП, рмирм┐рм░рнНрммрнЛрмз рмнрм╛рммрм░рнЗ рм╣рм╕рм┐рммрм╛, рмирм┐рм░рнНрммрнЛрмз рморнБрм╣рмБ. рмирм┐рм░рнНрммрнЛрмзрмнрм╛рмм, рморнБрм╣рмБ
ЁЯШг => ЁЯШг, рм╢рмХрнНрмд рморнБрм╣рмБ, рм╢рмХрнНрмд рмХрм░рм┐рммрм╛, рморнБрм╣рмБ
ЁЯШе => ЁЯШе, рн▒рнЗрн▒!, рмжрнБрмГрмЦрм┐ рмХрм┐рмирнНрмдрнБ рмЖрм░рм╛рмо рморм┐рм│рм┐рм▓рм╛, рмЖрм░рм╛рмо рморм┐рм│рм┐рм▓рм╛, рмжрнБрмГрмЦрм┐, рморнБрм╣рмБ
ЁЯШо => ЁЯШо, рмЦрнЛрм▓рм╛ рмкрм╛рмЯрм┐ рморнБрм╣рмБ, рмЦрнЛрм▓рм╛ рмкрм╛рмЯрм┐, рмкрм╛рмЯрм┐, рморнБрм╣рмБ
ЁЯШп => ЁЯШп, рмирм┐рм╕рнНрмдрммрнНрмз рморнБрм╣рмБ, рмЪрмХрм┐рмд рм╣рнЗрммрм╛, рмЖрм╢рнНрмЪрм░рнНрмпрнНрнЯ рм╣рнЗрммрм╛, рморнБрм╣рмБ
ЁЯШк => ЁЯШк, рмирм┐рмжрнБрмЖ, рмирм┐рмжрнБрмЖ рморнБрм╣рмБ, рморнБрм╣рмБ
ЁЯШл => ЁЯШл, рм╣рм╛рм▓рм┐рмЖ рм╣рнЛрмЗрмерм┐рммрм╛, рм╣рм╛рм▓рм┐рмЖ рм╣рнЛрмЗрмерм┐рммрм╛ рморнБрм╣рмБ, рморнБрм╣рмБ
ЁЯШ┤ => ЁЯШ┤, рм╢рнЛрмЗрммрм╛, рм╢рнЛрмЗрммрм╛ рморнБрм╣рмБ, рморнБрм╣рмБ
ЁЯШМ => ЁЯШМ, рмЪрнБрмирнНрмдрм╛рморнБрмХрнНрмд рморнБрм╣рмБ, рмЪрм┐рмирнНрмдрм╛рморнБрмХрнНрмд, рморнБрм╣рмБ
ЁЯШЫ => ЁЯШЫ, рмЬрм┐рмн рммрм╛рм╣рм╛рм░ рмХрм░рм┐рммрм╛, рмЬрм┐рмн рммрм╛рм╣рм╛рм░ рмХрм░рм┐ рм░рмЦрм┐рммрм╛, рмЬрм┐рмн рммрм╛рм╣рм╛рм░ рмХрм░рм┐рмерм┐рммрм╛ рморнБрм╣рмБ, рморнБрм╣рмБ
ЁЯШЬ => ЁЯШЬ, рмЬрм┐рмн рммрм╛рм╣рм╛рм░ рмХрм░рм┐рммрм╛, рмХрнЗрммрм│ рм╣рмЗрм░рм╛рмг рмХрм░рм┐рммрм╛, рмЖрмЦрм┐ рморм╛рм░рм┐рммрм╛ рм╕рм╣рм┐рмд рмЬрм┐рмн рммрм╛рм╣рм╛рм░рмХрнБ рмХрм░рм┐рммрм╛, рмЖрмЦрм┐рморм╛рм░рм┐рммрм╛, рмХрнМрмдрнБрмХ, рморнБрм╣рмБ
ЁЯШЭ => ЁЯШЭ, рмШрнГрмгрм╛рм╕рнВрмЪрмХ, рмЖрмЦрм┐ рммрмирнНрмж рмХрм░рм┐ рмЬрм┐рмн рммрм╛рм╣рм╛рм░рмХрнБ рмХрм░рм┐рммрм╛, рмнрнЯрмЩрнНрмХрм░, рмЬрм┐рмн рммрм╛рм╣рм╛рм░рмХрнБ рмХрм░рм┐рммрм╛, рммрмирнНрмж рм╣рнЛрмЗрмерм┐рммрм╛ рмЖрмЦрм┐, рморнБрм╣рмБ
ЁЯШТ => ЁЯШТ, рмЕрмкрнНрм░рм╢рнНрми, рмЕрмкрнНрм░рм╢рнНрми рморнБрм╣рмБ, рмЦрнБрм╕рм┐рмирмерм┐рммрм╛, рморнБрм╣рмБ
ЁЯШУ => ЁЯШУ, рмермгрнНрмбрм╛ рмЭрм╛рм│, рмермгрнНрмбрм╛ рмЭрм╛рм│ рм╕рм╣рм┐рмд рморнБрм╣рмБ, рморнБрм╣рмБ
ЁЯШФ => ЁЯШФ, рмЪрм┐рмирнНрмдрм┐рмд рморнБрм╣рмБ, рмЙрмжрм╛рм╕, рмЪрм┐рмирнНрмдрм┐рмд, рморнБрм╣рмБ
ЁЯШХ => ЁЯШХ, рмжрнНрм╡рмирнНрмжрмХрм░ рморнБрм╣рмБ, рмжрнНрм╡рмирнНрмжрмХрм░, рморнБрм╣рмБ
ЁЯШЦ => ЁЯШЦ, рммрм┐рм░рмХрнНрмдрм┐рм╕рнВрмЪрмХ рморнБрм╣рмБ, рммрм┐рм░рмХрнНрмдрм┐рм╕рнВрмЪрмХ, рморнБрм╣рмБ
ЁЯШ╖ => ЁЯШ╖, рморнБрмЦрм╛ рм╕рм╣ рморнБрм╣рмБ, рмермгрнНрмбрм╛, рмкрм╛рмгрм┐рмкрм╛рмЧрм░рнЗ, рмбрм╛рмХрнНрмдрм░рнА рморнБрмЦрм╛, рморнБрмЦрм╛, рморнБрм╣рмБ
ЁЯШ▓ => ЁЯШ▓, рмЪрмХрм┐рмд рморнБрм╣рмБ, рмЪрмХрм┐рмд, рм╕рморнНрмкрнБрм░рнНрмгрнНрмг рмЪрмХрм┐рмд, рмЪрмХрм┐рмд рм╣рнЗрммрм╛, рморнБрм╣рмБ
ЁЯШЮ => ЁЯШЮ, рм╣рмдрм╛рм╕, рм╣рмдрм╛рм╕ рм╣рнЗрммрм╛, рм╣рмдрм╛рм╕ рм╣рнЛрмЗрмерм┐рммрм╛ рморнБрм╣рмБ, рморнБрм╣рмБ
ЁЯШЯ => ЁЯШЯ, рммрнНрнЯрм╕рнНрмд рм╣рнЗрммрм╛, рммрнНрнЯрм╕рнНрмд рморнБрм╣рмБ, рморнБрм╣рмБ
ЁЯШд => ЁЯШд, рммрм┐рмЬрнЯрнАрмнрм╛рмм, рморнБрмБ рмПрм╣рм╛ рмЬрм┐рмдрм┐рмерм┐рммрм╛ рморнБрм╣рмБ, рморнБрмБ рмЬрм┐рмдрм┐рмЫрм┐, рммрм┐рмЬрнЯрнА, рморнБрм╣рмБ
ЁЯШв => ЁЯШв, рмХрм╛рмирнНрмжрм┐рммрм╛, рмХрм╛рмирнНрмжрм┐рммрм╛ рморнБрм╣рмБ, рмжрнБрмГрмЦ, рм▓рнБрм╣, рморнБрм╣рмБ
ЁЯШн => ЁЯШн, рмЬрнЛрм░рнНтАМрм░рнЗ рмХрм╛рмирнНрмжрм┐рммрм╛, рм▓рнБрм╣, рмХрм╛рмирнНрмжрм┐рммрм╛, рмХрм╛рмирнНрмж, рморнБрм╣рмБ
ЁЯШж => ЁЯШж, рмХрнНрм░рнЛрмзрм┐рмд рморнБрм╣рмБ, рмЦрнЛрм▓рм╛ рмкрм╛рмЯрм┐ рм╕рм╣рм┐рмд рмХрнНрм░рнЛрмз, рмХрнНрм░рнЛрмз, рмЦрнЛрм▓рм╛ рмкрм╛рмЯрм┐, рморнБрм╣рмБ
ЁЯШз => ЁЯШз, рмжрнБрмГрмЦрнА, рмжрнБрмГрмЦрнА рморнБрм╣рмБ, рмнрнЛрмЧрм┐рммрм╛, рморнБрм╣рмБ
ЁЯШи => ЁЯШи, рмнрнЯрмнрнАрмд, рмбрм░рм┐рммрм╛, рмбрм░рм┐рммрм╛ рморнБрм╣рмБ, рморнБрм╣рмБ
ЁЯШй => ЁЯШй, рм╣рм╛рм▓рм┐рмЖ рм╣рнЛрмЗрмерм┐рммрм╛, рм╣рм╛рм▓рм┐рмЖ, рм╣рм╛рм▓рм┐рмЖ рм╣рнЛрмЗрмерм┐рммрм╛ рморнБрм╣рмБ, рморнБрм╣рмБ
ЁЯШм => ЁЯШм, рмЦрмдрнЗрмЗрм╣рнЗрммрм╛, рмЦрмдрнЗрмЗрм╣рнЗрммрм╛ рморнБрм╣рмБ, рморнБрм╣рмБ
ЁЯШ░ => ЁЯШ░, рммрнНрнЯрмЧрнНрм░ рморнБрм╣рмБ, рмермгрнНрмбрм╛ рмЭрм╛рм│ рм╕рм╣рм┐рмд рмирнАрм│ рморнБрм╣рмБ, рмкрм╛рмЯрм┐ рмЦрнЛрм▓рм╛, рмермгрнНрмбрм╛ рмЭрм╛рм│, рморнБрм╣рмБ
ЁЯШ▒ => ЁЯШ▒, рмнрнЯрмнрнАрмд рморнБрм╣рмБ, рмнрнЯрм░рнЗ рмбрм░рм┐рммрм╛, рмнрнЯрм░рнЗ рмнрнЯрмнрнАрмд рморнБрм╣рмБ рмХрм░рм┐рммрм╛, рмнрнЯ, рмнрнЯрмнрнАрмд, рмбрм░рм┐рммрм╛, рморнБрм╣рмБ
ЁЯШ│ => ЁЯШ│, рмЙрмдрнНрмдрнЗрмЬрм┐рмд рм╣рнЗрммрм╛, рмЙрмдрнНрмдрнЗрмЬрм┐рмд рморнБрм╣рмБ, рмирм┐рмжрм░рнЗ, рмирм┐рмжрнБрмЖ, рморнБрм╣рмБ
ЁЯШ╡ => ЁЯШ╡, рмШрнВрм░рнНрмгрнНрмгрм┐рмд, рмШрнВрм░рнНрмгрнНрмгрм┐рмд рморнБрм╣рмБ, рморнБрм╣рмБ
ЁЯШб => ЁЯШб, рморнБрм╣рмБ рмлрнБрм▓рм╛рмЗрммрм╛, рм░рм╛рмЧ, рмкрм╛рмЧрм│, рм▓рм╛рм▓рнН рморнБрм╣рмБ рмлрнБрм▓рм╛рмЗрммрм╛ рморнБрм╣рмБ, рм▓рм╛рм▓рнН рморнБрм╣рмБ, рморнБрм╣рмБ
ЁЯШа => ЁЯШа, рм░рм╛рмЧрм┐, рмкрм╛рмЧрм│, рм░рм╛рмЧрм┐ рморнБрм╣рмБ, рморнБрм╣рмБ
ЁЯШИ => ЁЯШИ, рм╣рм░рнНрми рм╕рм╣рм┐рмд рм╣рм╕, рм╣рм╕, рм╣рм░рнНрмирнН, рморнБрм╣рмБ
ЁЯС┐ => ЁЯС┐, рмжрнБрм╖рнНрмЯ рм╢рм┐рм╢рнБ, рмЫрнЛрмЯ рм╕рмЗрмдрм╛рми, рм╕рмЗрмдрм╛рми, рморнБрм╣рмБ
ЁЯС╣ => ЁЯС╣, рмормгрм┐рм╖рмЦрм┐рмЖ рм░рм╛рмХрнНрм╖рм╕, рмЕрм╕рнБрм░, рмжрм╛рмирмм, рмкрм░рнА рмХрм╛рм╣рм╛рмгрнА, рмЬрм╛рмкрм╛рмирнА рмормгрм┐рм╖рмЦрм┐рмЖ рм░рм╛рмХрнНрм╖, рморнБрм╣рмБ
ЁЯС║ => ЁЯС║, рмЦрм░рнНрммрмХрм╛рнЯ рмЕрм╕рнБрм░, рм░рм╛рмХрнНрм╖рм╕, рмЯрнЗрмЩрнНрмЧрнБ, рмкрм░рнА рмХрм╛рм╣рм╛рмгрнА, рмЬрм╛рмкрм╛рмирнА рмЦрм░рнНрммрмХрм╛рнЯ рмЕрм╕рнБрм░, рморнБрм╣рмБ
ЁЯТА => ЁЯТА, рмЦрмкрнБрм░рм┐, рмкрм░рнА рмХрм╛рм╣рм╛рмгрнА, рм╢рм░рнАрм░, рморнБрм╣рмБ
ЁЯС╗ => ЁЯС╗, рмнрнБрмд, рмкрм░рнА рмХрм╛рм╣рм╛рмгрнА, рморнБрм╣рмБ
ЁЯС╜ => ЁЯС╜, рмЖрм▓рм┐рмПрмирнНтАМ, рмЕрм▓рнМрмХрм┐рмХ, UFO, рмкрм░рнА рмХрм╛рм╣рм╛рмгрнА, рморнБрм╣рмБ
ЁЯС╛ => ЁЯС╛, рмЖрм▓рм┐рмПрмирнНтАМ рм░рм╛рмХрнНрм╖рм╕, рм░рм╛рмХрнНрм╖рм╕, UFO, рмкрм░рнА рмХрм╛рм╣рм╛рмгрнА, рморнБрм╣рмБ
ЁЯТй => ЁЯТй, рмкрнЛрмкрнН, рмкрнЛрм░ рмкрм┐рмЖрм▓рнН, рмкрнЛ, рмбрмЩрнНрмЧ, рмкрм╛рмЗрм▓рнН
ЁЯШ║ => ЁЯШ║, рм╣рм╕рм╣рм╕рм┐рмЖ рммрм┐рм░рм╛рмбрм┐ рморнБрм╣рмБ, рмЦрнЛрм▓рм╛ рмкрм╛рмЯрм┐ рм╕рм╣рм┐рмд рм╣рм╕рм╣рм╕рм┐рмЖ рммрм┐рм░рм╛рмбрм┐ рморнБрм╣рмБ, рммрм┐рм░рм╛рмбрм┐ рморнБрм╣рмБ, рмЦрнЛрм▓рм╛ рмкрм╛рмЯрм┐, рмЦрнЛрм▓рм╛. рмкрм╛рмЯрм┐, рммрм┐рм░рм╛рмбрм┐, рморнБрм╣рмБ
ЁЯШ╕ => ЁЯШ╕, рм╣рм╕рм╣рм╕рм┐рмЖ рммрм┐рм░рм╛рмбрм┐ рморнБрм╣рмБ, рм╣рм╕рм╣рм╕рм┐рмЖ, рм╣рм╕ рм╕рм╣рм┐рмд рммрм┐рм░рм╛рмбрм┐ рморнБрм╣рмБ рмПрммрмВ рм╣рм╕рм╣рм╕рм┐рмЖ рмЖрмЦрм┐, рммрм┐рм░рм╛рмбрм┐ рморнБрм╣рмБ, рммрм┐рм░рм╛рмбрм┐, рморнБрм╣рмБ
ЁЯШ╣ => ЁЯШ╣, рмЦрнБрм╕рнАрм░ рм▓рнБрм╣, рммрм┐рм░рм╛рмбрм┐ рморнБрм╣рмБ, рмЦрнБрм╕рнАрм░ рм▓рнБрм╣ рм╕рм╣рм┐рмд рммрм┐рм░рм╛рмбрм┐ рморнБрм╣рмБ, рммрм┐рм░рм╛рмбрм┐, рморнБрм╣рмБ
ЁЯШ╗ => ЁЯШ╗, рм╣рм╕рм╣рм╕рм┐рмЖ рммрм┐рм░рм╛рмбрм┐ рморнБрм╣рмБ, рм╣рнГрмжрнЯ-рмЖрмХрнГрмдрм┐ рмЖрмЦрм┐ рм╕рм╣рм┐рмд рм╣рм╕рм╣рм╕рм┐рмЖ рммрм┐рм░рм╛рмбрм┐, рмкрнНрм░рнЗрморм░рнЗ, рмкрнНрм░рнЗрмо, рм╣рнГрмжрнЯ, рмЖрмЦрм┐, рммрм┐рм░рм╛рмбрм┐ рморнБрм╣рмБ, рммрм┐рм░рм╛рмбрм┐, рморнБрм╣рмБ
ЁЯШ╝ => ЁЯШ╝, рммрм┐рмХрнГрмд рммрм┐рм░рм╛рмбрм┐ рморнБрм╣рмБ, рммрм┐рмХрнГрмд, рммрм┐рмХрнГрмд рм╣рм╕, рммрм┐рм░рм╛рмбрм┐ рморнБрм╣рмБ, рммрм┐рм░рм╛рмбрм┐, рморнБрм╣рмБ
ЁЯШ╜ => ЁЯШ╜, рмЪрнБрморм╛рмжрнЗрмЙрмерм┐рммрм╛ рммрм┐рм░рм╛рмбрм┐, рмЖрмЦрм┐ рммрмирнНрмж рм╣рнЛрмЗрмЫрм┐, рмЪрнБрморм╛рмжрнЗрммрм╛, рмЪрнБрморм╛, рмЖрмЦрм┐, рммрмирнНрмж рм╣рнЛрмЗрмЫрм┐, рммрм┐рм░рм╛рмбрм┐, рморнБрм╣рмБ
ЁЯЩА => ЁЯЩА, рмермХрм┐рмпрм╛рмЗрмерм┐рммрм╛ рммрм┐рм░рм╛рмбрм┐ рморнБрм╣рмБ, рм╣рнЗ рмнрмЧрммрм╛рми, рмкрнНрм░рмХрнГрмдрм░рнЗ рмЖрм╢рнНрмЪрм░рнНрмпрнНрнЯ рм╣рнЛрмЗрмерм┐рммрм╛, рммрм┐рм░рм╛рмбрм┐, рморнБрм╣рмБ
ЁЯШ┐ => ЁЯШ┐, рмХрм╛рмирнНрмжрнБрмерм┐рммрм╛ рммрм┐рм░рм╛рмбрм┐ рморнБрм╣рмБ, рмХрм╛рмирнНрмжрм┐рммрм╛, рмХрм╛рмирнНрмжрм┐рммрм╛ рморнБрм╣рмБ, рммрм┐рм░рм╛рмбрм┐, рморнБрм╣рмБ
ЁЯШ╛ => ЁЯШ╛, рморнБрм╣рмБ рмлрнБрм▓рм╛рмЗрмерм┐рммрм╛ рммрм┐рм░рм╛рмбрм┐ рморнБрм╣рмБ, рморнБрм╣рмБ рмлрнБрм▓рм╛рмЗрммрм╛, рммрм┐рм░рм╛рмжрм┐ рморнБрм╣рмБ, рммрм┐рм░рм╛рмбрм┐, рморнБрм╣рмБ
ЁЯЩИ => ЁЯЩИ, рмЦрм░рм╛рмк рмирмжрнЗрмЦрм┐рммрм╛, рмЦрм░рм╛рмк рмирмжрнЗрмЦрнБрмерм┐рммрм╛ рморм╛рмЩрнНрмХрмб, рморм╛рмЩрнНрмХрмб
ЁЯЩЙ => ЁЯЩЙ, рмЦрм░рм╛рмк рмирм╢рнБрмгрм┐рммрм╛, рмЦрм░рм╛рмк рмирм╢рнБрмгрнБрмерм┐рммрм╛ рморм╛рмЩрнНрмХрмб, рморм╛рмЩрнНрмХрмб
ЁЯЩК => ЁЯЩК, рмЦрм░рм╛рмк рмирмХрм╣рм┐рммрм╛, рмЦрм░рм╛рмк рмирмХрм╣рнБрмерм┐рммрм╛ рморм╛рмЩрнНрмХрмб, рморм╛рмЩрнНрмХрмб
ЁЯСж => ЁЯСж, рмкрнБрмЕ рмкрм┐рм▓рм╛, рм▓рнЛрмХрморм╛рмирнЗ
ЁЯСз => ЁЯСз, рмЭрм┐рмЕ рмкрм┐рм▓рм╛, рм▓рнЛрмХрморм╛рмирнЗ
ЁЯСи => ЁЯСи, рмкрнБрм░рнБрм╖, рм▓рнЛрмХрморм╛рмирнЗ
ЁЯСй => ЁЯСй, рморм╣рм┐рм│рм╛, рм▓рнЛрмХрморм╛рмирнЗ
ЁЯС┤ => ЁЯС┤, рммрнГрмжрнНрмз рммрнНрнЯрмХрнНрмдрм┐, рмкрнБрм░рнБрм╖, рммрнГрмжрнНрмз, рм▓рнЛрмХрморм╛рмирнЗ
ЁЯС╡ => ЁЯС╡, рммрнГрмжрнНрмз рморм╣рм┐рм│рм╛, рморм╣рм┐рм│рм╛, рммрнГрмжрнНрмз, рм▓рнЛрмХрморм╛рмирнЗ
ЁЯС╢ => ЁЯС╢, рмЫрнЛрмЯ рмкрм┐рм▓рм╛, рм▓рнЛрмХрморм╛рмирнЗ
ЁЯС▒ => ЁЯС▒, рм╕рнБрмирнЗрм▓рм┐ рм░рмЩрнНрмЧрм░ рмХрнЗрм╢ рмерм┐рммрм╛ рммрнНрнЯрмХрнНрмдрм┐, рм╕рнБрмирнЗрм▓рм┐ рммрм░рнНрмгрнНрмг, рм▓рнЛрмХрморм╛рмирнЗ
ЁЯСо => ЁЯСо, рмкрнЛрм▓рм┐рм╕рнНтАМ рмЕрмзрм┐рмХрм╛рм░рнА, рмкрнЛрм▓рм┐рм╕рнН, рмЕрмзрм┐рмХрм╛рм░рнА, рм▓рнЛрмХрморм╛рмирнЗ
ЁЯС▓ => ЁЯС▓, рмкрнБрм░рнБрм╖, рмЧрнБрмЖ рмкрм┐ рморм╛рмУ рм╕рм╣рм┐рмд рмкрнБрм░рнБрм╖, рмЧрнБрмЖ рмкрм┐ рморм╛рмУ, рм▓рнЛрмХрморм╛рмирнЗ
ЁЯС│ => ЁЯС│, рмкрнБрм░рнБрм╖, рмПрмХ рмкрмЧрмбрм┐ рмкрм┐рмирнНрмзрм┐рмерм┐рммрм╛ рмкрнБрм░рнБрм╖, рмкрмЧрмбрм┐, рм▓рнЛрмХрморм╛рмирнЗ
ЁЯС╖ => ЁЯС╖, рмирм┐рм░рнНрморм╛рмг рм╢рнНрм░рморм┐рмХ, рмирм┐рм░рнНрморм╛рмг, рм╢рнНрм░рморм┐рмХ, рм▓рнЛрмХрморм╛рмирнЗ
ЁЯС╕ => ЁЯС╕, рм░рм╛рмЬрмХрнБрморм╛рм░рнА, рмкрм░рнА рмХрм╛рм╣рм╛рмгрнА, рм▓рнЛрмХрморм╛рмирнЗ
ЁЯТВ => ЁЯТВ, рм╕рнБрм░рмХрнНрм╖рм╛рмХрм░рнНрморнА, рмЧрм╛рм░рнНрмб, рм▓рнЛрмХрморм╛рмирнЗ
ЁЯОЕ => ЁЯОЕ, рм╕рм╛рмгрнНрмЯрм╛, рм╕рм╛рмгрнНрмЯрм╛рмХрнНрм▓рм╕рнНтАМ, рм╕рм╛рмгрнНрмЯрм╛рмХрнНрм▓рм╕рнН, рмЦрнНрм░рнАрм╖рнНрмЯрморм╛рм╕, рмЙрмдрнНрм╕рмм
ЁЯС╝ => ЁЯС╝, рм╢рм┐рм╢рнБ рмжрнЗрммрмжрнВрмд, рмжрнЗрммрмжрнВрмд, рмкрм░рнА рмХрм╛рм╣рм╛рмгрнА, рморнБрм╣рмБ
ЁЯТЖ => ЁЯТЖ, рморнБрм╣рмБрм░ рморнНрнЯрм╛рм╕рнЗрмЬрнНтАМ, рморнНрнЯрм╛рм╕рнЗрмЬрнНтАМ, рм╕рнЗрм▓рнБрми
ЁЯТЗ => ЁЯТЗ, рмХрнЗрм╢ рмХрм╛рмЯрм┐рммрм╛, рммрм┐рнЯрнБрмЯрм┐ рмкрм╛рм░рнНрм▓рм░рнНтАМ, рм╕рнМрмирнНрмжрм░рнНрмпрнНрнЯ, рмкрм╛рм░рнНрм▓рм░рнНтАМ
ЁЯС░ => ЁЯС░, рммрмзрнВ, рмПрмХ рмУрмврмгрм┐ рмерм┐рммрм╛ рммрмзрнВ, рмУрмврмгрм┐, рммрм┐рммрм╛рм╣, рм▓рнЛрмХрморм╛рмирнЗ
ЁЯЩН => ЁЯЩН, рмХрнНрм░рнЛрмзрм┐рмд, рмХрнНрм░рнЛрмзрм┐рмд рммрнНрнЯрмХрнНрмдрм┐, рммрнНрнЯрмХрнНрмдрм┐, рмЗрмЩрнНрмЧрм┐рмд
ЁЯЩО => ЁЯЩО, рморнБрм╣рмБ рмлрнБрм▓рм╛рмЗрммрм╛, рморнБрм╣рмБ рмлрнБрм▓рм╛рмЗрмерм┐рммрм╛ рммрнНрнЯрмХрнНрмдрм┐, рммрнНрнЯрмХрнНрмдрм┐, рмЗрмЩрнНрмЧрм┐рмд
ЁЯЩЕ => ЁЯЩЕ, рмнрм▓ рмЗрмЩрнНрмЧрм┐рмд рмирм╛рм╣рм┐рмБ, рмнрм▓ рмирм╛рм╣рм┐рмБ, рмирм╛, рмкрнНрм░рмдрм┐рммрмирнНрмзрм┐рмд, рмЗрмЩрнНрмЧрм┐рмд, рморнБрм╣рмБ
ЁЯЩЖ => ЁЯЩЖ, рмУрмХрнЗ рмЗрмЩрнНрмЧрм┐рмд, рм╕рммрнБ рмарм┐рмХрнН рмЕрмЫрм┐, рмЗрмЩрнНрмЧрм┐рмд, рморнБрм╣рмБ
ЁЯТБ => ЁЯТБ, рм╕рнВрмЪрмирм╛ рмбрнЗрм╕рнНрмХ, рм╕рм╣рм╛рнЯрмдрм╛, рм╕рнВрмЪрмирм╛, рм▓рнЛрмХрморм╛рмирнЗ
ЁЯЩЛ => ЁЯЩЛ, рмЦрнБрм╕рнАрмерм┐рммрм╛ рммрнНрнЯрмХрнНрмдрм┐, рм╣рм╛рмд рмЙрмкрм░рмХрнБ рмЙрмарм╛рмЗрммрм╛, рмЙрмкрм░рмХрнБ рм╣рм╛рмд рмЙрмарм╛рмЗрмерм┐рммрм╛ рммрнНрнЯрмХрнНрмдрм┐, рмЦрнБрм╕рнА, рммрнНрнЯрмХрнНрмдрм┐, рмЗрмЩрнНрмЧрм┐рмд
ЁЯЩЗ => ЁЯЩЗ, рморнБрмБ рмжрнБрмГрмЦрм┐рмд рмЕрмЯрнЗ, рмЕрмдрм┐ рморнБрмгрнНрмб рмирнБрмЖрмБрмЗрммрм╛, рмжрнБрмГрмЦрм┐рмд, рморнБрмгрнНрмб рмирнБрмЖрмБрмЗрммрм╛, рмЗрмЩрнНрмЧрм┐рмд, рммрнНрнЯрмХрнНрмдрм┐
ЁЯЩМ => ЁЯЩМ, рм╣рнБрм░рнЗ, рмЦрнБрм╕рнАрм░рнЗ рмЙрмнрнЯ рм╣рм╛рмд рмЙрмкрм░рмХрнБ рмЙрмарм╛рмЗрммрм╛, рмЙрмнрнЯ рм╣рм╛рмд, рмЦрнБрм╕рнА
ЁЯЩП => ЁЯЩП, рм╣рм╛рмд рмпрнЛрмбрм┐рммрм╛, рмкрнНрм░рм╛рм░рнНрмермирм╛, рмкрнНрм░рм╛рм░рнНрмермирм╛ рмХрм░рм┐рммрм╛, рм╣рм╛рмд, рмЗрмЩрнНрмЧрм┐рмд
ЁЯСд => ЁЯСд, рмЫрм╛рнЯрм╛рморнВрм░рнНрмдрнНрмдрм┐рм░рнЗ рморм╕рнНрмдрмХ рмарм╛рм░рнБ рммрмХрнНрм╖ рмкрм░рнНрмпрнНрнЯрмирнНрмд, рморм╕рнНрмдрмХ рмарм╛рм░рнБ рммрмХрнНрм╖ рмкрм░рнНрмпрнНрнЯрмирнНрмд рмЪрм┐рмдрнНрм░, рмЫрм╛рнЯрм╛рморнВрм░рнНрмдрнНрмдрм┐, рм▓рнЛрмХрморм╛рмирнЗ
ЁЯСе => ЁЯСе, рмЫрм╛рнЯрм╛рморнВрм░рнНрмдрнНрмдрм┐рм░рнЗ рморм╕рнНрмдрмХ рмарм╛рм░рнБ рммрмХрнНрм╖ рмкрм░рнНрмпрнНрнЯрмирнНрмд, рморм╕рнНрмдрмХ рмарм╛рм░рнБ рммрмХрнНрм╖ рмкрм░рнНрмпрнНрнЯрмирнНрмд рмЪрм┐рмдрнНрм░, рмЫрм╛рнЯрм╛рморнВрм░рнНрмдрнНрмдрм┐, рм▓рнЛрмХрморм╛рмирнЗ
ЁЯЪ╢ => ЁЯЪ╢, рмкрмерм┐рмХ, рмкрм╛рмжрмЪрм▓рм╛ рммрнНрнЯрмХрнНрмдрм┐
ЁЯПГ => ЁЯПГ, рмжрнМрмбрм╛рм│рм┐, рмжрнМрмб, рморм╛рм░рм╛рмерми, рмХрнНрм░рнАрмбрм╛
ЁЯСп => ЁЯСп, рмбрнЗрмЩрнНрмЧрм╛ рмЭрм┐рмЕ, рм▓рморнНрммрм╛ рмХрм╛рми, рмЭрм┐рмЕ рмкрм┐рм▓рм╛, рморм╣рм┐рм│рм╛, рм▓рнЛрмХрморм╛рмирнЗ
ЁЯТГ => ЁЯТГ, рмирм░рнНрмдрнНрмдрмХ/рмирм░рнНрмдрнНрмдрмХрнА, рмирнГрмдрнНрнЯ, рм▓рнЛрмХрморм╛рмирнЗ
ЁЯТП => ЁЯТП, рмЪрнБрморнНрммрми, рмЪрнБрморнНрммрми рмжрнЗрммрм╛, рм▓рнЛрмХрморм╛рмирнЗ, рмкрнНрм░рмгрнЯ
ЁЯТС => ЁЯТС, рмкрнНрм░рнЗрморнА рмпрнБрмЧрм│, рмПрмХ рм╣рнГрмжрнЯ рмЪрм┐рмдрнНрм░ рм╕рм╣рм┐рмд рмкрнНрм░рнЗрморнА рмпрнБрмЧрм│, рм╣рнГрмжрнЯ, рм▓рнЛрмХрморм╛рмирнЗ, рмкрнНрм░рмгрнЯ
ЁЯСк => ЁЯСк, рмкрм░рм┐рммрм╛рм░, рммрм╛рмкрм╛, рморм╛рмЖ, рмкрм┐рм▓рм╛, рм▓рнЛрмХрморм╛рмирнЗ
ЁЯСл => ЁЯСл, рмкрнБрм░рнБрм╖ рмУ рморм╣рм┐рм│рм╛, рмжрморнНрмкрмдрм┐, рм╣рм╛рмд рмзрм░рм╛ рмзрм░рм┐ рм╣рнЛрмЗрмерм┐рммрм╛ рмкрнБрм░рнБрм╖ рмУ рморм╣рм┐рм│рм╛, рмкрнБрм░рнБрм╖, рморм╣рм┐рм│рм╛, рм╣рм╛рмд рмзрм░рм┐рмерм┐рммрм╛, рм▓рнЛрмХрморм╛рмирнЗ
ЁЯСм => ЁЯСм, рмжрнБрмЗ рмЬрмг рмкрнБрм░рнБрм╖, рмжрморнНрмкрмдрм┐, рмжрнБрмЗ рмЬрмг рмкрнБрм░рнБрм╖ рм╣рм╛рмд рмзрм░рм╛рмзрм░рм┐ рм╣рнЛрмЗрмЫрмирнНрмдрм┐, рмкрнБрм░рнБрм╖, рм╣рм╛рмд рмзрм░рм╛рмзрм░рм┐ рм╣рнЗрммрм╛, рм▓рнЛрмХрморм╛рмирнЗ
ЁЯСн => ЁЯСн, рмжрнБрмЗ рмЬрмг рморм╣рм┐рм│рм╛, рмжрморнНрмкрмдрм┐, рмжрнБрмЗ рмЬрмг рморм╣рм┐рм│рм╛ рм╣рм╛рмд рмзрм░рм╛рмзрм░рм┐ рм╣рнЛрмЗрмЫрмирнНрмдрм┐, рморм╣рм┐рм│рм╛, рм╣рм╛рмд рмзрм░рм╛рмзрм░рм┐ рм╣рнЗрммрм╛, рм▓рнЛрмХрморм╛рмирнЗ
ЁЯТк => ЁЯТк, рммрм╛рмЗрм╕рнЗрмкрнН, рморм╛рмВрм╕рмкрнЗрм╕рнА рмлрнНрм▓рнЗрмХрнНрм╕, рморм╛рмВрм╕рмкрнЗрм╕рнА, рмжрнГрмв, рмлрнНрм▓рнЗрмХрнНрм╕, рмХрморм┐рмХрнН
ЁЯСИ => ЁЯСИ, рммрм╛рмо рмЖрмЩрнНрмЧрнБрмарм┐, рмЖрмЩрнНрмЧрнБрмарм┐ рмирм┐рм░рнНрмжрнНрмжрнЗрм╢ рммрм╛рмормХрнБ, рммрм┐рм╢рм┐ рмЖрмЩрнНрмЧрнБрмарм┐, рммрнНрнЯрм╛рмХрм╣рм╛рмгрнНрмб, рмЖрмЩрнНрмЧрнБрмарм┐
ЁЯСЙ => ЁЯСЙ, рмбрм╛рм╣рм╛рмг рмЖрмЩрнНрмЧрнБрмарм┐, рмЖрмЩрнНрмЧрнБрмарм┐ рмирм┐рм░рнНрмжрнНрмжрнЗрм╢ рмбрм╛рм╣рм╛рмгрмХрнБ, рммрм┐рм╢рм┐ рмЖрмЩрнНрмЧрнБрмарм┐, рммрнНрнЯрм╛рмХрм╣рм╛рмгрнНрмб, рмЖрмЩрнНрмЧрнБрмарм┐
ЁЯСЖ => ЁЯСЖ, рмЙрмкрм░рмХрнБ рмЧрнЛрмЯрм┐рмП рмЖрмЩрнНрмЧрнБрмарм┐ рмХрм░рм┐рммрм╛, рмЖрмЩрнНрмЧрнБрмарм┐ рмирм┐рм░рнНрмжрнНрмжрнЗрм╢ рмЙрмкрм░рмХрнБ, рммрм┐рм╢рм┐ рмЖрмЩрнНрмЧрнБрмарм┐, рммрнНрнЯрм╛рмХрм╣рм╛рмгрнНрмб, рмЖрмЩрнНрмЧрнБрмарм┐
ЁЯСЗ => ЁЯСЗ, рмдрм│рмХрнБ рмЧрнЛрмЯрм┐рмП рмЖрмЩрнНрмЧрнБрмарм┐ рмХрм░рм┐рммрм╛, рмЖрмЩрнНрмЧрнБрмарм┐ рмирм┐рм░рнНрмжрнНрмжрнЗрм╢ рмдрм│рмХрнБ, рммрм┐рм╢рм┐ рмЖрмЩрнНрмЧрнБрмарм┐, рммрнНрнЯрм╛рмХрм╣рм╛рмгрнНрмб, рмЖрмЩрнНрмЧрнБрмарм┐
тЬМ => тЬМ, рмХрмБрмЗрмЪрм┐, рмЬрм┐рмдрм┐рммрм╛ рм╣рм╛рмд, рмЬрм┐рмдрм┐рммрм╛, рм╣рмБ
тЬЛ => тЬЛ, рмХрм╛рмЧрмЬ, рмЙрмарм┐рмерм┐рммрм╛ рм╣рм╛рмд
ЁЯСМ => ЁЯСМ, OK рмЪрм┐рм╣рнНрми, OK рм╣рм╛рмд рмЪрм┐рм╣рнНрми, OK, рм╣рм╛рмд, рмЪрм┐рм╣рнНрми
ЁЯСН => ЁЯСН, рм╕рмлрм│ рм╣рнЗрммрм╛ рмЪрм┐рм╣рнНрми, рммрнБрмврм╛ рмЖрмЩрнНрмЧрнБрмарм┐, рмЙрмкрм░, рм╣рм╛рмд, рмЪрм┐рм╣рнНрми
ЁЯСО => ЁЯСО, рмЕрм╕рмлрм│рмдрм╛ рмЪрм┐рм╣рнНрми, рммрнБрмврм╛ рмЖрмЩрнНрмЧрнБрмарм┐, рмдрм│, рм╣рм╛рмд, рмЪрм┐рм╣рнНрми
тЬК => тЬК, рм░рмХрнН, рмкрнНрм░рмерморнЗ рмЙрмарм╛рмЗрммрм╛
ЁЯСК => ЁЯСК, рмЯрм╛рмг рморнБрмарм╛, рморнБрмарм╛, рм╣рм╛рмд
ЁЯСЛ => ЁЯСЛ, рм╣рм╛рмд рм╣рм▓рм╛рмЗрммрм╛, рм╣рм╛рмд, рм╣рм▓рм╛рмЗрммрм╛
ЁЯСП => ЁЯСП, рм╣рм╛рмдрм░рнЗ рмдрм╛рм│рм┐ рморм╛рм░рм┐рммрм╛, рм╣рм╛рмд, рмдрм╛рм│рм┐ рморм╛рм░рм┐рммрм╛, рмЪрм┐рм╣рнНрми
ЁЯСР => ЁЯСР, рмЦрнЛрм▓рм╛ рм╣рм╛рмд, рмЦрнЛрм▓рм╛ рм╣рм╛рмд рмЪрм┐рм╣рнНрми, рм╣рм╛рмд, рмЦрнЛрм▓рм┐рммрм╛, рмЪрм┐рм╣рнНрми
ЁЯТЕ => ЁЯТЕ, рмирмЦ рмпрмдрнНрми, рмирмЦ, рморм╛рмирм┐рмХрнНрнЯрнБрм░рнНтАМ, рмирмЦ рмкрм╛рм▓рм┐рм╕, рмкрнНрм░рм╕рм╛рмзрми рм╕рм╛рмормЧрнНрм░рнА
ЁЯСВ => ЁЯСВ, рмХрм╛рми, рм╢рм░рнАрм░
ЁЯСГ => ЁЯСГ, рмирм╛рмХ, рморнБрм╣рмБ, рм╢рм░рнАрм░
ЁЯСг => ЁЯСг, рмкрм╛рмжрмЪрм┐рм╣рнНрми, рмкрм╛рмж, рмЪрм┐рм╣рнНрми, рм╢рм░рнАрм░
ЁЯСА => ЁЯСА, рмЖрмЦрм┐, рморнБрм╣рмБ
ЁЯСЕ => ЁЯСЕ, рмЬрм┐рмн, рморнБрм╣рмБ, рм╢рм░рнАрм░
ЁЯСД => ЁЯСД, рмкрм╛рмЯрм┐, рмУрма, рморнБрм╣рмБ, рм╢рм░рнАрм░
ЁЯТЛ => ЁЯТЛ, рмЪрнБрморнНрммрми рмЪрм┐рм╣рнНрми, рмУрма, рмЪрнБрморнНрммрми, рмкрнНрм░рмгрнЯ
ЁЯТШ => ЁЯТШ, рм╣рнГрмжрнЯ рмПрммрмВ рмдрнАрм░, рм╣рнГрмжрнЯ, рмдрнАрм░, рмкрнНрм░рнЗрмо, рмнрм╛рммрмирм╛
ЁЯТУ => ЁЯТУ, рм╕рнНрмкрмирнНрмжрм┐рмд рм╣рнГрмжрнЯ, рм╕рнНрмкрмирнНрмжрми, рм╣рнГрмжрнЯ, рмкрнНрм░рнЗрмо, рмнрм╛рммрмирм╛
ЁЯТФ => ЁЯТФ, рм╣рнГрмжрнЯ рмнрм╛рмЩрнНрмЧрм┐рмпрм┐рммрм╛, рмнрмЧрнНрми рм╣рнГрмжрнЯ, рмнрм╛рмЩрнНрмЧрм┐рммрм╛, рм╣рнГрмжрнЯ, рмнрмЧрнНрми, рмнрм╛рммрмирм╛
ЁЯТХ => ЁЯТХ, рмжрнБрмЗрмЯрм┐ рм╣рнГрмжрнЯ, рмкрнНрм░рнЗрморнА, рмкрнНрм░рнЗрмо, рмнрм╛рммрмирм╛
ЁЯТЦ => ЁЯТЦ, рмЭрмЯрмХрнБрмерм┐рммрм╛ рм╣рнГрмжрнЯ, рм░рнЛрморм╛рмЮрнНрмЪрм┐рмд, рмЪрмормдрнНрмХрм╛рм░, рмкрнНрм░рнЗрмо, рмнрм╛рммрмирм╛
ЁЯТЧ => ЁЯТЧ, рммрм░рнНрмжрнНрмзрм┐рмд рм╣рнГрмжрнЯ, рм╢рмЩрнНрмХрм╛рмЧрнНрм░рм╕рнНрмд, рм░рнЛрморм╛рмЮрнНрмЪрм┐рмд, рм╣рнГрмжрнЯ, рмкрнНрм░рнЗрмо, рмнрм╛рммрмирм╛
ЁЯТЩ => ЁЯТЩ, рмирнАрм│ рм╣рнГрмжрнЯ, рмирнАрм│, рм╣рнГрмжрнЯ, рмнрм╛рммрмирм╛
ЁЯТЪ => ЁЯТЪ, рм╕рммрнБрмЬ рм╣рнГрмжрнЯ, рм╕рммрнБрмЬ, рм╣рнГрмжрнЯ, рмнрм╛рммрмирм╛
ЁЯТЫ => ЁЯТЫ, рм╣рм│рмжрм┐рмЖ рм╣рнГрмжрнЯ, рм╣рм│рмжрм┐рмЖ, рм╣рнГрмжрнЯ, рмнрм╛рммрмирм╛
ЁЯТЬ => ЁЯТЬ, рммрм╛рмЗрмЧрмгрнА рм╣рнГрмжрнЯ, рммрм╛рмЗрмЧрмгрнА, рм╣рнГрмжрнЯ, рмнрм╛рммрмирм╛
ЁЯТЭ => ЁЯТЭ, рм░рм┐рммрмирнНтАМ рмпрнБрмХрнНрмд рм╣рнГрмжрнЯ, рм╣рнГрмжрнЯ, рм░рм┐рммрмирнНтАМ, рмнрм╛рм▓рнЗрмгрнНрмЯрм╛рмЗрмирнНтАМ, рмнрм╛рммрмирм╛
ЁЯТЮ => ЁЯТЮ, рмШрнВрм░рнНрмгрнНрмгрнЯрморм╛рми рм╣рнГрмжрнЯ, рм╣рнГрмжрнЯ, рмШрнВрм░рнНрмгрнНрмгрнЯрморм╛рми, рмЕрмдрм┐ рм╕рнБрмирнНрмжрм░, рмХрммрм╛рм▓рм┐, рмкрнНрм░рнЗрмо, рмЖрмжрм░рмгрнАрнЯ, рмнрм╛рммрмирм╛
ЁЯТЯ => ЁЯТЯ, рм╣рнГрмжрнЯ рм╕рмЬрнНрмЬрм╛, рм╣рнГрмжрнЯ
ЁЯТМ => ЁЯТМ, рмкрнНрм░рнЗрмо рмкрмдрнНрм░, рмПрмХ рм╣рнГрмжрнЯ рмЪрм┐рмдрнНрм░ рмерм╛рмЗ рморнЗрм▓рнНтАМ, рмЪрм┐рмарм┐, рм╣рнГрмжрнЯ, рмкрнНрм░рмгрнЯ
ЁЯТд => ЁЯТд, рмирм┐рмжрнБрмЖ, Zzz, рм╢рнЛрмЗрммрм╛, рмШрнБрмЩрнНрмЧрнБрмбрм┐ рморм╛рм░рм┐рммрм╛, рмХрморм┐рмХрнН, рмнрм╛рммрмирм╛
ЁЯТв => ЁЯТв, рмХрнНрм░рнЛрмз, рмХрнНрм░рнЛрмз рмЪрм┐рм╣рнНрми, рмХрнНрм░рнЛрмзрнА, рм╣рм╛рм╕рнНрнЯрнЛрмжрнНрмжрнАрмкрмХ, рмнрм╛рммрмирм╛
ЁЯТг => ЁЯТг, рммрморнНтАМ, рм╣рм╛рм╕рнНрнЯрнЛрмжрнНрмжрнАрмкрмХ, рмнрм╛рммрмирм╛
ЁЯТе => ЁЯТе, рмзрмХрнНрмХрм╛, рмзрмХрнНрмХрм╛ рмЪрм┐рм╣рнНрми, рмХрморм┐рмХрнН, рмнрм╛рммрмирм╛
ЁЯТж => ЁЯТж, рмЭрм╛рм│ рмЯрнЛрмкрм╛, рмЭрм╛рм│, рмЭрм╛рм│ рммрнЛрм╣рм┐рммрм╛, рмХрморм┐рмХрнН, рмнрм╛рммрмирм╛
ЁЯТи => ЁЯТи, рмЦрнБрммрнН рмЬрнЛрм░рм░рнЗ рмжрнМрмбрм┐рммрм╛, рмжрнМрмбрм┐ рмкрм│рм╛рмЗрммрм╛, рмжрнМрмбрм┐рммрм╛, рмХрморм┐рмХрнН, рмнрм╛рммрмирм╛
ЁЯТл => ЁЯТл, рмЪрмкрм│, рмдрм╛рм░рм╛ рмжрнЗрмЦрм┐рммрм╛, рмдрм╛рм░рм╛, рмХрморм┐рмХрнН, рмнрм╛рммрмирм╛
ЁЯТм => ЁЯТм, рмХрм╣рм┐рммрм╛ рммрнЗрм▓рнБрмирнН, рмХрм╣рм┐рммрм╛ рммрммрм▓рнН, рм╕рмВрм│рм╛рмк рммрнЗрм▓рнБрмирнН, рммрнЗрм▓рнБрмирнН, рммрммрм▓рнН, рм╕рмВрм│рм╛рмк, рмХрморм┐рмХрнН
ЁЯТн => ЁЯТн, рмнрм╛рммрмирм╛ рммрнЗрм▓рнБрмирнН, рмнрм╛рммрмирм╛ рммрммрм▓рнН, рмнрм╛рммрмирм╛, рммрммрм▓рнН, рмХрморм┐рмХрнН
ЁЯСУ => ЁЯСУ, рмЖрмЗрмЧрнНрм▓рм╛рм╕рнНтАМ, рмЪрм╖рморм╛, рмкрнЛрм╖рм╛рмХ рмкрм░рм┐рмЪрнНрмЫрмж
ЁЯСФ => ЁЯСФ, рмирнЗрмХрнНтАМрмЯрм╛рмП, рмЯрм╛рмП, рмкрнЛрм╖рм╛рмХ рмкрм░рм┐рмЪрнНрмЫрмж
ЁЯСХ => ЁЯСХ, рмЯрм┐-рм╕рм╛рм░рнНрмЯрнНтАМ, рм╕рм╛рм░рнНрмЯрнНтАМ, рмкрнЛрм╖рм╛рмХ рмкрм░рм┐рмЪрнНрмЫрмж
ЁЯСЦ => ЁЯСЦ, рмЯрнНрм░рм╛рмЙрмЬрм░рнНтАМ, рмЬрм┐рмирнНрм╕, рмкрнНрнЯрм╛рмгрнНрмЯ, рмкрнЛрм╖рм╛рмХ рмкрм░рм┐рмЪрнНрмЫрмж
ЁЯСЧ => ЁЯСЧ, рмкрнЛрм╖рм╛рмХ, рмЧрнЛрмЯрм┐рмП-рмЦрмгрнНрмб, рмкрнЛрм╖рм╛рмХ рмкрм░рм┐рмЪрнНрмЫрмж
ЁЯСШ => ЁЯСШ, рмХрм┐рморнЛрмирнЛ, рмкрнЛрм╖рм╛рмХ, рмкрнЛрм╖рм╛рмХ рмкрм░рм┐рмЪрнНрмЫрмж
ЁЯСЩ => ЁЯСЩ, рммрм┐рмХрм┐рмирм┐, рмЧрм╛рмзрнЛрмЗрммрм╛ рмкрм░рм┐рмзрм╛рми, рмкрнЛрм╖рм╛рмХ рмкрм░рм┐рмЪрнНрмЫрмж
ЁЯСЪ => ЁЯСЪ, рморм╣рм┐рм│рм╛рмЩрнНрмХ рмкрнЛрм╖рм╛рмХрмкрмдрнНрм░, рмкрнЛрм╖рм╛рмХрмкрмдрнНрм░, рмкрнЛрм╖рм╛рмХ рмкрм░рм┐рмЪрнНрмЫрмж
ЁЯСЫ => ЁЯСЫ, рмкрм░рнНрм╕рнНтАМ, рмХрмПрмирнНтАМ рмкрм░рнНрм╕рнН, рморнБрмжрнНрм░рм╛, рмкрнЛрм╖рм╛рмХ рмкрм░рм┐рмЪрнНрмЫрмж
ЁЯСЬ => ЁЯСЬ, рм╣рнНрнЯрм╛рмгрнНрмбрммрнНрнЯрм╛рмЧрнНтАМ, рммрнНрнЯрм╛рмЧрнН, рмкрнЛрм╖рм╛рмХ рмкрм░рм┐рмЪрнНрмЫрмж
ЁЯСЭ => ЁЯСЭ, рмЫрнЛрмЯ рмерм│рм┐, рммрнНрнЯрм╛рмЧрнНтАМ, рмкрнЛрм╖рм╛рмХ рмкрм░рм┐рмЪрнНрмЫрмж
ЁЯОТ => ЁЯОТ, рм╕рнНрмХрнБрм▓рнНтАМ рммрнНрнЯрм╛рмЧрнНтАМ, рммрм┐рмжрнНрнЯрм╛рм│рнЯ рммрм╕рнНрмдрм╛рмирм┐, рммрм╕рнНрмдрм╛рмирм┐, рммрм┐рмжрнНрнЯрм╛рм│рнЯ
ЁЯСЮ => ЁЯСЮ, рмкрнБрм░рнБрм╖рмЩрнНрмХ рмЬрнЛрмдрм╛, рмЬрнЛрмдрм╛, рмкрнЛрм╖рм╛рмХ рмкрм░рм┐рмЪрнНрмЫрмж
ЁЯСЯ => ЁЯСЯ, рмжрнМрмбрмХрнБрмж рм╕рморнНрммрмирнНрмзрм┐рмд рмЬрнЛрмдрм╛, рмирм░рмо рмдрм│ рмерм┐рммрм╛ рмЬрнЛрмдрм╛, рмЬрнЛрмдрм╛, рмкрнЛрм╖рм╛рмХ рмкрм░рм┐рмЪрнНрмЫрмж
ЁЯСа => ЁЯСа, рм╣рм╛рмЗ-рм╣рм┐рм▓рнН, рмЬрнЛрмдрм╛, рмкрнЛрм╖рм╛рмХ рмкрм░рм┐рмЪрнНрмЫрмж
ЁЯСб => ЁЯСб, рморм╣рм┐рм│рм╛рмЩрнНрмХ рмЪрмкрм▓, рмЪрмкрм▓, рморм╣рм┐рм│рм╛, рмкрнЛрм╖рм╛рмХ рмкрм░рм┐рмЪрнНрмЫрмж
ЁЯСв => ЁЯСв, рморм╣рм┐рм│рм╛рмЩрнНрмХ рммрнБрмЯрнНтАМ, рммрнБрмЯрнНтАМ, рморм╣рм┐рм│рм╛, рмкрнЛрм╖рм╛рмХ рмкрм░рм┐рмЪрнНрмЫрмж
ЁЯСС => ЁЯСС, рморнБрмХрнБрмЯ, рмкрнЛрм╖рм╛рмХ рмкрм░рм┐рмЪрнНрмЫрмж
ЁЯСТ => ЁЯСТ, рморм╣рм┐рм│рм╛рмЩрнНрмХ рмЯрнЛрмкрм┐, рмЯрнЛрмкрм┐, рмкрнЛрм╖рм╛рмХ рмкрм░рм┐рмЪрнНрмЫрмж
ЁЯОй => ЁЯОй, рм▓рморнНрммрм╛ рмЯрнЛрмкрм┐, рмЯрнЛрмкрм┐, рмормирнЛрм░рмЮрнНрмЬрми
ЁЯОУ => ЁЯОУ, рм╕рнНрмирм╛рмдрмХ рмЯрнЛрмкрм┐, рмЯрнЛрмкрм┐, рм╕рнНрмирм╛рмдрмХ, рмЙрмдрнНрм╕рмм
ЁЯТД => ЁЯТД, рм▓рм┐рмкрм╖рнНрмЯрм┐рмХрнНтАМ, рморнЗрмХрмЕрмкрнН, рмкрнНрм░рм╕рм╛рмзрми рм╕рм╛рмормЧрнНрм░рнА
ЁЯТН => ЁЯТН, рморнБрмжрнНрм░рм┐рмХрм╛, рмкрнНрм░рмгрнЯ
ЁЯТО => ЁЯТО, рмормгрм┐, рмормгрм┐ рмкрмерм░, рм╣рм┐рм░рм╛, рмкрнНрм░рмгрнЯ
ЁЯР╡ => ЁЯР╡, рморм╛рмЩрнНрмХрмб рморнБрм╣рмБ, рморм╛рмЩрнНрмХрмб, рморнБрм╣рмБ, рмЬрнАрмм
ЁЯРТ => ЁЯРТ, рморм╛рмЩрнНрмХрмб, рмкрм╢рнБ
ЁЯР╢ => ЁЯР╢, рмХрнБрмХрнБрм░ рморнБрм╣рмБ, рмХрнБрмХрнБрм░, рморнБрм╣рмБ, рмЬрнАрмм
ЁЯРХ => ЁЯРХ, рмХрнБрмХрнБрм░, рмХрнБрмХрнБрм░ рмЫрнБрмЖ, рмкрм╢рнБ
ЁЯРй => ЁЯРй, рм▓рнЛрморм╢ рмХрнБрмХрнБрм░, рмХрнБрмХрнБрм░, рмкрм╢рнБ
ЁЯР║ => ЁЯР║, рмЧрмзрм┐рмЖ рморнБрм╣рмБ, рмЧрмзрм┐рмЖ, рморнБрм╣рмБ, рмЬрнАрмм
ЁЯР▒ => ЁЯР▒, рммрм┐рм▓рнЗрмЗ рморнБрм╣рмБ, рммрм┐рм▓рнЗрмЗ, рморнБрм╣рмБ, рмЬрнАрмм
ЁЯРИ => ЁЯРИ, рммрм┐рм▓рнЗрмЗ, рмкрм╢рнБ
ЁЯРп => ЁЯРп, рммрм╛рмШ рморнБрм╣рмБ, рммрм╛рмШ, рмЬрнАрмм
ЁЯРЕ => ЁЯРЕ, рммрм╛рмШ, рмкрм╢рнБ
ЁЯРЖ => ЁЯРЖ, рмЪрм┐рмдрм╛рммрм╛рмШ, рмкрм╢рнБ
ЁЯР┤ => ЁЯР┤, рмШрнЛрмбрм╛ рморнБрм╣рмБ, рмШрнЛрмбрм╛, рморнБрм╣рмБ, рмЬрнАрмм
ЁЯРО => ЁЯРО, рмШрнЛрмбрм╛, рмкрм╢рнБ
ЁЯРо => ЁЯРо, рмЧрм╛рмЗ рморнБрм╣рмБ, рмЧрм╛рмЗ, рморнБрм╣рмБ, рмкрм╢рнБ
ЁЯРВ => ЁЯРВ, рммрм│рмж, рмкрм╢рнБ
ЁЯРГ => ЁЯРГ, рмЬрм│ рмормЗрмБрм╖рм┐, рмЬрм│, рмормЗрмБрм╖рм┐, рмкрм╢рнБ
ЁЯРД => ЁЯРД, рмЧрм╛рмЗ, рмкрм╢рнБ
ЁЯР╖ => ЁЯР╖, рмШрнБрм╖рнБрм░рм┐ рморнБрм╣рмБ, рмШрнБрм╖рнБрм░рм┐, рморнБрм╣рмБ, рмЬрнАрмм
ЁЯРЦ => ЁЯРЦ, рмШрнБрм╖рнБрм░рм┐, рмкрм╢рнБ
ЁЯРЧ => ЁЯРЧ, рммрм╛рм░рм╛рм╣рм╛, рмкрм╢рнБ
ЁЯР╜ => ЁЯР╜, рмШрнБрм╖рнБрм░рм┐ рмирм╛рмХ, рмШрнБрм╖рнБрм░рм┐, рморнБрм╣рмБ, рмЬрнАрмм
ЁЯРП => ЁЯРП, рмЦрм╛рм╕рнБ рм╣рнЛрмЗрмирмерм┐рммрм╛ рморнЗрмгрнНрмврм╛, рмкрм╢рнБ
ЁЯРС => ЁЯРС, рморнЗрмгрнНрмврм╛, рмкрм╢рнБ
ЁЯРР => ЁЯРР, рмЫрнЗрм│рм┐, рмкрм╢рнБ
ЁЯРк => ЁЯРк, рмПрмХ рмХрнБрмЬ рммрм┐рм╢рм┐рм╖рнНрмЯ рмУрмЯ, рмХрнБрмЬ, рмУрмЯ, рмПрмХ рмХрнБрмЬ рммрм┐рм╢рм┐рм╖рнНрмЯ рмЖрм░рммрнАрнЯ рмУрмЯ, рмкрм╢рнБ
ЁЯРл => ЁЯРл, рмжрнБрмЗ рмХрнБрмЬ рммрм┐рм╢рм┐рм╖рнНрмЯ рмУрмЯ, рмХрнБрмЬ, рмУрмЯ, рмжрнБрмЗ рмХрнБрмЬ рммрм┐рм╢рм┐рм╖рнНрмЯ рмЖрм░рммрнАрнЯ рмУрмЯ, рмкрм╢рнБ
ЁЯРШ => ЁЯРШ, рм╣рм╛рмдрнА, рмкрм╢рнБ
ЁЯРн => ЁЯРн, рморнВрм╖рм╛ рморнБрм╣рмБ, рморнВрм╖рм╛, рморнБрм╣рмБ, рмЬрнАрмм
ЁЯРБ => ЁЯРБ, рморнВрм╖рм┐рмХ, рмЬрнАрмм
ЁЯРА => ЁЯРА, рммрмб рморнВрм╖рм╛, рмЬрнАрмм
ЁЯР╣ => ЁЯР╣, рм╣рм╛рморм╖рнНрмЯрм░рнНтАМ рморнБрм╣рмБ, рм╣рм╛рморм╖рнНрмЯрм░рнНтАМ, рморнБрм╣рмБ, рмЬрнАрмм
ЁЯР░ => ЁЯР░, рмарнЗрмХрнБрмЖ рморнБрм╣рмБ, рмарнЗрмХрнБрмЖ, рморнБрм╣рмБ, рмЬрнАрмм
ЁЯРЗ => ЁЯРЗ, рмарнЗрмХрнБрмЖ, рмЦрм░рм┐рмЖ, рмкрм╢рнБ
ЁЯР╗ => ЁЯР╗, рмнрм╛рм▓рнБ рморнБрм╣рмБ, рмнрм╛рм▓рнБ, рморнБрм╣рмБ, рмЬрнАрмм
ЁЯРи => ЁЯРи, рмХрнЛрмЖрм▓рм╛, рмХрнЛрмЖрм▓рм╛ рмнрм╛рм▓рнБ, рмЬрнАрмм
ЁЯР╝ => ЁЯР╝, рмкрм╛рмгрнНрмбрм╛ рморнБрм╣рмБ, рмкрм╛рмгрнНрмбрм╛, рморнБрм╣рмБ, рмЬрнАрмм
ЁЯР╛ => ЁЯР╛, рмкрмЮрнНрмЬрм╛, рмкрмЮрнНрмЬрм╛ рмЪрм┐рм╣рнНрми, рмЪрм┐рм╣рнНрми, рмЬрнАрмм
ЁЯРФ => ЁЯРФ, рмХрнБрмХрнБрмбрм╛, рмкрм╢рнБ
ЁЯРУ => ЁЯРУ, рмЧрнГрм╣рмкрм╛рм│рм┐рмд рмЧрмЮрнНрмЬрм╛, рмкрм╢рнБ
ЁЯРг => ЁЯРг, рмЕрмгрнНрмбрм╛рм░рнБ рммрм╛рм╣рм╛рм░рм┐рмерм┐рммрм╛ рмерм┐рммрм╛ рмХрнБрмХрнБрмбрм╛ рмЫрнБрмЖ, рмЫрнЛрмЯ рмХрнБрмХрнБрмбрм╛ рмЫрнБрмЖ, рмЕрмгрнНрмбрм╛ рмлрнБрмЯрм╛рмЗрммрм╛ рмХрм╛рм░рнНрмпрнНрнЯ, рм╢рм┐рм╢рнБ, рмХрнБрмХрнБрмбрм╛ рмЫрнБрмЖ, рмХрнБрмХрнБрмбрм╛, рмЬрнАрмм
ЁЯРд => ЁЯРд, рмЫрнЛрмЯ рмХрнБрмХрнБрмбрм╛ рмЫрнБрмЖ, рм╢рм┐рм╢рнБ, рмХрнБрмХрнБрмбрм╛ рмЫрнБрмЖ, рмХрнБрмХрнБрмбрм╛, рмЬрнАрмм
ЁЯРе => ЁЯРе, рмЫрнЛрмЯ рмХрнБрмХрнБрмбрм╛ рмЫрнБрмЖ, рморнБрм╣рмБ рммрм╛рм╣рм╛рм░рмХрнБ рммрм╛рм╣рм░ рмХрм░рм┐рмерм┐рммрм╛ рмЫрнЛрмЯ рмХрнБрмХрнБрмбрм╛ рмЫрнБрмЖ, рм╢рм┐рм╢рнБ, рмХрнБрмХрнБрмбрм╛ рмЫрнБрмЖ, рмХрнБрмХрнБрмбрм╛, рмЬрнАрмм
ЁЯРж => ЁЯРж, рмкрмХрнНрм╖рнА, рмЬрнАрмм
ЁЯРз => ЁЯРз, рмкрнЗрмЩрнНрмЧрнБрмЗрмирнНтАМ, рмЬрнАрмм
ЁЯР╕ => ЁЯР╕, рммрнЗрмЩрнНрмЧ рморнБрм╣рмБ, рммрнЗрмЩрнНрмЧ, рморнБрм╣рмБ, рмЬрнАрмм
ЁЯРК => ЁЯРК, рмХрнБрморнНрмнрнАрм░, рмкрм╢рнБ
ЁЯРв => ЁЯРв, рмХрмЗрмБрмЫ, рмЬрнАрмм
ЁЯРН => ЁЯРН, рм╕рм╛рмк, рмЬрнАрмм
ЁЯР▓ => ЁЯР▓, рмбрнНрм░рм╛рмЧрмирнНтАМ рморнБрм╣рмБ, рмбрнНрм░рм╛рмЧрмирнНтАМ, рморнБрм╣рмБ, рмЬрнАрмм
ЁЯРЙ => ЁЯРЙ, рмбрнНрм░рм╛рмЧрмирнНтАМ, рмкрм╢рнБ
ЁЯР│ => ЁЯР│, рм╕рнНрмкрм╛рмЙрмЯрм┐рмВ рмдрм┐рморм┐, рм╕рнНрмкрм╛рмЙрмЯрм┐рмВ, рмдрм┐рморм┐, рмЬрнАрмм
ЁЯРЛ => ЁЯРЛ, рмдрм┐рморм┐, рмЬрнАрмм
ЁЯРм => ЁЯРм, рмбрм▓рмлрм┐рмирнНтАМ, рмЬрнАрмм
ЁЯРЯ => ЁЯРЯ, рморм╛рмЫ, рмЬрнАрмм
ЁЯРа => ЁЯРа, рмЯрнЛрмкрм┐рмХрм╛рм▓рнНтАМ, рморм╛рмЫ, рмЬрнАрмм
ЁЯРб => ЁЯРб, рммрнНрм▓рнЛрмлрм┐рм╢рнНтАМ, рморм╛рмЫ, рмЬрнАрмм
ЁЯРЩ => ЁЯРЩ, рмЕрмХрнНрмЯрнЛрмкрм╕рнНтАМ, рмЬрнАрмм
ЁЯРЪ => ЁЯРЪ, рм╢рм╛рморнБрмХрм╛, рм╕рм░рнНрмкрм┐рм│ рмЦрнЛрм│, рмЬрнАрмм
ЁЯРМ => ЁЯРМ, рмЧрнЗрмгрнНрмбрм╛, рмЬрнАрмм
ЁЯРЫ => ЁЯРЫ, рмУрмбрм╢, рмдрнЗрм▓рнБрмгрм┐ рмкрнЛрмХ, рм╕рморнНрммрм╛рм│рнБрмЖ, рмЬрнАрмм
ЁЯРЬ => ЁЯРЬ, рмкрм┐рморнНрмкрнБрмбрм┐, рмЬрнАрмм
ЁЯРЭ => ЁЯРЭ, рморм╣рнБрморм╛рмЫрм┐, рмормзрнБрмормХрнНрм╖рм┐рмХрм╛, рмЬрнАрмм
ЁЯРЮ => ЁЯРЮ, рморм╛рмЗ рмЧрнЛрммрм░рмкрнЛрмХ, рморм╛рмЗ рмУрмбрм╢, рморм╛рмЗ, рмЧрнЛрммрм░рмкрнЛрмХ, рмЬрнАрмм
ЁЯТР => ЁЯТР, рмлрнБрм▓рмдрнЛрмбрм╛, рмлрнБрм▓, рмкрнНрм░рмгрнЯ
ЁЯМ╕ => ЁЯМ╕, рмЪрнЗрм░рм┐ рммрнНрм▓рнЛрм╕рморнН, рмЪрнЗрм░рм┐, рмлрнБрм▓ рмжрнЗрмЦрм┐рммрм╛, рмлрнБрм▓
ЁЯТо => ЁЯТо, рмлрнБрм▓ рм╖рнНрмЯрм╛рморнНрмк, рмЕрмдрм┐рмЙрмдрнНрмдрмо рм╖рнНрмЯрм╛рморнНрмкрнН, рмлрнБрм▓, рм╖рнНрмЯрм╛рморнНрмкрнН
ЁЯМ╣ => ЁЯМ╣, рмЧрнЛрм▓рм╛рмк, рмлрнБрм▓
ЁЯМ║ => ЁЯМ║, рм╣рм┐рммрм┐рм╕рмХрнБрм╕рнН, рмлрнБрм▓
ЁЯМ╗ => ЁЯМ╗, рм╕рнВрм░рнНрмпрнНрнЯрморнБрмЦрнА, рмлрнБрм▓
ЁЯМ╝ => ЁЯМ╝, рммрнНрм▓рнЛрмЬрморнН, рмлрнБрм▓
ЁЯМ╖ => ЁЯМ╖, рмдрнБрм▓рм┐рмкрнН, рмлрнБрм▓
ЁЯМ▒ => ЁЯМ▒, рмЪрм╛рм░рм╛, рмЫрнЛрмЯ, рмдрм│рм┐
ЁЯМ▓ => ЁЯМ▓, рмЪрм┐рм░рм╣рм░рм┐ рммрнГрмХрнНрм╖, рмЪрм┐рм░рм╣рм░рм┐, рмЧрмЫ
ЁЯМ│ => ЁЯМ│, рмкрм░рнНрмгрнНрмгрмкрм╛рмдрм┐ рммрнГрмХрнНрм╖, рмкрм░рнНрмгрнНрмгрмкрм╛рмдрм┐, рммрнГрмХрнНрм╖
ЁЯМ┤ => ЁЯМ┤, рмдрм╛рм│ рмЧрмЫ, рмдрм╛рм│, рмЧрмЫ
ЁЯМ╡ => ЁЯМ╡, рмХрм╛рмХрнНтАМрмЯрм╕рнН, рмЧрмЫ
ЁЯМ╛ => ЁЯМ╛, рмзрм╛рми рмЧрмЫ, рмзрм╛рми рмХрнЗрмгрнНрмбрм╛, рмзрм╛рми, рмХрнЗрмгрнНрмбрм╛
ЁЯМ┐ => ЁЯМ┐, рмЬрмбрм┐ рммрнБрмЯрм┐, рмкрмдрнНрм░
ЁЯНА => ЁЯНА, рмЪрм╛рм░рм┐ рмкрмдрнНрм░ рммрм┐рм╢рм┐рм╖рнНрмЯ рмШрм╛рм╕, рмЪрм╛рм░рм┐, рмкрмдрнНрм░, рмШрм╛рм╕, рмнрм╛рмЧрнНрнЯ рм╢рм╛рм│рм┐
ЁЯНБ => ЁЯНБ, рморм╛рмкрм▓рнН рмкрмдрнНрм░, рмлрм╛рм▓рнЗрмирнН рмкрмдрнНрм░, рмкрмдрнНрм░
ЁЯНВ => ЁЯНВ, рмлрм╛рм▓рм┐рмВ рмкрмдрнНрм░, рмлрм╛рм▓рнЗрмирнН рмкрмдрнНрм░, рмлрм╛рм▓рм┐рмВ, рмлрм╛рм▓рнЗрмирнН, рмкрмдрнНрм░
ЁЯНГ => ЁЯНГ, рмкрмдрнНрм░ рмЙрмбрм┐рммрм╛, рмкрммрми рммрнЛрм╣рм┐рммрм╛, рмкрмдрнНрм░, рммрм╛рнЯрнБ, рмкрммрми рммрм╣рм┐рммрм╛
ЁЯНЗ => ЁЯНЗ, рмЖрмЩрнНрмЧрнБрм░, рмлрм│
ЁЯНИ => ЁЯНИ, рмЦрм░рмнрнБрмЬ, рмлрм│
ЁЯНЙ => ЁЯНЙ, рмдрм░рмнрнБрмЬ, рмлрм│
ЁЯНК => ЁЯНК, рмирм╛рм░рмВрмЧрнА, рмХрморм│рм╛, рмлрм│
ЁЯНЛ => ЁЯНЛ, рм▓рнЗрморнНрм╡рнБ, рмЯрмнрм╛, рмлрм│
ЁЯНМ => ЁЯНМ, рмХрмжрм│рнА, рмлрм│
ЁЯНН => ЁЯНН, рм╕рмкрнБрм░рм┐, рмлрм│
ЁЯНО => ЁЯНО, рм▓рм╛рм▓рнН рмПрмкрм▓рнН, рмПрмкрм▓рнН, рм▓рм╛рм▓рнН, рмлрм│
ЁЯНП => ЁЯНП, рм╕рммрнБрмЬ рмПрмкрм▓рнН, рмПрмкрм▓рнН, рм╕рммрнБрмЬ, рмлрм│
ЁЯНР => ЁЯНР, рмирм╛рм╕рмкрмдрм┐, рмлрм│
ЁЯНС => ЁЯНС, рмкрм┐рмЪрнН, рмлрм│
ЁЯНТ => ЁЯНТ, рмЪрнЗрм░рм┐, рмлрм│
ЁЯНУ => ЁЯНУ, рм╖рнНрмЯрнНрм░рммрнЗрм░рнА, рммрнЗрм░рнА, рмлрм│
ЁЯНЕ => ЁЯНЕ, рмЯрморм╛рмЯ, рмкрмирм┐рмкрм░рм┐рммрм╛
ЁЯНЖ => ЁЯНЖ, рммрм╛рмЗрмЧрмг, рмкрм░рм┐рммрм╛
ЁЯМ╜ => ЁЯМ╜, рмормХрм╛, рмХрм╛рмо
ЁЯНД => ЁЯНД, рмЫрмдрнБ
ЁЯМ░ => ЁЯМ░, рмЪрнЗрм╖рнНрмЯрмирмЯрнН
ЁЯНЮ => ЁЯНЮ, рмкрм╛рмЙрмБрм░рнБрмЯрм┐, рм░рнЗрм╖рнНрмЯрнБрм░рм╛рмгрнНрмЯрнН
ЁЯНЦ => ЁЯНЦ, рморм╛рмВрм╕, рм╣рм╛рмбрм░рнЗ рморм╛рмВрм╕, рм░рнЗрм╖рнНрмЯрнБрм░рм╛рмгрнНрмЯрнН
ЁЯНЧ => ЁЯНЧ, рмХрнБрмХрнБрмбрм╛ рмЧрнЛрмб, рмкрм▓рнБрмЯрнНрм░рм┐, рмЧрнЛрмб, рм░рнЗрм╖рнНрмЯрнБрм░рм╛рмгрнНрмЯрнН
ЁЯНФ => ЁЯНФ, рм╣рм╛рморнНтАМрммрм░рнНрмЧрм░рнН, рммрм░рнНрмЧрм░рнН, рм░рнЗрм╖рнНрмЯрнБрм░рм╛рмгрнНрмЯрнН
ЁЯНЯ => ЁЯНЯ, рмлрнНрм░рм╛рмЗрм╕рнН, рмлрнНрм░рнЗрмЮрнНрмЪ рмлрнНрм░рм╛рмЗрм╕рнН, рм░рнЗрм╖рнНрмЯрнБрм░рм╛рмгрнНрмЯрнН
ЁЯНХ => ЁЯНХ, рмкрм┐рмЬрм╛ рмЦрмгрнНрмб, рмкрм┐рмЬрм╛, рмЦрмгрнНрмб, рм░рнЗрм╖рнНрмЯрнБрм░рм╛рмгрнНрмЯрнН
ЁЯН▓ => ЁЯН▓, рм╕рмирнНрмдрнБрм│рм╛, рмкрм╛рмдрнНрм░ рмЦрм╛рмжрнНрнЯ, рм░рнЗрм╖рнНрмЯрнБрм░рм╛рмгрнНрмЯрнН
ЁЯН▒ => ЁЯН▒, рммрнЗрмгрнНрмЯрнЛ, рммрнЗрмгрнНрмЯрнЛ рммрм╛рмХрнНрм╕, рммрм╛рмХрнНрм╕, рм░рнЗрм╖рнНрмЯрнБрм░рм╛рмгрнНрмЯрнН
ЁЯНШ => ЁЯНШ, рм░рм╛рмЗрм╕рнН рмХрнНрм░рм╛рмХрм░рнН, рмнрм╛рмд
ЁЯНЩ => ЁЯНЩ, рм░рм╛рмЗрм╕рнН рммрм▓рнН, рмУрмирм┐рмЧрнНрм░рм┐, рмнрм╛рмд, рм░рнЗрм╖рнНрмЯрнБрм░рм╛рмгрнНрмЯрнН
ЁЯНЪ => ЁЯНЪ, рмнрм╛рмд, рм░рнЗрм╖рнНрмЯрнБрм░рм╛рмгрнНрмЯрнН
ЁЯНЫ => ЁЯНЫ, рмнрм╛рмд рмдрм░рмХрм╛рм░рнА, рмдрм░рмХрм╛рм░рнА, рмнрм╛рмд, рм░рнЗрм╖рнНрмЯрнБрм░рм╛рмгрнНрмЯрнН
ЁЯНЬ => ЁЯНЬ, рм░рм╛рморнЗрмирнН, рмПрмХ рмкрм╛рмдрнНрм░ рмирнБрмбрм▓рнНрм╕, рмирнБрмбрнБрм▓рнН, рм╖рнНрмЯрм┐рмормВ, рммрм╛рмЙрм▓рнН, рмирнБрмбрнБрм▓рнНрм╕, рм░рнЗрм╖рнНрмЯрнБрм░рм╛рмгрнНрмЯрнН
ЁЯНЭ => ЁЯНЭ, рм╕рмкрм╛рмШрнЗрмЯрнНрмЯрм┐, рмкрм╛рм╕рнНрмдрм╛, рм░рнЗрм╖рнНрмЯрнБрм░рм╛рмгрнНрмЯрнН
ЁЯНа => ЁЯНа, рмЫрмгрм╛ рм╣рнЛрмЗрмерм┐рммрм╛ рмЖрм│рнБ, рмХрмирнНрмжрморнВрм│, рмЫрмгрм╛ рм╣рнЛрмЗрмерм┐рммрм╛ рмХрмирнНрмжрморнВрм│, рморм┐рмарм╛, рмЫрмгрм╛ рм╣рнЛрмЗрмерм┐рммрм╛, рм░рнЗрм╖рнНрмЯрнБрм░рм╛рмгрнНрмЯрнН
ЁЯНв => ЁЯНв, рмУрмбрнЗрмирнН, рм╖рнНрмЯрм┐рмХрнНтАМрм░рнЗ рм╕рм╛рморнБрмжрнНрм░рм┐рмХ рмЦрм╛рмжрнНрнЯ, рм╕рм╛рморнБрмжрнНрм░рм┐рмХ рмЦрм╛рмжрнНрнЯ, рмХрм╛рмарм┐, рм░рнЗрм╖рнНрмЯрнБрм░рм╛рмгрнНрмЯрнН
ЁЯНг => ЁЯНг, рм╕рнБрм╕рм┐, рм░рнЗрм╖рнНрмЯрнБрм░рм╛рмгрнНрмЯрнН
ЁЯНд => ЁЯНд, рмЫрмгрм╛ рм╣рнЛрмЗрмерм┐рммрм╛ рмЪрм┐рмЩрнНрмЧрнБрмбрм┐, рмЪрм┐рмЩрнНрмЧрнБрмбрм┐, рм░рнЗрм╖рнНрмЯрнБрм░рм╛рмгрнНрмЯрнН
ЁЯНе => ЁЯНе, рморм╛рмЫ рмХрнЗрмХрнН, рм╕рнНрм╡рм┐рм░рнНрм▓рнН рм╕рм╣рм┐рмд рморм╛рмЫ рмХрнЗрмХрнН, рморм╛рмЫ, рм░рнЗрм╖рнНрмЯрнБрм░рм╛рмгрнНрмЯрнН
ЁЯНб => ЁЯНб, рморнЛрмЪрм┐, рморнЛрмЪрм┐рммрм▓рнН, рм╖рнНрмЯрм┐рмХрнНтАМрм░рнЗ рморнЛрмЪрм┐ рммрм▓рнН, рмбрм╛рмЩрнНрмЧрнЛ, рм░рнЗрм╖рнНрмЯрнБрм░рм╛рмгрнНрмЯрнН
ЁЯНж => ЁЯНж, рм╕рмлрнНрмЯ рмЖрмЗрм╕рнН рмХрнНрм░рм┐рморнН, рмЖрмЗрм╕рнН рмХрнНрм░рм┐рморнН, рм╕рмлрнНрмЯ рм╕рм░рнНрмнрнН, рмХрнНрм░рм┐рморнН, рм░рнЗрм╖рнНрмЯрнБрм░рм╛рмгрнНрмЯрнН
ЁЯНз => ЁЯНз, рмЪрнБрм╕рнНтАМрмХрм┐, рммрм░рмл, рмЧрнЛрм▓рм╛, рм░рнЗрм╖рнНрмЯрнБрм░рм╛рмгрнНрмЯрнН
ЁЯНи => ЁЯНи, рмЖрмЗрм╕рнНтАМ рмХрнНрм░рм┐рморнНтАМ, рммрм░рмл, рмХрнНрм░рм┐рморнНтАМ, рм░рнЗрм╖рнНрмЯрнБрм░рм╛рмгрнНрмЯрнН
ЁЯНй => ЁЯНй, рмбрнБрмирмЯрнНтАМ, рмбрнЛрмирмЯрнНтАМ, рм░рнЗрм╖рнНрмЯрнБрм░рм╛рмгрнНрмЯрнН
ЁЯНк => ЁЯНк, рмХрнБрмХрм┐, рм░рнЗрм╖рнНрмЯрнБрм░рм╛рмгрнНрмЯрнН
ЁЯОВ => ЁЯОВ, рмЬрмирнНрмормжрм┐рми рмХрнЗрмХрнНтАМ, рмЬрмирнНрмормжрм┐рми, рмХрнЗрмХрнНтАМ, рмЙрмдрнНрм╕рмм
ЁЯН░ => ЁЯН░, рмХрмЪрнЛрмбрм┐, рмХрмЯрм╛ рмпрм╛рмЗрмерм┐рммрм╛ рмХрнЗрмХрнНтАМ, рмХрнЗрмХрнНтАМ, рм░рнЗрм╖рнНрмЯрнБрм░рм╛рмгрнНрмЯрнН
ЁЯНл => ЁЯНл, рмЪрмХрм▓рнЗрмЯрнНтАМ, рмЪрмХрм▓рнЗрмЯрнНтАМ рммрм╛рм░рнН, рммрм╛рм░рнНтАМ, рм░рнЗрм╖рнНрмЯрнБрм░рм╛рмгрнНрмЯрнН
ЁЯНм => ЁЯНм, рмХрнНрнЯрм╛рмгрнНрмбрм┐, рм░рнЗрм╖рнНрмЯрнБрм░рм╛рмгрнНрмЯрнН
ЁЯНн => ЁЯНн, рм▓рм▓рм┐рмкрмкрнНтАМ, рмХрнНрнЯрм╛рмгрнНрмбрм┐, рм░рнЗрм╖рнНрмЯрнБрм░рм╛рмгрнНрмЯрнН
ЁЯНо => ЁЯНо, рмХрм╖рнНрмЯрм╛рм░рнНрмбрнНтАМ, рмкрнБрмбрм┐рмВ, рм░рнЗрм╖рнНрмЯрнБрм░рм╛рмгрнНрмЯрнН
ЁЯНп => ЁЯНп, рм╣рмирм┐рмкрмЯрнНтАМ, рморм╣рнБ, рмкрм╛рмдрнНрм░, рм░рнЗрм╖рнНрмЯрнБрм░рм╛рмгрнНрмЯрнН
ЁЯН╝ => ЁЯН╝, рм╢рм┐рм╢рнБ рммрнЛрмдрм▓, рмХрнНрм╖рнАрм░, рммрнЛрмдрм▓, рмкрм╛рмирнАрнЯ
ЁЯН╡ => ЁЯН╡, рмЪрм╛ рмХрмкрнНтАМ, рмХрмкрнЗ рмЪрм╛, рмЪрм╛, рмкрм╛рмирнАрнЯ
ЁЯН╢ => ЁЯН╢, рм╕рнЗрмХрнНтАМ, рм╕рнЗрмХрнНтАМ рммрнЛрмдрм▓ рмПрммрмВ рмХрмкрнНтАМ, рмХрмкрнНтАМ, рммрнЛрмдрм▓, рмкрм╛рмирнАрнЯ, рм░рнЗрм╖рнНрмЯрнБрм░рм╛рмгрнНрмЯрнН, рммрм╛рм░рнН
ЁЯН╖ => ЁЯН╖, рм╕рнБрм░рм╛, рм╕рнБрм░рм╛рмнрм░рнНрмдрнНрмдрм┐ рмЧрнНрм▓рм╛рм╕рнНтАМ, рм╕рнБрм░рм╛ рмЧрнНрм▓рм╛рм╕рнНтАМ, рмЧрнНрм▓рм╛рм╕рнНтАМ, рмкрм╛рмирнАрнЯ, рм░рнЗрм╖рнНрмЯрнБрм░рм╛рмгрнНрмЯрнН, рммрм╛рм░рнН
ЁЯН╕ => ЁЯН╕, рмХрмХрмЯрнЗрм▓рнНтАМ, рмХрмХрмЯрнЗрм▓рнНтАМ рмЧрнНрм▓рм╛рм╕рнНтАМ, рм░рнЗрм╖рнНрмЯрнБрм░рм╛рмгрнНрмЯрнН, рммрм╛рм░рнН
ЁЯН╣ => ЁЯН╣, рмЧрнНрм░рнАрм╖рнНрмо рмормгрнНрмбрм│ рм╕рморнНрммрмирнНрмзрнАрнЯ рмкрм╛рмирнАрнЯ, рмЧрнНрм░рнАрм╖рнНрмо рмормгрнНрмбрм│ рм╕рморнНрммрмирнНрмзрнАрнЯ, рмкрм╛рмирнАрнЯ, рм░рнЗрм╖рнНрмЯрнБрм░рм╛рмгрнНрмЯрнН, рммрм╛рм░рнН
ЁЯН║ => ЁЯН║, рмормж, рмормж рмормЧрнНтАМ, рмормЧрнНтАМ, рм░рнЗрм╖рнНрмЯрнБрм░рм╛рмгрнНрмЯрнН, рммрм╛рм░рнН
ЁЯН╗ => ЁЯН╗, рмормж рмормЧрнНтАМрмЧрнБрмбрм┐рмХ, рмормж, рмормЧрнНтАМрмЧрнБрмбрм┐рмХ, рмормЧрнНтАМ, рм░рнЗрм╖рнНрмЯрнБрм░рм╛рмгрнНрмЯрнН, рммрм╛рм░рнН
ЁЯН┤ => ЁЯН┤, рмХрмгрнНрмЯрм╛ рмЪрм╛рмормЪ рмПрммрмВ рмЫрнБрм░рнА, рмХрмгрнНрмЯрм╛ рмЪрм╛рмормЪ, рмЫрнБрм░рнА, рм░рнЗрм╖рнНрмЯрнБрм░рм╛рмгрнНрмЯрнН
ЁЯН│ => ЁЯН│, рмнрм╛рмЬрм┐рммрм╛ рмХрмбрнЗрмЗ, рм░рнЛрм╖рнЗрмЗ, рм░рнЗрм╖рнНрмЯрнБрм░рм╛рмгрнНрмЯрнН
ЁЯМН => ЁЯМН, рмкрнГрмерм┐рммрнА, рммрм┐рм╢рнНрм╡, рнЯрнБрм░рнЛрмк, рмЖрмлрнНрм░рм┐рмХрм╛
ЁЯМО => ЁЯМО, рмкрнГрмерм┐рммрнА, рммрм┐рм╢рнНрм╡, рмЖрморнЗрм░рм┐рмХрнАрнЯ, рмЖрморнЗрм░рм┐рмХрм╛
ЁЯМП => ЁЯМП, рмкрнГрмерм┐рммрнА, рммрм┐рм╢рнНрм╡, рмПрм╕рм┐рмЖ, рмЕрм╖рнНрмЯрнНрм░рнЗрм▓рм┐рмЖ
ЁЯМР => ЁЯМР, рмкрнГрмерм┐рммрнА, рмжрнНрм░рм╛рмШрм┐рморм╛
ЁЯМЛ => ЁЯМЛ, рмЖрмЧрнНрмирнЗрнЯрмЧрм┐рм░рм┐, рмЖрмЧрнНрмирнЗрнЯрмЧрм┐рм░рм┐ рммрм┐рм╕рнНрмлрнЛрмЯ
ЁЯЧ╗ => ЁЯЧ╗, рморм╛рмЙрмгрнНрмЯрнН. рмлрнБрмЬрм┐, рмкрм╛рм╣рм╛рмб
ЁЯПа => ЁЯПа, рмШрм░, рмЕрмЯрнНрмЯрм╛рм│рм┐рмХрм╛
ЁЯПб => ЁЯПб, рмЧрнГрм╣, рмПрмХ рммрмЧрм┐рмЪрм╛ рмерм┐рммрм╛ рмШрм░, рммрмЧрм┐рмЪрм╛, рмЕрмЯрнНрмЯрм╛рм│рм┐рмХрм╛
тЫк => тЫк, рмЪрм░рнНрмЪрнНрмЪ, рмХрнЛрмарм╛
ЁЯПв => ЁЯПв, рмХрм╛рм░рнНрмпрнНрнЯрм╛рм│рнЯ рмЕрмЯрнНрмЯрм╛рм│рм┐рмХрм╛, рмХрм╛рм░рнНрмпрнНрнЯрм╛рм│рнЯ, рмЕрмЯрнНрмЯрм╛рм│рм┐рмХрм╛
ЁЯПг => ЁЯПг, рмбрм╛рмХрмШрм░, рмЬрм╛рмкрм╛рмирнА рмбрм╛рмХрмШрм░, рмЬрм╛рмкрм╛рмирнА, рмбрм╛рмХ, рмЕрмЯрнНрмЯрм╛рм│рм┐рмХрм╛
ЁЯПд => ЁЯПд, рмбрм╛рмХрмШрм░, рнЯрнБрм░рнЛрмкрнАрнЯ рмбрм╛рмХрмШрм░, рнЯрнБрм░рнЛрмкрнАрнЯ, рмбрм╛рмХ, рмЕрмЯрнНрмЯрм╛рм│рм┐рмХрм╛
ЁЯПе => ЁЯПе, рмбрм╛рмХрнНрмдрм░рмЦрм╛рмирм╛, рмЕрмЯрнНрмЯрм╛рм│рм┐рмХрм╛
ЁЯПж => ЁЯПж, рммрнНрнЯрм╛рмЩрнНрмХ рмЕрмЯрнНрмЯрм╛рм│рм┐рмХрм╛
ЁЯПи => ЁЯПи, рм╣рнЛрмЯрнЗрм▓рнНтАМ, рмЕрмЯрнНрмЯрм╛рм│рм┐рмХрм╛
ЁЯПй => ЁЯПй, рмкрм╕рмирнНрмжрм░ рм╣рнЛрмЯрнЗрм▓рнНтАМ, рмнрм▓ рмкрм╛рмЗрммрм╛, рм╣рнЛрмЯрнЗрм▓рнНтАМ, рмЕрмЯрнНрмЯрм╛рм│рм┐рмХрм╛
ЁЯПк => ЁЯПк, рмЙрмкрмпрнЛрмЧрнА рм╖рнНрмЯрнЛрм░рнНтАМ, рмЙрмкрмпрнЛрмЧрнА рмкрмжрм╛рм░рнНрме, рм╖рнНрмЯрнЛрм░рнНтАМ, рмЕрмЯрнНрмЯрм╛рм│рм┐рмХрм╛
ЁЯПл => ЁЯПл, рммрм┐рмжрнНрнЯрм╛рм│рнЯ, рммрм┐рмжрнНрнЯрм╛рм│рнЯ рмЕрмЯрнНрмЯрм╛рм│рм┐рмХрм╛, рмЕрмЯрнНрмЯрм╛рм│рм┐рмХрм╛
ЁЯПм => ЁЯПм, рммрм┐рмнрм╛рмЧрнАрнЯ рм╖рнНрмЯрнЛрм░рнНтАМ, рммрм┐рмнрм╛рмЧ, рм╖рнНрмЯрнЛрм░рнНтАМ
ЁЯПн => ЁЯПн, рмХрм╛рм░рмЦрм╛рмирм╛, рмЕрмЯрнНрмЯрм╛рм│рм┐рмХрм╛
ЁЯПп => ЁЯПп, рмЬрм╛рмкрм╛рмирнА рмжрнБрм░рнНрмЧ, рмжрнБрм░рнНрмЧ, рмЕрмЯрнНрмЯрм╛рм│рм┐рмХрм╛
ЁЯП░ => ЁЯП░, рнЯрнБрм░рнЛрмкрнАрнЯ рмжрнБрм░рнНрмЧ, рмжрнБрм░рнНрмЧ, рмЕрмЯрнНрмЯрм╛рм│рм┐рмХрм╛
ЁЯТТ => ЁЯТТ, рммрм┐рммрм╛рм╣ рммрнЗрмжрнА, рммрм┐рммрм╛рм╣, рммрнЗрмжрнА, рмкрнНрм░рмгрнЯ
ЁЯЧ╝ => ЁЯЧ╝, рмЯрнЛрмХрм┐рнЯрнЛ рмЯрм╛рн▒рм╛рм░рнН, рмЯрнЛрмХрм┐рнЯрнЛ, рмЯрм╛рн▒рм╛рм░рнН
ЁЯЧ╜ => ЁЯЧ╜, рм╖рнНрмЯрнЗрмЪрнНрнЯрнБ рмЕрмлрнН рм▓рм┐рммрм░рнНрмЯрм┐, рм╖рнНрмЯрнЗрмЪрнНрнЯрнБ, рм▓рм┐рммрм░рнНрмЯрм┐
ЁЯЧ╛ => ЁЯЧ╛, рморнНрнЯрм╛рмкрнН рмЕрмлрнН рмЬрм╛рмкрм╛рмирнН, рморнНрнЯрм╛рмкрнН, рмЬрм╛рмкрм╛рмирнН
тЫ▓ => тЫ▓, рмлрм╛рмЙрмгрнНрмЯрнЗрмирнН
тЫ║ => тЫ║, рмЯрнЗрмгрнНрмЯрнН, рм╢рм┐рммрм┐рм░
ЁЯМБ => ЁЯМБ, рмХрнБрм╣рнБрмбрм┐рмЖ, рмХрнБрм╣рнБрмбрм┐
ЁЯМГ => ЁЯМГ, рм░рм╛рмдрнНрм░ рмдрм╛рм░рм╛, рмдрм╛рм░рм╛, рм░рм╛рмдрм┐
ЁЯМД => ЁЯМД, рм╕рнВрм░рнНрмпрнНрнЯрмЙрмжрнЯ, рм╕рмЦрм╛рм│рнБрмЖ рм╕рнВрм░рнНрмпрнНрнЯ, рмкрм╛рм╣рм╛рмб рмЙрмкрм░рнЗ рм╕рнВрм░рнНрмпрнНрнЯрмЙрмжрнЯ, рмкрм╛рм╣рм╛рмб
ЁЯМЕ => ЁЯМЕ, рм╕рнВрм░рнНрмпрнНрнЯрмЙрмжрнЯ, рм╕рмЦрм╛рм│рнБрмЖ рм╕рнВрм░рнНрмпрнНрнЯ
ЁЯМЖ => ЁЯМЖ, рм╕рмирнНрмзрнНрнЯрм╛рмХрм╛рм│ рм╕рм╣рм░, рм╕рмирнНрмзрнНрнЯрм╛рмХрм╛рм│, рм╕рмирнНрмзрнНрнЯрм╛, рм╕рнВрм░рнНрмпрнНрнЯрм╛рм╕рнНрмд, рм╕рм╣рм░, рмХрнЛрмарм╛, рмормирнЛрм░рмо рмжрнГрм╢рнНрнЯ
ЁЯМЗ => ЁЯМЗ, рм╕рнВрм░рнНрмпрнНрнЯрм╛рм╕рнНрмд, рм╕рмирнНрмзрнНрнЯрм╛рмХрм╛рм│, рмХрнЛрмарм╛ рмЙрмкрм░рнЗ рм╕рнВрм░рнНрмпрнНрнЯрм╛рм╕рнНрмд, рмХрнЛрмарм╛
ЁЯМЙ => ЁЯМЙ, рм░рм╛рмдрнНрм░ рммрнНрм░рм┐рмЬрнН, рм░рм╛рмдрнНрм░рм░рнЗ рммрнНрм░рм┐рм░рнНрмЬрнН, рм░рм╛рмдрнНрм░
ЁЯММ => ЁЯММ, рмЖрмХрм╛рм╢рмЧрмЩрнНрмЧрм╛
ЁЯОа => ЁЯОа, рмШрнВрм░рнНрмгрнНрмгрмирм╢рнАрм│ рммрм╛рм╣рмХ рмпрмирнНрмдрнНрм░, рммрм╛рм╣рмХ рмШрнЛрмбрм╛, рмШрнЛрмбрм╛, рмормирнЛрм░рмЮрнНрмЬрми
ЁЯОб => ЁЯОб, рммрмб рмШрнВрм░рнНрмгрнНрмгрмирм╢рнАрм│ рмЪрмХ, рмШрнВрм░рнНрмгрнНрмгрмирм╢рнАрм│, рмЪрмХ, рмЖрморнЛрмж рмЙрмжрнНрнЯрм╛рми, рмормирнЛрм░рмЮрнНрмЬрми
ЁЯОв => ЁЯОв, рм░рнЛрм▓рм░рнНтАМ рмХрнЛрм╖рнНрмЯрм░рнНтАМ, рм░рнЛрм▓рм░рнНтАМ, рмЖрморнЛрмж рмЙрмжрнНрнЯрм╛рми, рмормирнЛрм░рмЮрнНрмЬрми
ЁЯТИ => ЁЯТИ, рммрм╛рм░рнНрммрм░рнНтАМ рм╢рмкрнНтАМ, рммрм╛рм░рнНрммрм░рнНтАМ рмкрнЛрм▓рнНтАМ, рммрм╛рм░рнНрммрм░рнНтАМ, рмкрнЛрм▓рнН
ЁЯОк => ЁЯОк, рм╕рм░рнНрмХрм╕тАМ, рм╕рм░рнНрмХрм╕тАМ рмдрморнНрммрнБ, рмдрморнНрммрнБ, рмормирнЛрм░рмЮрнНрмЬрми
ЁЯОн => ЁЯОн, рморнБрм╣рмБ рмЖрммрм░рмг, рмкрнНрм░рмжрм░рнНрм╢рми рмХрм│рм╛, рмХрм│рм╛, рмормирнЛрм░рмЮрнНрмЬрми, рмкрнНрм░рмжрм░рнНрм╢рми рмХрм░рм┐рммрм╛
ЁЯОи => ЁЯОи, рм░рмЩрнНрмЧ рм╢рмпрнНрнЯрм╛, рмХрм│рм╛рмХрм╛рм░ рм╢рмпрнНрнЯрм╛, рмЕрм╕рнНрмерм╛рнЯрнА рм╢рмпрнНрнЯрм╛, рмХрм│рм╛рмХрм╛рм░, рм░рмЩрнНрмЧ, рмХрм│рм╛
ЁЯО░ => ЁЯО░, рм╕рнНрм▓рмЯрнНтАМ рморнЗрм╕рм┐рмирнНтАМ, рм╕рнНрм▓рмЯрнНтАМ, рмЦрнЗрм│
ЁЯЪВ => ЁЯЪВ, рм╖рнНрмЯрм┐рморнН рм▓рнЛрмХрнЛрморнЛрмЯрм┐рмнрнН, рм▓рнЛрмХрнЛрморнЛрмЯрм┐рмнрнН, рмЯрнНрм░рнЗрмирнН, рммрм╛рм╣рм╛рми
ЁЯЪГ => ЁЯЪГ, рмЯрнНрм░рнЗрмирнН, рмЗрм▓рнЗрмХрнНрмЯрнНрм░рм┐рмХрнН рмЯрнНрм░рнЗрмирнН, рм░рнЗрм▓рн▒рнЗ рмХрм╛рм░рнН, рмЗрм▓рнЗрмХрнНрмЯрнНрм░рм┐рмХрнН, рм░рнЗрм▓рн▒рнЗ, рмЯрнНрм░рм╛рморнН, рммрм╛рм╣рм╛рми
ЁЯЪД => ЁЯЪД, рмЕрмзрм┐рмХ-рмЧрмдрм┐рм╢рнАрм│ рмЯрнНрм░рнЗрмирнН, рм╕рм┐рмВрмирмХрм╛рмирм╕рнЗрмирнН, рмЯрнНрм░рнЗрмирнН, рммрм╛рм╣рм╛рми
ЁЯЪЕ => ЁЯЪЕ, рмЕрмзрм┐рмХ-рмЧрмдрм┐рм╢рнАрм│ рмЯрнНрм░рнЗрмирнН, рммрнБрм▓рнЗрмЯрнН рмирнЛрмЬрнН, рм╕рм┐рмВрмирмХрм╛рмирм╕рнЗрмирнН рм╕рм╣рм┐рмд рммрнБрм▓рнЗрмЯрнН рмирнЛрмЬрнН, рм╕рм┐рмВрмирмХрм╛рмирм╕рнЗрмирнН, рмЯрнНрм░рнЗрмирнН, рммрм╛рм╣рм╛рми
ЁЯЪЖ => ЁЯЪЖ, рмЯрнНрм░рнЗрмирнН, рм░рнЗрм▓рн▒рнЗ, рммрм╛рм╣рм╛рми
ЁЯЪЗ => ЁЯЪЗ, рм╕рммрнНтАМрн▒рнЗ, рморнЗрмЯрнНрм░рнЛ, рммрм╛рм╣рм╛рми
ЁЯЪИ => ЁЯЪИ, рм▓рм╛рмЗрмЯрнН рм░рнЗрм│, рм▓рм╛рмЗрмЯрнН, рм░рнЗрм│, рммрм╛рм╣рм╛рми
ЁЯЪЙ => ЁЯЪЙ, рмЯрнНрм░рнЗрмирнН рм╖рнНрмЯрнЗрм╕рмирнН, рмЯрнНрм░рнЗрмирнН, рм╖рнНрмЯрнЗрм╕рмирнН
ЁЯЪК => ЁЯЪК, рмЯрнНрм░рм╛рморнН, рммрм╛рм╣рм╛рми
ЁЯЪЭ => ЁЯЪЭ, рморнЛрмирнЛрм░рнЗрм▓рнН, рммрм╛рм╣рм╛рми
ЁЯЪЮ => ЁЯЪЮ, рморм╛рмЙрмгрнНрмЯрнЗрмирнН рм░рнЗрм▓рн▒рнЗ, рморм╛рмЙрмгрнНрмЯрнЗрмирнН рмХрнЗрммрм▓рнН рмХрм╛рм░рнН, рморм╛рмЙрмгрнНрмЯрнЗрмирнН, рм░рнЗрм▓рн▒рнЗ, рмХрм╛рм░рнН, рммрм╛рм╣рм╛рми
ЁЯЪЛ => ЁЯЪЛ, рмЯрнНрм░рм╛рморнН рмХрм╛рм░рнН, рмЯрнНрм░рм╛рморнН, рмХрм╛рм░рнН, рммрм╛рм╣рм╛рми
ЁЯЪМ => ЁЯЪМ, рммрм╕рнН, рммрм╛рм╣рм╛рми
ЁЯЪН => ЁЯЪН, рмЖрм╕рнБрмерм┐рммрм╛ рммрм╕рнН, рммрм╕рнН, рмЖрм╕рнБрмерм┐рммрм╛, рммрм╛рм╣рм╛рми
ЁЯЪО => ЁЯЪО, рмЯрнНрм░рнЛрм▓рм┐ рммрм╕рнН, рммрм╕рнН, рмЯрнНрм░рнЛрм▓рм┐, рммрм╛рм╣рм╛рми
ЁЯЪП => ЁЯЪП, рммрм╕рнН рм╖рнНрмЯрмкрнН, рм╖рнНрмЯрмкрнН, рммрм╕рнН
ЁЯЪР => ЁЯЪР, рморм┐рмирм┐ рммрм╕рнН, рммрм╕рнН, рммрм╛рм╣рм╛рми
ЁЯЪС => ЁЯЪС, рмЖрморнНрм╡рнБрм▓рнЗрмирнНрм╕, рммрм╛рм╣рм╛рми
ЁЯЪТ => ЁЯЪТ, рмлрм╛рнЯрм╛рм░рнН рмЗрмЮрнНрмЬрм┐рмирнН, рмлрм╛рнЯрм╛рм░рнН рмЯрнНрм░рмХрнН, рмлрм╛рнЯрм╛рм░рнН, рмЗрмЮрнНрмЬрм┐рмирнН, рммрм╛рм╣рм╛рми
ЁЯЪУ => ЁЯЪУ, рмкрнЛрм▓рм┐рм╕рнН рмХрм╛рм░рнН, рмкрнЗрмЯрнНрм░рнЛрм▓рнН рмХрм╛рм░рнН, рмкрнЛрм▓рм┐рм╕рнН, рммрм╛рм╣рм╛рми
ЁЯЪФ => ЁЯЪФ, рмЖрм╕рм┐рммрм╛рмХрнБрмерм┐рммрм╛ рмкрнЛрм▓рм┐рм╕рнН рмХрм╛рм░рнН, рмкрнЛрм▓рм┐рм╕рнН рмХрм╛рм░рнН, рмкрнЛрм▓рм┐рм╕рнН, рммрм╛рм╣рм╛рми
ЁЯЪХ => ЁЯЪХ, рмЯрнЗрмХрнНрм╕рм┐, рммрм╛рм╣рм╛рми
ЁЯЪЦ => ЁЯЪЦ, рмЖрм╕рм┐рммрм╛рмХрнБрмерм┐рммрм╛ рмЯрнЗрмХрнНрм╕рм┐, рмЯрнЗрмХрнНрм╕рм┐, рммрм╛рм╣рм╛рми
ЁЯЪЧ => ЁЯЪЧ, рмХрм╛рм░рнН, рмЕрмЯрнЛрморнЛрммрм╛рмЗрм▓рнН, рммрм╛рм╣рм╛рми
ЁЯЪШ => ЁЯЪШ, рмЖрм╕рм┐рммрм╛рмХрнБрмерм┐рммрм╛ рмХрм╛рм░рнН, рмЖрм╕рм┐рммрм╛рмХрнБрмерм┐рммрм╛ рмЕрмЯрнЛрморнЛрммрм╛рмЗрм▓рнН, рмХрм╛рм░рнН, рмЕрмЯрнЛрморнЛрммрм╛рмЗрм▓рнН, рмЖрм╕рм┐рммрм╛рмХрнБрмерм┐рммрм╛, рммрм╛рм╣рм╛рми
ЁЯЪЩ => ЁЯЪЩ, рмЖрм░рнНтАМрмнрм┐, рмкрнБрмирмГрм╕рнГрм╖рнНрмЯрм┐рмЬрмирм┐рмд рммрм╛рм╣рм╛рми, рмХрм╛рм░рнН, рммрм╛рм╣рм╛рми
ЁЯЪЪ => ЁЯЪЪ, рмбрнЗрм▓рм┐рмнрнЗрм░рм┐ рмЯрнНрм░рмХрнН, рмЯрнНрм░рмХрнН, рммрм╛рм╣рм╛рми
ЁЯЪЫ => ЁЯЪЫ, рм▓рм░рм┐, рм╕рнЗрморм┐, рмпрнЛрмбрм┐ рм╣рнЛрмЗрмерм┐рммрм╛ рм▓рм░рм┐, рмЯрнНрм░рмХрнН, рмЯрнНрм░рм▓рм░рнН, рммрм╛рм╣рм╛рми
ЁЯЪЬ => ЁЯЪЬ, рмЯрнНрм░рм╛рмХрнНрмЯрм░рнН, рммрм╛рм╣рм╛рми
ЁЯЪ▓ => ЁЯЪ▓, рммрм╛рмЗрмХрнН, рммрм╛рмЗрм╕рм╛рмЗрмХрнЗрм▓рнН, рммрм╛рм╣рм╛рми
тЫ╜ => тЫ╜, рмЧрнНрнЯрм╛рм╕рнН рм╖рнНрмЯрнЗрм╕рмирнН, рмлрм┐рнЯрнБрмПрм▓рнН рмкрморнНрмкрнН, рмлрм┐рнЯрнБрмПрм▓рнН, рмЧрнНрнЯрм╛рм╕рнН, рм╖рнНрмЯрнЗрм╕рмирнН
ЁЯЪи => ЁЯЪи, рм▓рм╛рм▓рнН рммрмдрм┐, рмкрнЛрм▓рм┐рм╕рнН рм▓рм╛рмЗрмЯрнН, рмкрнЛрм▓рм┐рм╕рнН рммрм┐рмХрнЛрмирнН, рмкрнЛрм▓рм┐рм╕рнН рмХрм╛рм░рнН
ЁЯЪе => ЁЯЪе, рмЯрнНрм░рм╛рмлрм┐рмХрнН рм▓рм╛рмЗрмЯрнН, рмнрнВрм╕рморм╛рмирнНрмдрм░ рмЯрнНрм░рм╛рмлрм┐рмХрнН рм▓рм╛рмЗрмЯрнН, рмЯрнНрм░рм╛рмлрм┐рмХрнН рм╕рм┐рмЧрнНтАМрмирм╛рм▓рнН, рм▓рм╛рмЗрмЯрнН, рмЯрнНрм░рм╛рмлрм┐рмХрнН
ЁЯЪж => ЁЯЪж, рмЯрнНрм░рм╛рмлрм┐рмХрнН рм▓рм╛рмЗрмЯрнН, рмнрнВрм▓рморнНрм╡ рмЯрнНрм░рм╛рмлрм┐рмХрнН рм▓рм╛рмЗрмЯрнН, рмЯрнНрм░рм╛рмлрм┐рмХрнН рм╕рм┐рмЧрнНтАМрмирм╛рм▓рнН, рм▓рм╛рмЗрмЯрнН, рмЯрнНрм░рм╛рмлрм┐рмХрнН
ЁЯЪз => ЁЯЪз, рмирм┐рм░рнНрморм╛рмгрмзрм┐рми, рмирм┐рм░рнНрморм╛рмг рмЪрм┐рм╣рнНрми, рмирм┐рм░рнНрморм╛рмг, рмЪрм┐рм╣рнНрми
тЪУ => тЪУ, рмПрмЩрнНрмХрм░рнН, рмЪрм┐рм╣рнНрми
тЫ╡ => тЫ╡, рмкрм╛рм▓ рмЯрмгрм╛ рмбрмЩрнНрмЧрм╛, рмбрмЩрнНрмЧрм╛, рмирнМрмХрм╛, рм╕рморнБрмжрнНрм░ рм░рм┐рм╕рм░рнНрмЯрнН, рм░рм┐рм╕рм░рнНрмЯрнН
ЁЯЪг => ЁЯЪг, рм░рнЛрммрнЛрмЯрнН, рммрнЛрмЯрнН, рммрм╛рм╣рм╛рми
ЁЯЪд => ЁЯЪд, рм╕рнНрмкрм┐рмбрнНтАМрммрнЛрмЯрнН, рммрнЛрмЯрнН, рммрм╛рм╣рм╛рми
ЁЯЪв => ЁЯЪв, рм╕рм┐рмкрнН, рммрм╛рм╣рм╛рми
ЁЯТ║ => ЁЯТ║, рм╕рм┐рмЯрнН, рмЪрнЗрнЯрм╛рм░рнН
ЁЯЪБ => ЁЯЪБ, рм╣рнЗрм▓рм┐рмХрнЗрмкрнНрмЯрм░рнН, рммрм╛рм╣рм╛рми
ЁЯЪЯ => ЁЯЪЯ, рм╕рм╕рнНтАМрмкрнЗрмирнНтАМрм╕рмирнН рм░рнЗрм▓рн▒рнЗ, рм░рнЗрм▓рн▒рнЗ, рм╕рм╕рнНтАМрмкрнЗрмирнНтАМрм╕рмирнН, рммрм╛рм╣рм╛рми
ЁЯЪа => ЁЯЪа, рморм╛рмЙрмгрнНрмЯрнЗрмирнН рмХрнЗрммрм▓рнНтАМрн▒рнЗ, рморм╛рмЙрмгрнНрмЯрнЗрмирнН рмХрнЗрммрнБрм▓рнН рмХрм╛рм░рнН, рмХрнЗрммрнБрм▓рнН, рмХрм╛рм░рнН, рморм╛рмЙрмгрнНрмЯрнЗрмирнН, рммрм╛рм╣рм╛рми
ЁЯЪб => ЁЯЪб, рмХрнЗрммрнБрм▓рнН рмХрм╛рм░рнН, рмПрм░рм┐рмПрм▓рнН рмЯрнНрм░рм╛рморнНтАМрн▒рнЗ, рм░рнЛрмкрн▒рнЗ, рмПрм░рм┐рмПрм▓рнН, рмЯрнНрм░рм╛рморнНтАМрн▒рнЗ, рмЧрнЛрмирмбрнЛрм▓рм╛, рммрм╛рм╣рм╛рми
ЁЯЪА => ЁЯЪА, рм░рмХрнЗрмЯрнН, рммрм╛рм╣рм╛рми
ЁЯЪк => ЁЯЪк, рмжрнНрм╡рм╛рм░
ЁЯЪ╜ => ЁЯЪ╜, рмЯрмПрм▓рнЗрмЯрнН
ЁЯЪ┐ => ЁЯЪ┐, рм╕рм╛рн▒рм╛рм░рнН
ЁЯЫА => ЁЯЫА, рм╕рнНрмирм╛рми
ЁЯЫБ => ЁЯЫБ, рммрм╛рмернНтАМрмЯрммрнН
тМЫ => тМЫ, рмЖрн▒рм╛рм░рнНтАМрмЧрнНрм▓рм╛рм╕рнН, рммрм╛рм▓рм┐
тП│ => тП│, рм╕рнЗрмгрнНрмбрнН рмЯрм╛рмЗрморм░рнН, рм╕рнЗрмгрнНрмбрнН рм╣рм╛рн▒рм╛рм░рнНтАМрмЧрнНрм▓рм╛рм╕рнН, рм╣рм╛рн▒рм╛рм░рнНтАМрмЧрнНрм▓рм╛рм╕рнН, рмЯрм╛рмЗрморм░рнН
тМЪ => тМЪ, рмШрмгрнНрмЯрм╛, рмШрмбрм┐
тП░ => тП░, рмЖрм▓рнНтАМрм░рм╛рморнН рмШрмгрнНрмЯрм╛, рмЖрм▓рнНтАМрм░рм╛рморнН, рмШрмгрнНрмЯрм╛
ЁЯХЫ => ЁЯХЫ, 12 рмШрмЯрм┐рмХрм╛, рмШрмгрнНрмЯрм╛, рммрм╛рм░, 12:00
ЁЯХз => ЁЯХз, рммрм╛рм░рмЯрм╛-рмдрм┐рм░рм┐рм╢рм┐, рмШрмгрнНрмЯрм╛, 12:30
ЁЯХР => ЁЯХР, 1 рмШрмЯрм┐рмХрм╛, рмШрмгрнНрмЯрм╛, рмПрмХ, 1:00
ЁЯХЬ => ЁЯХЬ, рмПрмХ-рмдрм┐рм░рм┐рм╢рм┐, рмШрмгрнНрмЯрм╛, 1:30
ЁЯХС => ЁЯХС, 2 рмШрмЯрм┐рмХрм╛, рмШрмгрнНрмЯрм╛, рмжрнБрмЗ, 2:00
ЁЯХЭ => ЁЯХЭ, рмжрнБрмЗрмЯрм╛-рмдрм┐рм░рм┐рм╢рм┐, рмШрмгрнНрмЯрм╛, 2:30
ЁЯХТ => ЁЯХТ, 3 рмШрмЯрм┐рмХрм╛, рмШрмгрнНрмЯрм╛, рмдрм┐рмирм┐, 3:00
ЁЯХЮ => ЁЯХЮ, рмдрм┐рмирм┐рмЯрм╛-рмдрм┐рм░рм┐рм╢рм┐, рмШрмгрнНрмЯрм╛, 3:30
ЁЯХУ => ЁЯХУ, 4 рмШрмЯрм┐рмХрм╛, рмШрмгрнНрмЯрм╛, рмЪрм╛рм░рм┐, 4:00
ЁЯХЯ => ЁЯХЯ, рмЪрм╛рм░рм┐рмЯрм╛-рмдрм┐рм░рм┐рм╢рм┐, рмШрмгрнНрмЯрм╛, 4:30
ЁЯХФ => ЁЯХФ, 5 рмШрмЯрм┐рмХрм╛, рмШрмгрнНрмЯрм╛, рмкрм╛рмЮрнНрмЪ, 5:00
ЁЯХа => ЁЯХа, рмкрм╛рмЮрнНрмЪрмЯрм╛-рмдрм┐рм░рм┐рм╢рм┐, рмШрмгрнНрмЯрм╛, 5:30
ЁЯХХ => ЁЯХХ, 6 рмШрмЯрм┐рмХрм╛, рмШрмгрнНрмЯрм╛, рмЫрмЕ, 6:00
ЁЯХб => ЁЯХб, рмЫрмЕрмЯрм╛-рмдрм┐рм░рм┐рм╢рм┐, рмШрмгрнНрмЯрм╛, 6:30
ЁЯХЦ => ЁЯХЦ, 7 рмШрмЯрм┐рмХрм╛, рмШрмгрнНрмЯрм╛, рм╕рм╛рмд, 7:00
ЁЯХв => ЁЯХв, рм╕рм╛рмдрмЯрм╛-рмдрм┐рм░рм┐рм╢рм┐, рмШрмгрнНрмЯрм╛, 7:30
ЁЯХЧ => ЁЯХЧ, 8 рмШрмЯрм┐рмХрм╛, рмШрмгрнНрмЯрм╛, рмЖрма, 8:00
ЁЯХг => ЁЯХг, рмЖрмармЯрм╛-рмдрм┐рм░рм┐рм╢рм┐, рмШрмгрнНрмЯрм╛, 8:30
ЁЯХШ => ЁЯХШ, 9 рмШрмЯрм┐рмХрм╛, рмШрмгрнНрмЯрм╛, рмирмЕ, 9:00
ЁЯХд => ЁЯХд, рмирмЕрмЯрм╛-рмдрм┐рм░рм┐рм╢рм┐, рмШрмгрнНрмЯрм╛, 9:30
ЁЯХЩ => ЁЯХЩ, 10 рмШрмЯрм┐рмХрм╛, рмШрмгрнНрмЯрм╛, рмжрм╢, 10:00
ЁЯХе => ЁЯХе, рмжрм╢рмЯрм╛-рмдрм┐рм░рм┐рм╢рм┐, рмШрмгрнНрмЯрм╛, 10:30
ЁЯХЪ => ЁЯХЪ, 11 рмШрмЯрм┐рмХрм╛, рмШрмгрнНрмЯрм╛, рмПрмЧрм╛рм░, 11:00
ЁЯХж => ЁЯХж, рмПрмЧрм╛рм░рмЯрм╛-рмдрм┐рм░рм┐рм╢рм┐, рмШрмгрнНрмЯрм╛, 11:30
ЁЯМС => ЁЯМС, рмЕрморммрм╛рм╕рнНрнЯрм╛, рмЧрм╛рмв, рмирнВрмдрми, рмЪрмирнНрмжрнНрм░
ЁЯМТ => ЁЯМТ, рмЕрмкрнВрм░рнНрмгрнНрмгрмЪрмирнНрмжрнНрм░, рммрмврмирнНрмдрм╛ рмЪрмирнНрмжрнНрм░, рммрмврмирнНрмдрм╛, рмЪрмирнНрмжрнНрм░
ЁЯМУ => ЁЯМУ, рмЕрм░рнНрмжрнНрмз рмЪрмирнНрмжрнНрм░, рмкрнНрм░рмермо рмЕрм░рнНрмжрнНрмз рмЪрмирнНрмжрнНрм░, рмЪрмирнНрмжрнНрм░
ЁЯМФ => ЁЯМФ, рм╢рнБрмХрнНрм│рмкрмХрнНрм╖ рммрмврмирнНрмдрм╛ рмЪрмирнНрмжрнНрм░, рммрмврмирнНрмдрм╛, рмЕрм░рнНрмжрнНрмзрм░рнБ рмЕрмзрм┐рмХ рмЪрмирнНрмжрнНрм░, рмЕрм░рнНрмжрнНрмзрм░рнБ рмЕрмзрм┐рмХ, рмЪрмирнНрмжрнНрм░
ЁЯМХ => ЁЯМХ, рмкрнВрм░рнНрмгрнНрмгрм┐рморм╛, рмкрнВрм░рнНрмгрнНрмг, рмкрнВрм░рнНрмгрнНрмг рмЪрмирнНрмжрнНрм░, рмЙрмЬрнНрм╡рм│, рмЪрмирнНрмжрнНрм░
ЁЯМЦ => ЁЯМЦ, рморм│рм┐рми рмЪрмирнНрмжрнНрм░, рморм│рм┐рми, рмЕрм░рнНрмжрнНрмзрм░рнБ рмЕрмзрм┐рмХ рмЪрмирнНрмжрнНрм░, рмЕрм░рнНрмжрнНрмзрм░рнБ рмЕрмзрм┐рмХ, рмЪрмирнНрмжрнНрм░
ЁЯМЧ => ЁЯМЧ, рмЕрм░рнНрмжрнНрмз рмЪрмирнНрмжрнНрм░, рмХрнГрм╖рнНрмгрмкрмХрнНрм╖ рмЪрмирнНрмжрнНрм░, рмЪрмирнНрмжрнНрм░
ЁЯМШ => ЁЯМШ, рмЕрмкрнВрм░рнНрмгрнНрмгрмЪрмирнНрмжрнНрм░, рмЕрмкрнВрм░рнНрмгрнНрмг, рморм│рм┐рми рмЪрмирнНрмжрнНрм░, рморм│рм┐рми, рмЪрмирнНрмжрнНрм░
ЁЯМЩ => ЁЯМЩ, рмЕрмкрнВрм░рнНрмгрнНрмгрмЪрмирнНрмжрнНрм░, рмЕрмкрнВрм░рнНрмгрнНрмг, рмЪрмирнНрмжрнНрм░
ЁЯМЪ => ЁЯМЪ, рмЕрморм╛рммрм╛рм╕рнНрнЯрм╛ рморнБрмЦ, рмЕрморм╛рммрм╛рм╕рнНрнЯрм╛, рморнБрмЦ рм╕рм╣рм┐рмд рмЕрморм╛рммрм╛рм╕рнНрнЯрм╛, рмЪрмирнНрмжрнНрм░, рморнБрмЦ
ЁЯМЫ => ЁЯМЫ, рмЕрм░рнНрмжрнНрмз рмЪрмирнНрмжрнНрм░ рморнБрмЦ, рморнБрмЦ рм╕рм╣рм┐рмд рмЕрм░рнНрмжрнНрмз рмЪрмирнНрмжрнНрм░, рморнБрмЦ рм╕рм╣рм┐рмд рмЪрмирнНрмжрнНрм░, рмкрнНрм░рмермо рмЕрм░рнНрмжрнНрмз рмЪрмирнНрмжрнНрм░, рмЕрм░рнНрмжрнНрмз рмЪрмирнНрмжрнНрм░, рмЪрмирнНрмжрнНрм░, рморнБрмЦ
ЁЯМЬ => ЁЯМЬ, рмЕрм░рнНрмжрнНрмз рмЪрмирнНрмжрнНрм░ рморнБрмЦ, рморнБрмЦ рм╕рм╣рм┐рмд рмЕрм░рнНрмжрнНрмз рмЪрмирнНрмжрнНрм░, рморнБрмЦ рм╕рм╣рм┐рмд рмЪрмирнНрмжрнНрм░, рм╢рнЗрм╖ рмЕрм░рнНрмжрнНрмз рмЪрмирнНрмжрнНрм░, рмЕрм░рнНрмжрнНрмз рмЪрмирнНрмжрнНрм░, рмЪрмирнНрмжрнНрм░, рморнБрмЦ
ЁЯМЭ => ЁЯМЭ, рмкрнВрм░рнНрмгрнНрмгрм┐рморм╛ рморнБрмЦ, рморнБрмЦ рм╕рм╣рм┐рмд рмкрнВрм░рнНрмгрнНрмгрм┐рморм╛, рморнБрмЦ рм╕рм╣рм┐рмд рмЪрмирнНрмжрнНрм░, рмкрнВрм░рнНрмгрнНрмгрм┐рморм╛, рмкрнВрм░рнНрмгрнНрмг, рмЪрмирнНрмжрнНрм░, рморнБрмЦ
ЁЯМЮ => ЁЯМЮ, рм╕рнВрм░рнНрмпрнНрнЯ рморнБрмЦ, рм╕рнВрм░рнНрмпрнНрнЯ, рморнБрмЦ
ЁЯМЯ => ЁЯМЯ, рмЪрмормХрнБрмерм┐рммрм╛ рмдрм╛рм░рм╛, рмЪрмормХрнБрмерм┐рммрм╛, рмЪрмормХ, рмдрм╛рм░рм╛
ЁЯМа => ЁЯМа, рмЙрм▓рмХрм╛рмдрм╛рм░рм╛, рмЙрм▓рмХрм╛, рмЙрм▓рмХрм╛ рмдрм╛рм░рм╛, рмдрм╛рм░рм╛
тШБ => тШБ, рморнЗрмШ, рмкрм╛рмгрм┐рмкрм╛рмЧ
тЫЕ => тЫЕ, рморнЗрмШ рмкрмЫрм░рнЗ рм╕рнВрм░рнНрмпрнНрнЯ, рм╕рнВрм░рнНрмпрнНрнЯ рм╕рм╣рм┐рмд рморнЗрмШ, рм╕рнВрм░рнНрмпрнНрнЯ, рморнЗрмШ
ЁЯМА => ЁЯМА, рмдрнЛрмлрм╛рми, рмЯрм╛рмЗрмлрнЛрмирнН, рмШрнВрм░рнНрмгрнНрмгрм┐рммрм╛рнЯрнБ, рммрм╛рнЯрнБ рмШрнБрм░рнНрмгрнНрмгрми
ЁЯМИ => ЁЯМИ, рмЗрмирнНрмжрнНрм░рмзрмирнБ
ЁЯМВ => ЁЯМВ, рмЫрмдрм╛, рммрм░рнНрм╖рм╛, рммрм░рнНрм╖рм╛ рмжрм┐рмирм┐рмЖ
тЪб => тЪб, рмЙрмЪрнНрмЪ рмнрнЛрм▓рмЯрнЗрмЬрнН, рмЙрмЪрнНрмЪ рмнрнЛрм▓рмЯрнЗрмЬрнН рммрм┐рмкрмжрмдрм╛, рмЙрмЪрнНрмЪ рмнрнЛрм▓рмЯрнЗрмЬрнН рмЪрм┐рм╣рнНрми, рммрм┐рмкрмж, рмЙрмЪрнНрмЪ, рмнрнЛрм▓рмЯрнЗрмЬрнН, рмЪрм┐рм╣рнНрми
тЫД => тЫД, рм╕рнНрмирнЛрморнЗрмирнН, рммрм░рмл рммрм┐рмирм╛ рм╕рнНрмирнЛрморнЗрмирнН, рммрм░рмл
ЁЯФе => ЁЯФе, рмирм┐рмЖрмБ, рмЭрм╛рм╕
ЁЯТз => ЁЯТз, рмермгрнНрмбрм╛ рмЭрм╛рм│, рмЭрм╛рм│, рмЭрм╛рм│ рммрнЛрм╣рм┐рммрм╛, рмХрморм┐рмХрнН
ЁЯМК => ЁЯМК, рм▓рм╣рмбрм┐, рм╕рм╛рмЧрм░ рм▓рм╣рмбрм┐, рмкрм╛рмгрм┐ рм▓рм╣рмбрм┐
ЁЯОГ => ЁЯОГ, рмЬрнНрнЯрм╛рмХрнНтАМ-рмУ-рм▓рмгрнНрмарми, рм▓рмгрнНрмарми, рм╣рм╛рм▓рнНрм▓рнЛрн▒рм┐рмирнНтАМ, рмХрмЦрм╛рм░рнБ, рмЙрмдрнНрм╕рмм
ЁЯОД => ЁЯОД, рмЦрнНрм░рнАрм╖рнНрмарморм╛рм╕ рммрнГрмХрнНрм╖, рммрнГрмХрнНрм╖, рмЙрмдрнНрм╕рмм
ЁЯОЖ => ЁЯОЖ, рмЖрмдрм╕рммрм╛рмЬрнА, рмЙрмдрнНрм╕рмм
ЁЯОЗ => ЁЯОЗ, рмЭрнБрм░рнНтАМтАМрмЭрнБрм░рнА рммрм╛рмг, рмЖрмдрм╕рммрм╛рмЬрнА, рмЖрмдрм╕рммрм╛рмЬрнА рмЪрмормХ, рмЙрмдрнНрм╕рмм
тЬи => тЬи, рмЪрмормХрм┐рммрм╛, рмЪрмормХрм┐рм▓рм╛ рмдрм╛рм░рм╛, рмдрм╛рм░рм╛
ЁЯОИ => ЁЯОИ, рммрнЗрм▓рнБрмирнНтАМ, рмЙрмдрнНрм╕рмм
ЁЯОЙ => ЁЯОЙ, рмкрм╛рм░рнНрмЯрм┐ рмкрмкрм░рнНтАМ, рмкрм╛рм░рнНрмЯрм┐, рмкрмкрм░рнНтАМ, рмЙрмдрнНрм╕рмм
ЁЯОК => ЁЯОК, рмХрмирмлрнЗрмЯрм┐, рмХрмирмлрнЗрмЯрм┐ рммрм▓рнНтАМ, рммрм▓рнНтАМ, рмЙрмдрнНрм╕рмм
ЁЯОЛ => ЁЯОЛ, рмЧрмЫ рмПрммрмВ рмХрм╛рмЧрмЬ рмкрмЯрм┐, рм╖рнНрмЯрм╛рм░рнНтАМ рмЙрмдрнНрм╕рмм, рмЧрмЫ, рмХрм╛рмЧрмЬ рмкрмЯрм┐, рмЙрмдрнНрм╕рмм
ЁЯОМ => ЁЯОМ, рмЫрмХрм┐ рмпрнБрмХрнНрмд рмкрмдрм╛рмХрм╛, рмЬрм╛рмкрм╛рмирм░ рмЫрмХрм┐ рмпрнБрмХрнНрмд рмкрмдрм╛рмХрм╛, рмЫрмХрм┐ рмпрнБрмХрнНрмд, рмкрмдрм╛рмХрм╛рмЧрнБрмбрм┐рмХ, рмЙрмдрнНрм╕рмм
ЁЯОН => ЁЯОН, рмкрм╛рмЗрмирнНтАМ рм╕рм╛рмЬрм╕рмЬрнНрмЬрм╛, рмирнВрмЖ рммрм░рнНрм╖, рмЬрм╛рмкрм╛рмирнА, рмкрм╛рмЗрмирнНтАМ, рмЙрмдрнНрм╕рмм
ЁЯОО => ЁЯОО, рмХрмгрнНрмврнЗрмЗрмЧрнБрмбрм┐рмХ, рмХрмгрнНрмврнЗрмЗ рмЙрмдрнНрм╕рмм, рмЙрмдрнНрм╕рмм, рмЬрм╛рмкрм╛рмирнА
ЁЯОП => ЁЯОП, рмХрм╛рм░рнНрмкрнНтАМ рм╖рнНрмЯрнНрм░рм┐рморм░рнНтАМ, рм╖рнНрмЯрнНрм░рм┐рморм░рнНтАМ, рмЙрмдрнНрм╕рмм
ЁЯОР => ЁЯОР, рмкрммрми рмЭрмЩрнНрмХрм╛рм░, рмЭрмЩрнНрмХрм╛рм░
ЁЯОС => ЁЯОС, рмЪрмирнНрмжрнНрм░ рмжрм░рнНрм╢рми, рмХрнБрморм╛рм░ рмкрнВрм░рнНрмгрнНрмгрм┐рморм╛, рмЪрмирнНрмжрнНрм░, рмжрм░рнНрм╢рми, рмЙрмдрнНрм╕рмм
ЁЯОА => ЁЯОА, рм░рнЗрм╢рмо рмлрм┐рмдрм╛, рмЙрмдрнНрм╕рмм
ЁЯОБ => ЁЯОБ, рмЙрмкрм╣рм╛рм░, рмЧрнБрмбрм╛ рм╣рнЛрмЗрмерм┐рммрм╛ рмЙрмкрм╣рм╛рм░, рмЧрнБрмбрм╛ рм╣рнЛрмЗрмЫрм┐, рмЙрмдрнНрм╕рмм
ЁЯОл => ЁЯОл, рмЯрм┐рмХрнЗрмЯрнНтАМ, рмормирнЛрм░рмЮрнНрмЬрми
тЪ╜ => тЪ╜, рм╕рнЛрмХрм░рнН рммрм▓рнН, рм╕рнЛрмХрм░рнН, рммрм▓рнН
тЪ╛ => тЪ╛, рммрнЗрм╕рнНтАМрммрм▓рнН
ЁЯПА => ЁЯПА, рммрм╛рм╕рнНрмХрнЗрмЯрммрм▓, рммрм╛рм╕рнНрмХрнЗрмЯрммрм▓ рмЦрнЗрм│рм░ рмЧрнЛрм▓рм╛рмХрм╛рм░ рмкрмЯрм┐, рммрм▓рнНтАМ, рмЧрнЛрм▓рм╛рмХрм╛рм░ рмкрмЯрм┐, рмХрнНрм░рнАрмбрм╛
ЁЯПИ => ЁЯПИ, рмЖрморнЗрм░рм┐рмХрнАрнЯ рмлрнБрмЯрммрм▓рнНтАМ, рмЖрморнЗрм░рм┐рмХрнАрнЯ, рммрм▓рнНтАМ, рмХрнНрм░рнАрмбрм╛
ЁЯПЙ => ЁЯПЙ, рмлрнБрмЯрммрм▓, рм╕рмХрм░рнНтАМ рммрм▓рнНтАМ, рммрм▓рнНтАМ, рмХрнНрм░рнАрмбрм╛
ЁЯО╛ => ЁЯО╛, рмЯрнЗрмирм┐рм╕рнНтАМ, рмЯрнЗрмирм┐рм╕рнНтАМ рммрм▓рнНтАМ, рмЯрнЗрмирм┐рм╕рнНтАМ рм░рнЗрмХрнЗрмЯрнНтАМ рмПрммрмВ рммрм▓рнНтАМ, рмХрнНрм░рнАрмбрм╛
ЁЯО▒ => ЁЯО▒, рммрм┐рм▓рм┐рнЯрм╛рм░рнНрмб, рмЖрмарнЛрмЯрм┐ рммрм▓рнНтАМ, рмЦрнЗрм│
ЁЯО│ => ЁЯО│, рмлрм┐рмЩрнНрмЧрм┐рммрм╛, рмлрм┐рмЩрнНрмЧрм╛ рммрм▓рнНтАМ, рммрм▓рнНтАМ, рмЦрнЗрм│
тЫ│ => тЫ│, рмЧрм╛рмдрм░рнЗ рмкрмдрм╛рмХрм╛, рмЧрм▓рнНрмл, рмЧрм▓рнНрмл рмкрмдрм╛рмХрм╛, рмЧрм╛рмд
ЁЯОг => ЁЯОг, рморм╛рмЫ рмзрм░рм┐рммрм╛, рморм╛рмЫ рмзрм░рм┐рммрм╛ рмкрм╛рмЗрмБ рмЦрморнНрмм, рморм╛рмЫ, рмЦрморнНрмм, рмЪрм┐рмдрнНрмдрммрм┐рмирнЛрмжрми, рмормирнЛрм░рмЮрнНрмЬрми
ЁЯО╜ => ЁЯО╜, рм░рмирм┐рмВ рм╕рм╛рм░рнНрмЯтАМ, рм╕рнНрнЯрм╛рм╢рнНтАМ рм╕рм╣рм┐рмд рм░рмирм┐рмВ рм╕рм╛рм░рнНрмЯ, рмЪрм│рморм╛рми, рм╕рм╛рм░рнНрмЯ, рм╕рнНрнЯрм╛рм╢рнНтАМ, рмХрнНрм░рнАрмбрм╛
ЁЯО┐ => ЁЯО┐, рм╕рнНрмХрм╛рмЗ, рм╕рнНрмХрм╛рмЗ рмПрммрмВ рммрнБрмЯрнНтАМ, рммрнБрмЯрнН, рмХрнНрм░рнАрмбрм╛
ЁЯПВ => ЁЯПВ, рммрм░рмлрм░рнЗ рммрм╕рммрм╛рм╕ рмХрм░рнБрмерм┐рммрм╛ рммрнНрнЯрмХрнНрмдрм┐, рммрм░рмл рммрм╛рм╕рм╕рнНрмерм╛рми, рммрм░рмлрм╛рммрнГрмд, рмХрнНрм░рнАрмбрм╛
ЁЯПД => ЁЯПД, рмврнЗрмЙ рмнрм╛рмЩрнНрмЧрм┐рммрм╛, рмврнЗрмЙ рмнрм╛рмЩрнНрмЧрнБрмерм┐рммрм╛ рммрнНрнЯрмХрнНрмдрм┐, рмХрнНрм░рнАрмбрм╛
ЁЯПЗ => ЁЯПЗ, рмШрнЛрмбрм╛ рмжрнМрмб, рмжрнМрмб рмШрнЛрмбрм╛, рмЬрмХрм┐, рмжрнМрмб, рмШрнЛрмбрм╛, рмХрнНрм░рнАрмбрм╛
ЁЯПК => ЁЯПК, рм╕рмирнНрмдрм░рмгрмХрм╛рм░рнА, рм╕рмирнНрмдрм░рмг, рмкрм╣рмБрм░рм┐рммрм╛, рмХрнНрм░рнАрмбрм╛
ЁЯЪ┤ => ЁЯЪ┤, рм╕рм╛рмЗрмХрнЗрм▓рнН рмЪрм╛рм│рмХ, рммрм╛рмЗрмХрнН
ЁЯЪ╡ => ЁЯЪ╡, рмкрм╛рм░рнНрммрмдрнНрнЯ рм╕рм╛рмЗрмХрнЗрм▓рнН рмЪрм╛рм│рмХ, рммрм╛рмЗрмХрнН, рм╕рм╛рмЗрмХрнЗрм▓рнН рмЪрм╛рм│рмХ, рмкрм░рнНрммрмд
ЁЯПЖ => ЁЯПЖ, рмЯрнНрм░рмлрм┐, рмкрнБрм░рм╕рнНрмХрм╛рм░
ЁЯОп => ЁЯОп, рм▓рмХрнНрм╖рнНрнЯрм╕рнНрмерм│рм░ рмХрнЗрмирнНрмжрнНрм░, рм╕рм┐рмзрм╛рм╕рм│рмЦ рммрм╛рмЬрм┐рммрм╛, рмарм┐рмХрнНтАМ рм▓рмХрнНрм╖рнНрнЯрм╕рнНрмерм│рм░рнЗ, рм▓рмХрнНрм╖рнНрнЯрм╕рнНрмерм│, рммрм╛рмЬрм┐рммрм╛, рмЦрнЗрм│
ЁЯОо => ЁЯОо, рмнрм┐рмбрм┐рмУ рмЧрнЗрморнНтАМ, рмЦрнЗрм│ рмирм┐рнЯрмирнНрмдрнНрм░рмХ, рмирм┐рнЯрмирнНрмдрнНрм░рмХ, рмЦрнЗрм│
ЁЯО▓ => ЁЯО▓, рм▓рнБрмбрнБ, рморм░рм┐рммрм╛, рмкрм╢рм╛рмХрм╛рмарм┐, рмЦрнЗрм│
ЁЯГП => ЁЯГП, рмЬрнЛрмХрм░рнН рмХрм╛рм░рнНрмбрнН, рмЬрнЛрмХрм░рнН, рмкрнНрм▓рнЗрнЯрм┐рмВ рмХрм╛рм░рнНрмбрнН, рмХрм╛рм░рнНрмбрнН
ЁЯАД => ЁЯАД, рморм╣рмЬрнЛрмЩрнНрмЧ рмЯрм╛рмЗрм▓рнН, рм▓рм╛рм▓рнН рмбрнНрм░рм╛рмЧрмирнН, рмбрнНрм░рм╛рмЧрмирнН, рморм╣рмЬрнЛрмЩрнНрмЧ, рмЯрм╛рмЗрм▓рнН
ЁЯО┤ => ЁЯО┤, рмдрм╛рм╕, рмлрнНрм▓рм╛рн▒рм╛рм░рнНтАМ рмХрм╛рм░рнНрмб, рмлрнБрм▓, рмХрм╛рм░рнНрмб рмЦрнЗрм│, рмХрм╛рм░рнНрмб, рмЦрнЗрм│, рм╣рм╛рмирм╛рмлрнБрмбрм╛
ЁЯФЗ => ЁЯФЗ, рмХрмерм╛ рмирмХрм╣рм┐рммрм╛, рмжрнЯрм╛рмХрм░рм┐ рм╢рм╛рмирнНрмд рм░рнБрм╣рмирнНрмдрнБ, рм╢рм╛рмирнНрмд, рммрм╛рмдрм┐рм▓рнН рмЪрм┐рм╣рнНрми рм╕рм╣рм┐рмд рм╕рнНрмкрм┐рмХрм░рнН
ЁЯФИ => ЁЯФИ, рм╕рнНрмкрм┐рмХрм░рнН, рм▓рм╛рмЙрмбрнНтАМрм╕рнНрмкрм┐рмХрм░рнН
ЁЯФЙ => ЁЯФЙ, рм╕рнНрмкрм┐рмХрм░рнН, рмХрморнН рмнрм▓рнНрнЯрнБрморнН, рмХрморнН, рмХрморнН рмнрм▓рнНрнЯрнБрморнН рм╕рм╣рм┐рмд рм╕рнНрмкрм┐рмХрм░рнН
ЁЯФК => ЁЯФК, рм╕рнНрмкрм┐рмХрм░рнН, рмЙрмЪрнНрмЪ рмнрм▓рнНрнЯрнБрморнН, рмЙрмЪрнНрмЪ, рм▓рм╛рмЙрмбрнН рмнрм▓рнНрнЯрнБрморнН рм╕рм╣рм┐рмд рм╕рнНрмкрм┐рмХрм░рнН
ЁЯУв => ЁЯУв, рм▓рм╛рмЙрмбрнНтАМрм╕рнНрмкрм┐рмХрм░рнН, рм╕рм░рнНрммрм╕рм╛рмзрм╛рм░рмг рмарм┐рмХрмгрм╛, рм╣рнНрнЯрм╛рмгрнНрмбрнН рм╕рнНрмкрм┐рмХрм░рнН, рмпрнЛрмЧрм╛рмпрнЛрмЧ
ЁЯУг => ЁЯУг, рморнЗрмЧрм╛рмлрнЛрмирнН, рмЪрм┐рнЯрм░рм┐рмВ, рмпрнЛрмЧрм╛рмпрнЛрмЧ
ЁЯУп => ЁЯУп, рмкрнЛрм╖рнНрмЯрм╛рм▓рнН рм╣рм░рнНрмгрнНрмг, рмкрнЛрм╖рнНрмЯрм╛рм▓рнН, рм╣рм░рнНрмгрнНрмг
ЁЯФФ => ЁЯФФ, рммрнЗрм▓рнН, рмЪрм░рнНрмЪрнНрмЪ
ЁЯФХ => ЁЯФХ, рмХрнМрмгрм╕рм┐ рммрнЗрм▓рнН рмирм╛рм╣рм┐рмБ, рмХрнМрмгрм╕рм┐ рм╕рм╛рмЙрмгрнНрмбрнН рмирм╛рм╣рм┐рмБ, рммрм╛рмдрм┐рм▓рнНтАМрмХрм░рмг рмЪрм┐рм╣рнНрми рм╕рм╣рм┐рмд рммрнЗрм▓рнН, рммрнЗрм▓рнН
ЁЯО╝ => ЁЯО╝, рм╕рмЩрнНрмЧрнАрмд рм╕рнНрмХрнЛрм░рнНтАМ, рм╕рмЩрнНрмЧрнАрмд, рм╕рнНрмХрнЛрм░рнНтАМ
ЁЯО╡ => ЁЯО╡, рм╕рмЩрнНрмЧрнАрмд рм╕рморнНрммрмирнНрмзрнАрнЯ рм╕рнНрн▒рм░, рм╕рмЩрнНрмЧрнАрмд, рм╕рнНрн▒рм░
ЁЯО╢ => ЁЯО╢, рм╕рмЩрнНрмЧрнАрмд рм╕рморнНрммрмирнНрмзрнАрнЯ рм╕рнНрн▒рм░рмЧрнБрмбрм┐рмХ, рм╕рмЩрнНрмЧрнАрмд, рм╕рнНрн▒рм░, рм╕рнНрн▒рм░рмЧрнБрмбрм┐рмХ
ЁЯОд => ЁЯОд, рморм╛рмЗрмХрнНтАМ, рморм╛рмЗрмХрнНрм░рнЛрмлрнЛрмирнНтАМ, рмХрм╛рм░рм╛рмУрмХрнНтАМ, рмормирнЛрм░рмЮрнНрмЬрми
ЁЯОз => ЁЯОз, рм╣рнЗрмбрмлрнЛрмирнНтАМ, рмормирнЛрм░рмЮрнНрмЬрми
ЁЯО╖ => ЁЯО╖, рм╕рнНрнЯрм╛рмХрнНрм╕, рм╕рм╛рмХрнНрм╕рнЛрмлрнЛрмирнНтАМ, рм╕рмЩрнНрмЧрнАрмд рмнрм┐рмдрнНрмдрм┐рмХ рмЙрмкрмХрм░рмг, рм╕рмЩрнНрмЧрнАрмд, рмЙрмкрмХрм░рмг
ЁЯО╕ => ЁЯО╕, рмЧрм┐рмдрм╛рм░, рм╕рмЩрнНрмЧрнАрмд рмнрм┐рмдрнНрмдрм┐рмХ рмЙрмкрмХрм░рмг, рмЙрмкрмХрм░рмг
ЁЯО╣ => ЁЯО╣, рмкрм┐рмЖрмирнЛ, рм╕рмЩрнНрмЧрнАрмд рмнрм┐рмдрнНрмдрм┐рмХ рмХрнАрммрнЛрм░рнНрмб, рмХрнАрммрнЛрм░рнНрмб, рм╕рмЩрнНрмЧрнАрмд рмнрм┐рмдрнНрмдрм┐рмХ рмЙрмкрмХрм░рмг, рм╕рмЩрнНрмЧрнАрмд, рмЙрмкрмХрм░рмг
ЁЯО║ => ЁЯО║, рмдрнБрм░рнА, рм╕рмЩрнНрмЧрнАрмд рмнрм┐рмдрнНрмдрм┐рмХ рмЙрмкрмХрм░рмг, рм╕рмЩрнНрмЧрнАрмд, рмЙрмкрмХрм░рмг
ЁЯО╗ => ЁЯО╗, рммрнЗрм╣рнЗрм▓рм╛, рм╕рмЩрнНрмЧрнАрмд рмнрм┐рмдрнНрмдрм┐рмХ рмЙрмкрмХрм░рмг, рм╕рмЩрнНрмЧрнАрмд, рмЙрмкрмХрм░рмг
ЁЯУ╗ => ЁЯУ╗, рм░рнЗрмбрм┐рмУ
ЁЯУ▒ => ЁЯУ▒, рм╕рнЗрм▓рнН рмлрнЛрмирнН, рморнЛрммрм╛рмЗрм▓рнН рмлрнЛрмирнН, рмлрнЛрмирнН
ЁЯУ▓ => ЁЯУ▓, рмдрнАрм░ рм╕рм╣рм┐рмд рм╕рнЗрм▓рнН рмлрнЛрмирнН, рмПрмХ рмХрм▓рнН рмХрм░рм┐рммрм╛, рморнЛрммрм╛рмЗрм▓рнН рмлрнЛрмирнН, рмлрнЛрмирнН
ЁЯУЮ => ЁЯУЮ, рмлрнЛрмирнН, рмЯрнЗрм▓рм┐рмлрнЛрмирнН, рмлрнЛрмирнН рм░рм┐рм╕рм┐рмнрм░рнН, рмпрнЛрмЧрм╛рмпрнЛрмЧ
ЁЯУЯ => ЁЯУЯ, рмкрнЗрмЬрм░рнН, рмпрнЛрмЧрм╛рмпрнЛрмЧ
ЁЯУа => ЁЯУа, рмлрнНрнЯрм╛рмХрнНрм╕, рмлрнНрнЯрм╛рмХрнНрм╕ рморнЗрм╕рм┐рмирнН, рмпрнЛрмЧрм╛рмпрнЛрмЧ
ЁЯФЛ => ЁЯФЛ, рммрнНрнЯрм╛рмЯрнЗрм░рнА
ЁЯФМ => ЁЯФМ, рмЗрм▓рнЗрмХрнНрмЯрнНрм░рм┐рмХрнН рмкрнНрм▓рмЧрнН, рмЗрм▓рнЗрмХрнНрмЯрнНрм░рм┐рмХрнН
ЁЯТ╗ => ЁЯТ╗, рмкрм┐рм╕рм┐, рмкрм░рнНрм╕рмирм╛рм▓рнН рмХрморнНрмкрнНрнЯрнБрмЯрм░рнН, рмХрморнНрмкрнНрнЯрнБрмЯрм░рнН, рмкрм░рнНрм╕рмирм╛рм▓рнН
ЁЯТ╜ => ЁЯТ╜, рмПрмормбрм┐, рморм┐рмирм┐ рмбрм┐рм╕рнНрмХрнН, рмбрм┐рм╕рнНрмХрнН
ЁЯТ╛ => ЁЯТ╛, рмлрнНрм▓рмкрм┐ рмбрм┐рм╕рнНрмХрнН, рмлрнНрм▓рмкрм┐, рмбрм┐рм╕рнНрмХрнН
ЁЯТ┐ => ЁЯТ┐, рммрнНрм▓рнБ-рм░рнЗ, рмбрм┐рмнрм┐рмбрм┐, рм╕рм┐рмбрм┐, рмЕрмкрнНрмЯрм┐рмХрм╛рм▓рнН рмбрм┐рм╕рнНрмХрнН, рмбрм┐рм╕рнНрмХрнН
ЁЯУА => ЁЯУА, рмбрм┐рмнрм┐рмбрм┐, рмбрм┐рмнрм┐рмбрм┐ рмбрм┐рм╕рнНрмХрнН, рмбрм┐рм╕рнНрмХрнН
ЁЯОе => ЁЯОе, рмЪрм│рмЪрнНрмЪрм┐рмдрнНрм░ рмХрнНрнЯрм╛рморнЗрм░рм╛, рмЪрм│рмЪрнНрмЪрм┐рмдрнНрм░, рм╕рм┐рмирнЗрморм╛, рмормирнЛрм░рмЮрнНрмЬрми
ЁЯОм => ЁЯОм, рмХрнНрм▓рм╛рмкрм░рнНтАМрммрнЛрм░рнНрмб, рмдрм╛рм│рм┐ рморм░рм╛рмпрм┐рммрм╛ рмлрм│рмХ, рмдрм╛рм│рм┐ рморм╛рм░рм┐рммрм╛ рммрнНрнЯрмХрнНрмдрм┐, рмЪрм│рмЪрнНрмЪрм┐рмдрнНрм░, рмормирнЛрм░рмЮрнНрмЬрми
ЁЯУ║ => ЁЯУ║, рмЯрм┐рмнрм┐, рмЯрнЗрм▓рм┐рмнрм┐рмЬрмирнН
ЁЯУ╖ => ЁЯУ╖, рмХрнНрнЯрм╛рморнЗрм░рм╛
ЁЯУ╣ => ЁЯУ╣, рмнрм┐рмбрм┐рмУ рмХрнНрнЯрм╛рморнН, рмХрнНрнЯрм╛рморнЗрм░рм╛, рмнрм┐рмбрм┐рмУ
ЁЯУ╝ => ЁЯУ╝, рмнрм┐рмбрм┐рмУ рмЯрнНрнЯрм╛рмкрнН, рмнрм┐рмбрм┐рмУ, рмЯрнНрнЯрм╛рмкрнН
ЁЯФН => ЁЯФН, рмЬрммрмХрм╛рмЪ, рм╕рмирнНрмзрм╛рми, рммрм╛рмормХрнБ рмжрнГрм╖рнНрмЯрм┐ рмирм┐рмХрнНрм╖рнЗрмк рмХрм░рнБрмерм┐рммрм╛ рмЬрммрмХрм╛рмЪ, рммрм╛рмормХрнБ рмжрнГрм╖рнНрмЯрм┐ рмирм┐рмХрнНрм╖рнЗрмк рмХрм░рнБрмерм┐рммрм╛, рмХрм╛рмЪ
ЁЯФО => ЁЯФО, рмЬрммрмХрм╛рмЪ, рм╕рмирнНрмзрм╛рми, рмбрм╛рм╣рм╛рмгрмХрнБ рмжрнГрм╖рнНрмЯрм┐ рмирм┐рмХрнНрм╖рнЗрмк рмХрм░рнБрмерм┐рммрм╛ рмЬрммрмХрм╛рмЪ, рмбрм╛рм╣рм╛рмгрмХрнБ рмжрнГрм╖рнНрмЯрм┐ рмирм┐рмХрнНрм╖рнЗрмк рмХрм░рнБрмерм┐рммрм╛, рмХрм╛рмЪ
ЁЯФм => ЁЯФм, рморм╛рмЗрмХрнНрм░рнЛрм╕рнНрмХрнЛрмкрнН
ЁЯФн => ЁЯФн, рмЯрнЗрм▓рм┐рм╕рнНрмХрнЛрмкрнН
ЁЯУб => ЁЯУб, рм╕рм╛рмЯрнЗрм▓рм╛рмЗрмЯрнН рмбрм┐рм╕рнН, рм╕рм╛рмЯрнЗрм▓рм╛рмЗрмЯрнН рмЖрмгрнНрмЯрм┐рмирм╛, рмЖрмгрнНрмЯрм┐рмирм╛, рмбрм┐рм╕рнН, рм╕рм╛рмЯрнЗрм▓рм╛рмЗрмЯрнН, рмпрнЛрмЧрм╛рмпрнЛрмЧ
ЁЯТб => ЁЯТб, рмЖрм▓рнЛрмХ рммрм▓рммрнНтАМ, рмПрмХ рмзрм╛рм░рмгрм╛ рмкрм╛рмЗрммрм╛, рммрнИрмжрнНрнЯрнБрмдрм┐рмХ, рмЖрм▓рнЛрмХ, рммрм▓рмХрнНтАМ, рм╣рм╛рм╕рнНрнЯрнЛрмжрнНрмжрнАрмкрмХ
ЁЯФж => ЁЯФж, рмлрнНрм▓рм╛рм╕рнНтАМрм▓рм╛рмЗрмЯрнН, рмЖрм▓рнЛрмХ, рмЯрм░рнНрмЪрнНрмЪ, рмЗрм▓рнЗрмХрнНрмЯрнНрм░рм┐рмХрнН
ЁЯПо => ЁЯПо, рм▓рм╛рм▓рнНтАМ рм▓рмгрнНрмарми, рм▓рм╛рм▓рнНтАМ, рм▓рмгрнНрмарми, рмЗрмЬрм╛рмХрм╛рнЯрм╛, рммрм╛рм░рнНтАМ, рм░рнЗрм╖рнНрмЯрнБрм░рм╛рмгрнНрмЯ
ЁЯУФ => ЁЯУФ, рмЪрм┐рмдрнНрм░рммрм┐рмЪрм┐рмдрнНрм░ рмирнЛрмЯрнНтАМрммрнБрмХрнН, рмЪрм┐рмдрнНрм░рммрм┐рмЪрм┐рмдрнНрм░ рммрм┐рм╢рм┐рм╖рнНрмЯ рмирнЛрмЯрнНтАМрммрнБрмХрнН, рмирнЛрмЯрнНтАМрммрнБрмХрнН, рмХрмнрм░рнН
ЁЯУХ => ЁЯУХ, рммрмирнНрмж рмкрнБрм╕рнНрмдрмХ, рмкрнБрм╕рнНрмдрмХ
ЁЯУЦ => ЁЯУЦ, рмЦрнЛрм▓рм╛ рмкрнБрм╕рнНрмдрмХ, рмкрнБрм╕рнНрмдрмХ
ЁЯУЧ => ЁЯУЧ, рм╕рммрнБрмЬ рмкрнБрм╕рнНрмдрмХ, рмкрнБрм╕рнНрмдрмХ
ЁЯУШ => ЁЯУШ, рмкрнБрм╕рнНрмдрмХ, рмирнАрм│ рмкрнБрм╕рнНрмдрмХ
ЁЯУЩ => ЁЯУЩ, рмХрморм│рм╛ рмкрнБрм╕рнНрмдрмХ, рмкрнБрм╕рнНрмдрмХ
ЁЯУЪ => ЁЯУЪ, рмкрнБрм╕рнНрмдрмХ
ЁЯУУ => ЁЯУУ, рмирнЛрмЯрнНтАМрммрнБрмХрнН
ЁЯУТ => ЁЯУТ, рм▓рнЗрмЬрм░рнН, рмирнЛрмЯрнНтАМрммрнБрмХрнН
ЁЯУГ => ЁЯУГ, рмбрмХрнНрнЯрнБрморнЗрмгрнНрмЯрнН, рмХрнБрмЮрнНрмЪрм┐рмд рмкрнГрм╖рнНрмарм╛, рмкрнГрм╖рнНрмарм╛
ЁЯУЬ => ЁЯУЬ, рм╕рнНрмХрнНрм░рнЛрм▓рнН, рмХрм╛рмЧрмЬ рм╕рнНрмХрнНрм░рнЛрм▓рнН
ЁЯУД => ЁЯУД, рмбрмХрнНрнЯрнБрморнЗрмгрнНрмЯрнН, рмЙрмкрм░рнБ рморнЛрмбрм┐ рм╣рнЛрмЗрмерм┐рммрм╛ рмкрнГрм╖рнНрмарм╛, рмЙрмкрм░рнБ рморнЛрмбрм┐ рм╣рнЛрмЗрмерм┐рммрм╛, рмкрнГрм╖рнНрмарм╛
ЁЯУ░ => ЁЯУ░, рмирнНрнЯрнБрмЬрнНтАМрмкрнЗрмкрм░рнН, рмирнНрнЯрнБрмЬрнН, рмкрнЗрмкрм░рнН
ЁЯУС => ЁЯУС, рмкрнБрм╕рнНрмдрмХрмЪрм┐рм╣рнНрми рмЯрнНрнЯрм╛рммрнН, рморм╛рм░рнНрмХрм░рнН, рмЯрнНрнЯрм╛рммрнН, рмкрнБрм╕рнНрмдрмХрмЪрм┐рм╣рнНрми
ЁЯФЦ => ЁЯФЦ, рмкрнБрм╕рнНрмдрмХрмЪрм┐рм╣рнНрми
ЁЯТ░ => ЁЯТ░, рмЯрмЩрнНрмХрм╛ рммрнНрнЯрм╛рмЧрнН, рмбрм▓рм╛рм░рнН рммрнНрнЯрм╛рмЧрнН, рмЯрмЩрнНрмХрм╛, рммрнНрнЯрм╛рмЧрнН
ЁЯТ┤ => ЁЯТ┤, рнЯрнЗрмирнН рмирнЛрмЯрнН, рммрнНрнЯрм╛рмЩрнНрмХрмирнЛрмЯрнН, рнЯрнЗрмирнН, рмЯрмЩрнНрмХрм╛, рммрм┐рм▓рнН, рмирнЛрмЯрнН
ЁЯТ╡ => ЁЯТ╡, рмбрм▓рм╛рм░рнН рмирнЛрмЯрнН, рммрнНрнЯрм╛рмЩрнНрмХрнН рмирнЛрмЯрнН, рмбрм▓рм╛рм░рнН, рмЯрмЩрнНрмХрм╛, рммрм┐рм▓рнН, рмирнЛрмЯрнН
ЁЯТ╢ => ЁЯТ╢, рнЯрнБрм░рнЛ рмирнЛрмЯрнН, рнЯрнБрм░рнЛ, рммрнНрнЯрм╛рмЩрнНрмХрмирнЛрмЯрнН, рмЯрмЩрнНрмХрм╛, рммрм┐рм▓рнН, рмирнЛрмЯрнН
ЁЯТ╖ => ЁЯТ╖, рмкрм╛рмЙрмгрнНрмбрнН рмирнЛрмЯрнН, рмкрм╛рмЙрмгрнНрмбрнН, рммрнНрнЯрм╛рмЩрнНрмХрмирнЛрмЯрнН, рмЯрмЩрнНрмХрм╛
ЁЯТ╕ => ЁЯТ╕, рмЙрмбрмирнНрмдрм╛ рмЯрмЩрнНрмХрм╛, рмЯрмЩрнНрмХрм╛рм░рнЗ рмкрм░ рм▓рм╛рмЧрм┐рммрм╛, рмЙрмбрмирнНрмдрм╛ рммрнНрнЯрм╛рмЩрнНрмХрмирнЛрмЯрнН, рммрнНрнЯрм╛рмЩрнНрмХрнН, рмирнЛрмЯрнН, рмЯрмЩрнНрмХрм╛
ЁЯТ│ => ЁЯТ│, рмХрнНрм░рнЗрмбрм┐рмЯрнН рмХрм╛рм░рнНрмбрнН, рмХрм╛рм░рнНрмбрнН, рмХрнНрм░рнЗрмбрм┐рмЯрнН
ЁЯТ╣ => ЁЯТ╣, рммрмврмирнНрмдрм╛ рммрмЬрм╛рм░, рмЪрм╛рм░рнНрмЯрнН рмЙрмкрм░рморм╛рм░рнНрмЧ, рмЙрмкрм░, рмЪрм╛рм░рнНрмЯрнН, рммрмЬрм╛рм░
ЁЯУз => ЁЯУз, рмЗрморнЗрм▓рнН, рморнЗрм▓рнН, рмЪрм┐рмарм╛, рмпрнЛрмЧрм╛рмпрнЛрмЧ
ЁЯУи => ЁЯУи, рмЖрмЧрмирнНрмдрнБрмХ рморнЗрм▓рнН, рмкрнНрм░рм╛рмкрнНрмд рм╣рнЛрмЗрмерм┐рммрм╛ рморнЗрм▓рнН, рмЖрмЧрмирнНрмдрнБрмХ, рмЗрморнЗрм▓рнН, рморнЗрм▓рнН, рмЪрм┐рмарм╛, рмПрмирнНтАМрмнрм▓рмкрнН, рмпрнЛрмЧрм╛рмпрнЛрмЧ
ЁЯУй => ЁЯУй, рммрм╣рм┐рм░рнНрмЧрморми рморнЗрм▓рнН, рмкрнНрм░рнЗрм░рм┐рмд рморнЗрм▓рнН, рммрм╣рм┐рм░рнНрмЧрморми, рмЗрморнЗрм▓рнН, рморнЗрм▓рнН, рмЪрм┐рмарм╛, рмПрмирнНтАМрмнрм▓рмкрнН, рмпрнЛрмЧрм╛рмпрнЛрмЧ
ЁЯУд => ЁЯУд, рморнЗрм▓рнН рмкрмарм╛рмЗрммрм╛, рмкрнНрм░рнЗрм░рмг рммрм╛рмХрнНрм╕, рморнЗрм▓рнН, рмкрнНрм░рнЗрм░рмг, рммрм╛рмХрнНрм╕, рммрм╛рм╣рнНрнЯрммрм╛рмХрнНрм╕, рмЯрнНрм░рнЗ, рмпрнЛрмЧрм╛рмпрнЛрмЧ
ЁЯУе => ЁЯУе, рмЗрмирнНтАМрммрм╛рмХрнНрм╕, рмкрнНрм░рм╛рмкрнНрмд рм╣рнЛрмЗрмерм┐рммрм╛ рморнЗрм▓рнН, рморнЗрм▓рнН, рмкрнНрм░рм╛рмкрнНрмд рм╣рнЛрмЗрмерм┐рммрм╛, рммрм╛рмХрнНрм╕, рмЯрнНрм░рнЗ, рмпрнЛрмЧрм╛рмпрнЛрмЧ
ЁЯУж => ЁЯУж, рмкрнНрнЯрм╛рмХрнЗрмЬрнН, рмкрм╛рм░рнНрм╕рм▓рнН, рммрм╛рмХрнНрм╕
ЁЯУл => ЁЯУл, рморнЗрм▓рнНтАМрммрм╛рмХрнНрм╕, рммрмирнНрмж рм╣рнЛрмЗрмЫрм┐, рмПрмХ рмЙрмжрнНрмзрмЧрм╛рморнА рмкрмдрм╛рмХрм╛ рм╕рм╣рм┐рмд рморнЗрм▓рнНтАМрммрм╛рмХрнНрм╕, рморнЗрм▓рнН, рмкрмдрм╛рмХрм╛
ЁЯУк => ЁЯУк, рморнЗрм▓рнНтАМрммрм╛рмХрнНрм╕, рммрмирнНрмж рм╣рнЛрмЗрмЫрм┐, рмПрмХ рмирм┐рморнНрмирмЧрм╛рморнА рмкрмдрм╛рмХрм╛ рм╕рм╣рм┐рмд рморнЗрм▓рнНтАМрммрм╛рмХрнНрм╕, рморнЗрм▓рнН, рмкрмдрм╛рмХрм╛
ЁЯУм => ЁЯУм, рморнЗрм▓рнНтАМрммрм╛рмХрнНрм╕, рмЦрнЛрм▓рм╛, рмПрмХ рмЙрмжрнНрмзрмЧрм╛рморнА рмкрмдрм╛рмХрм╛ рм╕рм╣рм┐рмд рморнЗрм▓рнНтАМрммрм╛рмХрнНрм╕, рморнЗрм▓рнН, рмкрмдрм╛рмХрм╛
ЁЯУн => ЁЯУн, рморнЗрм▓рнНтАМрммрм╛рмХрнНрм╕, рмЦрнЛрм▓рм╛, рмПрмХ рмирм┐рморнНрмирмЧрм╛рморнА рмкрмдрм╛рмХрм╛ рм╕рм╣рм┐рмд рморнЗрм▓рнНтАМрммрм╛рмХрнНрм╕, рморнЗрм▓рнН, рмкрмдрм╛рмХрм╛
ЁЯУо => ЁЯУо, рмкрнЛрм╖рнНрмЯрммрм╛рмХрнНрм╕
ЁЯУЭ => ЁЯУЭ, рморнЗрморнЛ, рморнЗрморнЛ рмкрнБрм╕рнНрмдрмХ, рмпрнЛрмЧрм╛рмпрнЛрмЧ
ЁЯТ╝ => ЁЯТ╝, рммрнНрм░рм┐рмлрмХрнЗрм╕рнН
ЁЯУБ => ЁЯУБ, рмлрм╛рмЗрм▓рнН рмлрнЛрм▓рнНрмбрм░рнН, рмлрм╛рмЗрм▓рнН, рмлрнЛрм▓рнНрмбрм░рнН
ЁЯУВ => ЁЯУВ, рмЦрнЛрм▓рм╛ рмлрнЛрм▓рнНрмбрм░рнН, рмЦрнЛрм▓рм╛ рмлрм╛рмЗрм▓рнН рмлрнЛрм▓рнНрмбрм░рнН, рмЦрнЛрм▓рм╛, рмлрм╛рмЗрм▓рнН, рмлрнЛрм▓рнНрмбрм░рнН
ЁЯУЕ => ЁЯУЕ, рмХрнНрнЯрм╛рм▓рнЗрмгрнНрмбрм░рнН
ЁЯУЖ => ЁЯУЖ, рмЪрм┐рм░рм┐рммрм╛рмпрнЛрмЧрнНрнЯ рмХрнНрнЯрм╛рм▓рнЗрмгрнНрмбрм░рнН, рмХрнНрнЯрм╛рм▓рнЗрмгрнНрмбрм░рнН
ЁЯУЗ => ЁЯУЗ, рмХрм╛рм░рнНрмбрнН рмЗрмгрнНрмбрнЗрмХрнНрм╕, рм░рнЛрм▓рнЛрмбрнЗрмХрнНрм╕, рмЗрмгрнНрмбрнЗрмХрнНрм╕
ЁЯУИ => ЁЯУИ, рммрмврмирнНрмдрм╛ рмкрнНрм░рммрнГрмдрнНрмдрм┐, рмЙрмкрм░рмХрнБ рммрмврмирнНрмдрм╛ рмкрнНрм░рммрнГрмдрнНрмдрм┐ рмЪрм╛рм░рнНрмЯрнН, рмЪрм╛рм░рнНрмЯрнН, рмЧрнНрм░рм╛рмлрнН, рмЙрмкрм░рмХрнБ
ЁЯУЙ => ЁЯУЙ, рмдрм│рмХрнБ рмпрм╛рмЙрмерм┐рммрм╛ рмкрнНрм░рммрнГрмдрнНрмдрм┐, рмдрм│рмХрнБ рмпрм╛рмЙрмерм┐рммрм╛ рмкрнНрм░рммрнГрмдрнНрмдрм┐ рмЪрм╛рм░рнНрмЯрнН, рмЪрм╛рм░рнНрмЯрнН, рмЧрнНрм░рм╛рмлрнН, рмдрм│рмХрнБ рмпрм╛рмЙрмерм┐рммрм╛
ЁЯУК => ЁЯУК, рммрм╛рм░рнН рмЧрнНрм░рм╛рмлрнН, рммрм╛рм░рнН рмЪрм╛рм░рнНрмЯрнН, рмЪрм╛рм░рнНрмЯрнН
ЁЯУЛ => ЁЯУЛ, рмХрнНрм▓рм┐рмкрнНтАМрммрнЛрм░рнНрмбрнН
ЁЯУМ => ЁЯУМ, рмкрнБрм╕рнНтАМрмкрм┐рмирнН, рмкрм┐рмирнН
ЁЯУН => ЁЯУН, рмЧрнЛрм▓ рмкрнБрм╕рнНтАМрмкрм┐рмирнН, рмкрнБрм╕рнНтАМрмкрм┐рмирнН, рмкрм┐рмирнН
ЁЯУО => ЁЯУО, рмкрнЗрмкрм░рнН рмХрнНрм▓рм┐рмкрнН, рмХрнНрм▓рм┐рмкрнН
ЁЯУП => ЁЯУП, рм╕рнНрмХрнЗрм▓рнН, рм░рнБрм▓рм░рнН
ЁЯУР => ЁЯУР, рмдрнНрм░рм┐рмХрнЛрмгрнАрнЯ рм╕рнНрмХрнЗрм▓рнН, рмдрнНрм░рм┐рмХрнЛрмгрнАрнЯ, рм╕рнЗрмЯрнН рм╕рнНрмХрнЛрнЯрм╛рм░рнН, рм░рнБрм▓рм░рнН
ЁЯФТ => ЁЯФТ, рм▓рмХрнН, рммрмирнНрмж рм╣рнЛрмЗрмерм┐рммрм╛ рм▓рмХрнН
ЁЯФУ => ЁЯФУ, рм▓рмХрнН, рм▓рмХрнН рмЦрнЛрм▓рм┐рммрм╛
ЁЯФП => ЁЯФП, рм▓рмХрнН, рмЧрнЛрмкрмирнАрнЯрмдрм╛, рмПрмХ рм╕рнНрнЯрм╛рм╣рм┐ рмкрнЗрмирнНтАМрм░рнЗ рм▓рмХрнН рмХрм░рм┐рммрм╛, рм╕рнНрнЯрм╛рм╣рм┐ рмкрнЗрмирнН
ЁЯФР => ЁЯФР, рммрмирнНрмж рм╣рнЛрмЗрмерм┐рммрм╛ рм▓рмХрнН, рмПрмХ рмХрнА рм╕рм╣рм┐рмд рм▓рмХрнН, рм╕рнБрм░рмХрнНрм╖рм┐рмд
ЁЯФС => ЁЯФС, рмХрнА, рмкрм╛рм╕рнНтАМрн▒рм╛рм░рнНрмбрнН
ЁЯФи => ЁЯФи, рм╣рм╛рморм╛рм░рнН, рмЙрмкрмХрм░рмг
ЁЯФз => ЁЯФз, рм░рнЗрмЮрнНрмЪрм┐, рмЙрмкрмХрм░рмг
ЁЯФй => ЁЯФй, рмирмЯрнН рмПрммрмВ рммрнЛрм▓рнНрмЯрнН, рмирмЯрнН, рммрнЛрм▓рнНрмЯрнН, рмЙрмкрмХрм░рмг
ЁЯФЧ => ЁЯФЧ, рм▓рм┐рмЩрнНрмХрнН рмЪрм┐рм╣рнНрми, рм▓рм┐рмЩрнНрмХрнН, рмжрнБрмЗрмЯрм┐ рм░рм┐рмВ
ЁЯТЙ => ЁЯТЙ, рм╢рмЯрнНтАМ, рм╕рм┐рм░рм┐рмЮрнНрмЬ, рмЫрнБрмЮрнНрмЪрм┐, рмФрм╖рмз, рмбрм╛рмХрнНрмдрм░
ЁЯТК => ЁЯТК, рммрмЯрм┐рмХрм╛, рмФрм╖рмз, рмбрм╛рмХрнНрмдрм░
ЁЯФк => ЁЯФк, рмЫрнБрм░рнА, рмЪрм╛рмХрнБ
ЁЯФл => ЁЯФл, рмЧрмирнН, рмкрм┐рм╕рнНрмдрм▓рнН, рм░рм┐рмнрнЛрм▓рнНтАМрмнрм░рнН
ЁЯПБ => ЁЯПБ, рмЪрнЗрмХрнНтАМ рмерм┐рммрм╛ рмкрмдрм╛рмХрм╛, рмкрмдрм╛рмХрм╛, рмЪрнЗрмХрнНтАМ рмпрнБрмХрнНрмд, рмжрнМрмб, рмХрнНрм░рнАрмбрм╛
ЁЯЪй => ЁЯЪй, рмЕрммрм╕рнНрмерм╛рми рмкрмдрм╛рмХрм╛, рмЕрммрм╕рнНрмерм╛рми рм╕рнВрмЪрмирм╛ рмкрмдрм╛рмХрм╛, рмдрнНрм░рм┐рмХрнЛрмг рмЕрммрм╕рнНрмерм╛рми рмкрмдрм╛рмХрм╛, рмдрнНрм░рм┐рмХрнЛрмг рмкрмдрм╛рмХрм╛, рмкрмдрм╛рмХрм╛, рмЕрммрм╕рнНрмерм╛рми
ЁЯЪм => ЁЯЪм, рмзрнВрмормкрм╛рми рмЪрм┐рм╣рнНрми, рмзрнВрмормкрм╛рми рмЕрмирнБрморнЛрмжрм┐рмд, рмзрнВрмормкрм╛рми, рмЪрм┐рм╣рнНрми
ЁЯЧ┐ => ЁЯЧ┐, рморнЛрнЯрм╛рмЗ рм╖рнНрмЯрнЗрмЪрнНрнЯрнБ, рм╖рнНрмЯрнЗрмЪрнНрнЯрнБ, рморнЛрнЯрм╛рмЗ
ЁЯФо => ЁЯФо, рмХрнНрм░рм┐рм╖рнНрмЯрм╛рм▓рнН рммрм▓рнН, рмлрм░рнНрмЪрнНрнЯрнБрмирнН рмЯрнЗрм▓рм┐рмВ, рмХрнНрм░рм┐рм╖рнНрмЯрм╛рм▓рнН, рммрм▓рнН, рмлрм░рнНрмЪрнНрнЯрнБрмирнН
ЁЯПз => ЁЯПз, рмПрмЯрм┐рмПрморнНтАМ, рм╕рнНрн▒рмЪрм╛рм│рм┐рмд рмЯрнЗрм▓рм░рнНтАМ, рм╕рнНрн▒рмЪрм╛рм│рм┐рмд, рмЯрнЗрм▓рм░рнНтАМ
ЁЯЪо => ЁЯЪо, рмЕрммрм░рнНрмЬрмирм╛ рммрм╛рмХрнНрм╕ рмЪрм┐рм╣рнНрми, рмЕрммрм░рнНрмЬрмирм╛ рмдрм╛рм╣рм╛рм░ рм╕рнНрмерм╛рмирм░рнЗ рмкрмХрм╛рмирнНрмдрнБ, рмЕрммрм░рнНрмЬрмирм╛ рммрм╛рмХрнНрм╕, рмЪрм┐рм╣рнНрми
ЁЯЪ░ => ЁЯЪ░, рмкрм╛рмирнАрнЯ рмЬрм│, рмкрм┐рмЗрммрм╛рмпрнЛрмЧрнНрнЯ рмЬрм│, рмкрм╛рмирнАрнЯ рмЬрм│ рмЪрм┐рм╣рнНрми
тЩ┐ => тЩ┐, рм╣рнБрмЗрм▓рнНтАМрмЪрнЗрнЯрм╛рм░рнН рмкрм╛рмЗрммрм╛, рм╣рнБрмЗрм▓рнНтАМрмЪрнЗрнЯрм╛рм░рнН, рмкрм╛рмЗрммрм╛, рм╣рнБрмЗрм▓рнНтАМрмЪрнЗрнЯрм╛рм░рнН рмЪрм┐рм╣рнНрми, рмЪрм┐рм╣рнНрми
ЁЯЪ╣ => ЁЯЪ╣, рмкрнБрм░рнБрм╖ рмЪрм┐рм╣рнНрми, рмкрнБрм░рнБрм╖рмЩрнНрмХ рмкрнНрм░рмХрнЛрм╖рнНрма, рмЪрм┐рм╣рнНрми
ЁЯЪ║ => ЁЯЪ║, рморм╣рм┐рм│рм╛ рмЪрм┐рм╣рнНрми, рморм╣рм┐рм│рм╛рмЩрнНрмХ рмкрнНрм░рмХрнЛрм╖рнНрма, рмЪрм┐рм╣рнНрми
ЁЯЪ╗ => ЁЯЪ╗, рм░рнЗрм╖рнНрмЯрм░рнБрморнН рмЪрм┐рм╣рнНрми, рм░рнЗрм╖рнНрмЯрм░рнБрморнН, рм▓рм╛рмнрм╛рмЯрнЛрм░рнА, рмбрммрнНрм▓рнБрм╕рм┐
ЁЯЪ╝ => ЁЯЪ╝, рм╢рм┐рм╢рнБ рмЪрм┐рм╣рнНрми, рм╢рм┐рм╢рнБ рмпрм╛рмдрнНрм░рм╛ рмХрм░рнБрмЫрмирнНрмдрм┐, рммрнЗрммрм┐ рмЪрнЗрмЮрнНрмЬрм┐рмВ рм╖рнНрмЯрнЗрм╕рмирнН, рм╢рм┐рм╢рнБ
ЁЯЪ╛ => ЁЯЪ╛, рм╢рнМрмЪрм╛рм│рнЯ, рмбрммрнНрм▓рнБрм╕рм┐, рм░рнЗрм╖рнНрмЯрм░рнБрморнН, рм▓рм╛рмнрм╛рмЯрнЛрм░рнА
ЁЯЫВ => ЁЯЫВ, рмкрм╛рм╕рнНтАМрмкрнЛрм░рнНрмЯрнН рмирм┐рнЯрмирнНрмдрнНрм░рмг, рмкрм╛рм╕рнНтАМрмкрнЛрм░рнНрмЯрнН, рмирм┐рнЯрмирнНрмдрнНрм░рмг
ЁЯЫГ => ЁЯЫГ, рмХрм╖рнНрмЯрморм╕рнН
ЁЯЫД => ЁЯЫД, рммрнНрнЯрм╛рмЧрнЗрмЬрнН рмкрм╛рмЗрммрм╛, рммрнНрнЯрм╛рмЧрнЗрмЬрнН
ЁЯЫЕ => ЁЯЫЕ, рм╕рм╛рморм╛рми рмЫрм╛рмбрм┐рмерм┐рммрм╛, рммрнНрнЯрм╛рмЧрнЗрмЬрнН рм╕рнЗрммрм╛, рм╕рм╛рморм╛рми, рммрнНрнЯрм╛рмЧрнЗрмЬрнН
тЪа => тЪа, рм╕рмдрм░рнНрмХрммрм╛рмгрнА рмЪрм┐рм╣рнНрми, рм╕рмдрм░рнНрмХрммрм╛рмгрнА, рмЪрм┐рм╣рнНрми
ЁЯЪ╕ => ЁЯЪ╕, рмкрм┐рм▓рм╛рморм╛рмирнЗ рм░рм╛рм╕рнНрмдрм╛ рмкрм╛рм░ рмХрм░рм┐рммрм╛, рмкрм┐рм▓рм╛рморм╛рмирнЗ, рм░рм╛рм╕рнНрмдрм╛ рмкрм╛рм░, рмЪрм┐рм╣рнНрми
тЫФ => тЫФ, рмкрнНрм░рммрнЗрм╢ рмирм╛рм╣рм┐рмБ рмЪрм┐рм╣рнНрми, рмкрнНрм░рммрнЗрм╢ рмирм╛рм╣рм┐рмБ, рмирм┐рм╖рм┐рмжрнНрмз, рмирм╛, рмЪрм┐рм╣рнНрми
ЁЯЪл => ЁЯЪл, рмкрнНрм░рммрнЗрм╢ рмирм╣рнЗрммрм╛ рмЪрм┐рм╣рнНрми, рмкрнНрм░рммрнЗрм╢ рмирм╣рнЗрммрм╛, рмЪрм┐рм╣рнНрми
ЁЯЪ│ => ЁЯЪ│, рммрм╛рмЗрмХрнН рмирм╛рм╣рм┐рмБ, рм╕рм╛рмЗрмХрнЗрм▓рнН рмирм╛рм╣рм┐рмБ, рм╕рм╛рмЗрмХрнЗрм▓рнН рмЕрмирнБрморнЛрмжрм┐рмд рмирнБрм╣рнЗрмБ, рммрм╛рмЗрмХрнН, рммрм╛рм╣рм╛рми
ЁЯЪн => ЁЯЪн, рмзрнВрмормкрм╛рми рмормирм╛ рмЪрм┐рм╣рнНрми, рмзрнВрмормкрм╛рми рмормирм╛, рмЪрм┐рм╣рнНрми
ЁЯЪп => ЁЯЪп, рмЕрммрм░рнНрмЬрмирм╛ рмирмкрмХрм╛рмЗрммрм╛ рмЪрм┐рм╣рнНрми, рмЕрммрм░рнНрмЬрмирм╛ рмкрмХрм╛рмирнНрмдрнБ рмирм╛рм╣рм┐рмБ, рмЕрммрм░рнНрмЬрмирм╛ рмирмкрмХрм╛рмЗрммрм╛, рмЪрм┐рм╣рнНрми
ЁЯЪ▒ => ЁЯЪ▒, рмЕрмг-рмкрм╛рмирнАрнЯ рмЬрм│, рмЬрм│, рмЕрмг-рмкрм╛рмирнАрнЯ
ЁЯЪ╖ => ЁЯЪ╖, рмкрм╛рмжрмЪрм▓рм╛ рмирнБрм╣рнЗрмБ, рмкрмжрмЪрм▓рм╛ рмЕрмирнБрморнЛрмжрм┐рмд рмирнБрм╣рнЗрмБ, рмкрмжрмЪрм▓рм╛, рмкрм╛рмжрмЪрм▓рм╛, рмЪрм┐рм╣рнНрми
ЁЯФГ => ЁЯФГ, рмкрнБрмирмГрм▓рнЛрмбрнН, рмкрнБрмирмГрм▓рнЛрмбрнН рмЪрм┐рм╣рнНрми, рмнрнВрм▓рморнНрм╡ рмШрмгрнНрмЯрм╛рм░ рмЧрмдрм┐ рмжрм┐рмЧрм░рнЗ рмдрнАрм░, рмдрнАрм░
ЁЯФД => ЁЯФД, рмШрмгрнНрмЯрм╛рм░ рмЧрмдрм┐рм░ рммрм┐рмкрм░рнАрмд рмжрм┐рмЧрм░рнЗ рмдрнАрм░, рмШрмгрнНрмЯрм╛рм░ рмЧрмдрм┐рм░ рммрм┐рмкрм░рнАрмд рмжрм┐рмЧ, рмдрнАрм░
ЁЯФЩ => ЁЯФЩ, рмкрм╢рнНрмЪрнНрнЯрм╛рмдрнН, рмкрм╢рнНрмЪрнНрнЯрм╛рмдрнН рмдрнАрм░, рммрм╛рмо рмдрнАрм░ рм╕рм╣рм┐рмд рмкрм╢рнНрмЪрнНрнЯрм╛рмдрнН, рммрм╛рмо рмдрнАрм░, рмдрнАрм░
ЁЯФЪ => ЁЯФЪ, рм╢рнЗрм╖, рм╢рнЗрм╖ рмдрнАрм░, рммрм╛рмо рмдрнАрм░ рм╕рм╣рм┐рмд рм╢рнЗрм╖, рммрм╛рмо рмдрнАрм░, рмдрнАрм░
ЁЯФЫ => ЁЯФЫ, рмЕрмирнН рмдрнАрм░, рмЕрмирнН рм╕рм╣рм┐рмд рммрм┐рм╕рнНрморнЯрм╕рнВрмЪрмХ рмЪрм┐рм╣рнНрми рмПрммрмВ рмдрнАрм░, рмдрнАрм░, рммрм┐рм╕рнНрморнЯрм╕рнВрмЪрмХ рмЪрм┐рм╣рнНрми, рммрм┐рм╕рнНрморнЯрм╕рнВрмЪрмХ
ЁЯФЬ => ЁЯФЬ, рм╢рнАрмШрнНрм░ рмЪрм┐рм╣рнНрми, рм╢рнАрмШрнНрм░, рммрм╛рмо рмдрнАрм░ рм╕рм╣рм┐рмд рм╢рнАрмШрнНрм░, рмдрнАрм░
ЁЯФЭ => ЁЯФЭ, рм╢рнАрм░рнНрм╖ рмЪрм┐рм╣рнНрми, рм╢рнАрм░рнНрм╖, рмПрмХ рмЙрмкрм░ рмдрнАрм░ рм╕рм╣рм┐рмд рм╢рнАрм░рнНрм╖, рмЙрмкрм░ рмдрнАрм░, рмЙрмкрм░
ЁЯФп => ЁЯФп, рмЫрмЕ рморнБрм╣рм╛рмБ рмдрм╛рм░рм╛, рмлрм░рнНрмЪрнНрнЯрнБрмирнН рмЯрнЗрм▓рм┐рмВ, рмЫрмЕ рморнБрм╣рм╛рмБ, рмдрм╛рм░рм╛, рмлрм░рнНрмЪрнНрнЯрнБрмирнН
тЩ╗ => тЩ╗, рм░рм┐рм╕рм╛рмЗрмХрнЗрм▓рм┐рмВ рмЪрм┐рм╣рнНрми, рм╕рм▓рм┐рмбрнН рнЯрнБрмирм┐рмнрм░рнНрм╕рм┐рмЖрм▓рнН рм░рм┐рм╕рм╛рмЗрмХрнЗрм▓рм┐рмВ рмЪрм┐рм╣рнНрми, рм░рм┐рм╕рм╛рмЗрмХрнЗрм▓рм┐рмВ, рнЯрнБрмирм┐рмнрм░рнНрм╕рм┐рмЖрм▓рнН, рмЪрм┐рм╣рнНрми
ЁЯУЫ => ЁЯУЫ, рмирм╛рмо рммрнНрнЯрм╛рмЬрнН, рммрнНрнЯрм╛рмЬрнН, рмирм╛рмо
ЁЯФ░ => ЁЯФ░, рм╕рммрнБрмЬ рмПрммрмВ рм╣рм│рмжрм┐рмЖ рмкрмдрнНрм░, рм╕рммрнБрмЬ рмПрммрмВ рм╣рм│рмжрм┐рмЖ, рм╢рм┐рмХрнНрм╖рм╛рм░рнНрмернА, рмЬрм╛рмкрм╛рмирнА
ЁЯФ▒ => ЁЯФ▒, рмЯрнНрм░рм┐рмбрнЗрмгрнНрмЯрнН рмЪрм┐рм╣рнНрми, рмПрмЩрнНрмХрм░рнН, рмЯрнНрм░рм┐рмбрнЗрмгрнНрмЯрнН, рмПрморммрнНрм▓рнЗрморнН
тЬЕ => тЬЕ, рмарм┐рмХрнН рмЪрм┐рм╣рнНрми, рмпрм╛рмЮрнНрмЪ, рмЧрм╛рмв рмарм┐рмХрнН рмЪрм┐рм╣рнНрми
тЭМ => тЭМ, рмЫрмХрм┐ рмЪрм┐рм╣рнНрми, тАЬXтАЭ
тЭО => тЭО, рмЫрмХрм┐ рмЪрм┐рм╣рнНрми, рмЪрмдрнБрм░рнНрмнрнБрмЬрм░рнЗ тАЬXтАЭ
тЮХ => тЮХ, рмпрнБрмХрнНрмд, рмЧрм╛рмв рмпрнБрмХрнНрмд рмЪрм┐рм╣рнНрми, рмпрнБрмХрнНрмд рмЪрм┐рм╣рнНрми, рмЪрм┐рм╣рнНрми
тЮЦ => тЮЦ, рммрм┐рмпрнБрмХрнНрмд, рмЧрм╛рмв рммрм┐рмпрнБрмХрнНрмд рмЪрм┐рм╣рнНрми, рммрм┐рмпрнБрмХрнНрмд рмЪрм┐рм╣рнНрми, рмЪрм┐рм╣рнНрми
тЮЧ => тЮЧ, рммрм┐рмнрмХрнНрмд, рмЧрм╛рмв рммрм┐рмнрмХрнНрмд рмЪрм┐рм╣рнНрми, рммрм┐рмнрмХрнНрмд рмЪрм┐рм╣рнНрми, рмЪрм┐рм╣рнНрми
тЮ░ => тЮ░, рмХрнБрмЮрнНрмЪрм┐рмд рм▓рнБрмкрнН, рмШрнБрм░рм╛рмЗрммрм╛, рм▓рнБрмкрнН
тЮ┐ => тЮ┐, рмЧрм╛рмв рмХрнБрмЮрнНрмЪрм┐рмд рм▓рнБрмкрнН, рмХрнБрмЮрнНрмЪрм┐рмд рм▓рнБрмкрнН, рмЬрм╛рмкрм╛рми, рморнБрмХрнНрмд рмбрм╛рмПрм▓рнН
ЁЯТ▒ => ЁЯТ▒, рморнБрмжрнНрм░рм╛ рммрм┐рмирм┐рморнЯ, рморнБрмжрнНрм░рм╛, рмЯрмЩрнНрмХрм╛, рммрм┐рмирм┐рморнЯ
ЁЯТ▓ => ЁЯТ▓, рмбрм▓рм╛рм░рнН рмЪрм┐рм╣рнНрми, рммрнЛрм▓рнНрмбрнН рмбрм▓рм╛рм░рнН рмЪрм┐рм╣рнНрми, рмбрм▓рм╛рм░рнН, рмЯрмЩрнНрмХрм╛
тЭУ => тЭУ, рмкрнНрм░рм╢рнНрми рммрм╛рмЪрмХ рмЪрм┐рм╣рнНрми, рмкрнНрм░рм╢рнНрми
тЭФ => тЭФ, рмкрнНрм░рм╢рнНрми рммрм╛рмЪрмХ рмЪрм┐рм╣рнНрми, рмкрнНрм░рм╢рнНрми
тЭХ => тЭХ, рммрм┐рм╕рнНрморнЯрм╕рнВрмЪрмХ рмЪрм┐рм╣рнНрми, рммрм┐рм╕рнНрморнЯрм╕рнВрмЪрмХ
уА░ => уА░, рмдрм░рмЩрнНрмЧрморнЯ рмбрнНрнЯрм╛рм╕рнН, рм▓рморнНрм╡рм╛ рм╢рмжрнНрмж рмЪрм┐рм╣рнНрми, рмдрм░рмЩрнНрмЧрморнЯ, рмбрнНрнЯрм╛рм╕рнН
┬й => ┬й, рмХрмкрм┐рм░рм╛рмЗрмЯрнН рмЪрм┐рм╣рнНрми, рмХрмкрм┐рм░рм╛рмЗрмЯрнН
┬о => ┬о, рмкрмЮрнНрмЬрм┐рмХрнГрмд рм╣рнЛрмЗрмерм┐рммрм╛ рмЪрм┐рм╣рнНрми, рмкрмЮрнНрмЬрм┐рмХрнГрмд рм╣рнЛрмЗрмЫрм┐
тДв => тДв, рмЯрнНрм░рнЗрмбрнН рморм╛рм░рнНрмХрнН рмЪрм┐рм╣рнНрми, рмЯрнНрм░рнЗрмбрнН рморм╛рм░рнНрмХрнН, рмЪрм┐рм╣рнНрми
тЩИ => тЩИ, рморнЗрм╖, рм░рм╛рм╢рм┐рмлрм│
тЩЙ => тЩЙ, рммрнГрм╖, рм░рм╛рм╢рм┐рмлрм│
тЩК => тЩК, рморм┐рмернБрми, рм░рм╛рм╢рм┐рмлрм│
тЩЛ => тЩЛ, рмХрм░рнНрмХрмЯ, рм░рм╛рм╢рм┐рмлрм│
тЩМ => тЩМ, рм╕рм┐рмВрм╣, рм░рм╛рм╢рм┐рмлрм│
тЩН => тЩН, рмХрмирнНрнЯрм╛, рм░рм╛рм╢рм┐рмлрм│
тЩО => тЩО, рмдрнБрм│рм╛, рм░рм╛рм╢рм┐рмлрм│
тЩП => тЩП, рммрм┐рмЫрм╛, рм░рм╛рм╢рм┐рмлрм│
тЩР => тЩР, рмзрмирнБ, рм░рм╛рм╢рм┐рмлрм│
тЩС => тЩС, рмормХрм░, рм░рм╛рм╢рм┐рмлрм│
тЩТ => тЩТ, рмХрнБрморнНрмн, рм░рм╛рм╢рм┐рмлрм│
тЩУ => тЩУ, рморнАрми, рм░рм╛рм╢рм┐рмлрм│
тЫО => тЫО, рмУрмкрм╣рм┐рмЙрмЪрнБрм╕рнН, рм░рм╛рм╢рм┐рмлрм│
ЁЯФА => ЁЯФА, рмХрнНрм░рм╕рнН рмдрнАрм░, рмХрнНрм░рм╕рнН рмбрм╛рм╣рм╛рмг рмдрнАрм░, рмдрнАрм░
ЁЯФБ => ЁЯФБ, рмШрмгрнНрмЯрм╛рм░ рмЧрмдрм┐ рмжрм┐рмЧрм░рнЗ рмдрнАрм░, рмШрмгрнНрмЯрм╛рм░ рмЧрмдрм┐ рмжрм┐рмЧ, рмдрнАрм░
ЁЯФВ => ЁЯФВ, рмШрмгрнНрмЯрм╛рм░ рмЧрмдрм┐ рмжрм┐рмЧрм░рнЗ рмдрнАрм░, рм╕рмВрмЦрнНрнЯрм╛ 1 рм╕рм╣рм┐рмд рмШрмгрнНрмЯрм╛рм░ рмЧрмдрм┐ рмжрм┐рмЧрм░рнЗ рмдрнАрм░, рмШрмгрнНрмЯрм╛рм░ рмЧрмдрм┐ рмжрм┐рмЧ, рмдрнАрм░, рм╕рмВрмЦрнНрнЯрм╛ 1
тПй => тПй, рмлрм╛рм╖рнНрмЯрнН рмлрм░рн▒рм╛рм░рнНрмбрнН, рмбрммрм▓рнН рм░рм╛рмЗрмЯрнН рмдрнАрм░, рм░рм╛рмЗрмЯрнН, рмдрнАрм░
тПк => тПк, рмкрмЫрмХрнБ рмирнЗрммрм╛, рмжрнБрмЗрмЯрм┐ рммрм╛рмо рмдрнАрм░, рммрм╛рмо, рмдрнАрм░
ЁЯФ╝ => ЁЯФ╝, рмЙрмкрм░ рмдрнНрм░рм┐рмХрнЛрмг, рмЙрмкрм░ рмдрнНрм░рм┐рмХрнЛрмг рммрмЯрмирнН, рмдрнНрм░рм┐рмХрнЛрмг, рммрмЯрмирнН
тПл => тПл, рмЙрмкрм░ рмдрнАрм░, рмжрнБрмЗрмЯрм┐ рмЙрмкрм░ рмдрнАрм░, рмЙрмкрм░, рмдрнАрм░
ЁЯФ╜ => ЁЯФ╜, рмдрм│ рмдрнНрм░рм┐рмХрнЛрмг, рмдрм│ рмдрнНрм░рм┐рмХрнЛрмг рммрмЯрмирнН, рмдрнНрм░рм┐рмХрнЛрмг, рммрмЯрмирнН
тПм => тПм, рмдрм│рмХрнБ рмдрнАрм░, рмжрнБрмЗрмЯрм┐ рмдрм╛рм│рмХрнБ рмдрнАрм░, рмдрм│рмХрнБ, рмдрнАрм░
ЁЯОж => ЁЯОж, рмЪрм│рмЪрнНрмЪрм┐рмдрнНрм░, рм╕рм┐рмирнЗрморм╛, рмЪрм│рмЪрнНрмЪрм┐рмдрнНрм░ рмЪрм┐рм╣рнНрми, рмормирнЛрм░рмЮрнНрмЬрми
ЁЯФЕ => ЁЯФЕ, рмХрморнН рмФрмЬрм▓рнНрнЯрмдрм╛, рмХрморнН, рмЕрмдрм┐рмХрморнН, рмХрморнН рмФрмЬрм▓рнНрнЯрмдрм╛ рмЪрм┐рм╣рнНрми, рмФрмЬрм▓рнНрнЯрмдрм╛
ЁЯФЖ => ЁЯФЖ, рмЕрмзрм┐рмХ рмФрмЬрм▓рнНрнЯрмдрм╛, рмФрмЬрм▓рнНрнЯрмдрм╛, рмЕрмзрм┐рмХ рмФрмЬрм▓рнНрнЯрмдрм╛ рмЪрм┐рм╣рнНрми
ЁЯУ╢ => ЁЯУ╢, рморнЛрммрм╛рмЗрм▓рнН рм╕рм┐рмЧрнНтАМрмирм╛рм▓рнН, рммрм╛рм░рнН рм╕рм╣рм┐рмд рмЖрмгрнНрмЯрм┐рмирм╛, рм╕рм┐рмЧрнНтАМрмирм╛рм▓рнН рмжрмХрнНрм╖рмдрм╛, рм╕рм┐рмЧрнНтАМрмирм╛рм▓рнН, рмЖрмгрнНрмЯрм┐рмирм╛, рморнЛрммрм╛рмЗрм▓рнН, рмлрнЛрмирнН
ЁЯУ╡ => ЁЯУ╡, рмХрнМрмгрм╕рм┐ рм╕рнЗрм▓рнН рмлрнЛрмирнН рмирм╛рм╣рм┐рмБ, рмХрнМрмгрм╕рм┐ рмХрм▓рнН рмирм╛рм╣рм┐рмБ, рморнЛрммрм╛рмЗрм▓рнН, рмлрнЛрмирнН
ЁЯУ│ => ЁЯУ│, рмнрм╛рмЗрммрнНрм░рнЗрм╕рмирнН рморнЛрмбрнН, рм╕рнЗрм▓рнН рмлрнЛрмирнН, рморнЛрммрм╛рмЗрм▓рнН, рмлрнЛрмирнН, рморнЛрмбрнН
ЁЯУ┤ => ЁЯУ┤, рмлрнЛрмирнН рммрмирнНрмж, рм╕рнЗрм▓рнН рмлрнЛрмирнН рммрмирнНрмж, рм╕рнЗрм▓рнН рмлрнЛрмирнН, рморнЛрммрм╛рмЗрм▓рнН, рмлрнЛрмирнН, рмЕрмлрнН
ЁЯФЯ => ЁЯФЯ, рмХрнАрмХрнНрнЯрм╛рмкрнН рмжрм╢, 10
ЁЯТп => ЁЯТп, рмкрнВрм░рнНрмгрнНрмг рм╕рнНрмХрнЛрм░рнН, 100 рмкрмПрмгрнНрмЯрнН, 100, рм╕рнНрмХрнЛрм░рнН
ЁЯФЮ => ЁЯФЮ, 18 рм░рнБ рмХрморнН рмХрнЗрм╣рм┐ рмирнБрм╣рнЗрмБ, 18 рм░рнБ рмХрморнН рмкрнНрм░рмдрм┐рммрмирнНрмзрм┐рмд, 18 рм░рнБ рмХрморнН, 18
ЁЯФа => ЁЯФа, рмЕрмкрм░рнНтАМрмХрнЗрм╕рнН рмЕрмХрнНрм╖рм░рмЧрнБрмбрм┐рмХ, рмЗрмирнНтАМрмкрнБрмЯрнН рмЕрмкрм░рнНтАМрмХрнЗрм╕рнН рм▓рм╛рмЯрм┐рмирнН, рмЕрмкрм░рнНтАМрмХрнЗрм╕рнН рм▓рм╛рмЯрм┐рмирнН, рмЕрмкрм░рнНтАМрмХрнЗрм╕рнН, рм▓рм╛рмЯрм┐рмирнН
ЁЯФб => ЁЯФб, рм▓рнЛрнЯрм░рнНтАМрмХрнЗрм╕рнН рмЕрмХрнНрм╖рм░рмЧрнБрмбрм┐рмХ, рмЗрмирнНтАМрмкрнБрмЯрнН рм▓рнЛрнЯрм░рнНтАМрмХрнЗрм╕рнН рм▓рм╛рмЯрм┐рмирнН, рм▓рнЛрнЯрм░рнНтАМрмХрнЗрм╕рнН рм▓рм╛рмЯрм┐рмирнН, рм▓рнЛрнЯрм░рнНтАМрмХрнЗрм╕рнН, рм▓рм╛рмЯрм┐рмирнН
ЁЯФв => ЁЯФв, рм╕рмВрмЦрнНрнЯрм╛, рмЗрмирнНтАМрмкрнБрмЯрнН рм╕рмВрмЦрнНрнЯрм╛рмЧрнБрмбрм┐рмХ
ЁЯФг => ЁЯФг, рмЪрм┐рм╣рнНрмирмЧрнБрмбрм┐рмХ, рмЗрмирнНтАМрмкрнБрмЯрнН рмЪрм┐рм╣рнНрмирмЧрнБрмбрм┐рмХ
ЁЯФд => ЁЯФд, рм▓рм╛рмЯрм┐рмирнН рммрм░рнНрмгрнНрмгрморм╛рм│рм╛, рмЗрмирнНтАМрмкрнБрмЯрнН рм▓рм╛рмЯрм┐рмирнН рммрм░рнНрмгрнНрмгрморм╛рм│рм╛, рм▓рм╛рмЯрм┐рмирнН, рмЗрмВрм░рм╛рмЬрнА, ABC
ЁЯЕ░ => ЁЯЕ░, рм░рмХрнНрмд рмкрнНрм░рмХрм╛рм░ A, рмкрнНрм░рмХрм╛рм░ A, рм░рмХрнНрмд рмкрнНрм░рмХрм╛рм░, рм░рмХрнНрмд, A
ЁЯЖО => ЁЯЖО, рм░рмХрнНрмд рмкрнНрм░рмХрм╛рм░ AB, рмкрнНрм░рмХрм╛рм░ AB, рм░рмХрнНрмд рмкрнНрм░рмХрм╛рм░, рм░рмХрнНрмд, AB
ЁЯЕ▒ => ЁЯЕ▒, рм░рмХрнНрмд рмкрнНрм░рмХрм╛рм░ B, рмкрнНрм░рмХрм╛рм░ B, рм░рмХрнНрмд рмкрнНрм░рмХрм╛рм░, рм░рмХрнНрмд, B
ЁЯЖС => ЁЯЖС, CL, рм╕рмлрм╛, CL рмЪрм┐рм╣рнНрми
ЁЯЖТ => ЁЯЖТ, рм╢рм╛рмирнНрмд, рм╢рм╛рмирнНрмд рмЪрм┐рм╣рнНрми
ЁЯЖУ => ЁЯЖУ, рморм╛рмЧрмгрм╛, рморм╛рмЧрмгрм╛ рмЪрм┐рм╣рнНрми, рмЪрм┐рм╣рнНрми
ЁЯЖФ => ЁЯЖФ, ID, ID рмЪрм┐рм╣рнНрми, рмкрм░рм┐рмЪрнЯ, рмЪрм┐рм╣рнНрми
ЁЯЖХ => ЁЯЖХ, рмирнВрмдрми, рмирнВрмдрми рмЪрм┐рм╣рнНрми, рмЪрм┐рм╣рнНрми
ЁЯЖЦ => ЁЯЖЦ, NG, NG рмЪрм┐рм╣рнНрми, рмЪрм┐рм╣рнНрми
ЁЯЕ╛ => ЁЯЕ╛, рм░рмХрнНрмд рмкрнНрм░рмХрм╛рм░ O, рмкрнНрм░рмХрм╛рм░ O, рм░рмХрнНрмд рмкрнНрм░рмХрм╛рм░, рм░рмХрнНрмд, O
ЁЯЖЧ => ЁЯЖЧ, рмУрмХрнЗ, рмУрмХрнЗ рмЪрм┐рм╣рнНрми
ЁЯЕ┐ => ЁЯЕ┐, рмкрм╛рм░рнНрмХрм┐рмВ, рмкрм╛рм░рнНрмХрм┐рмВ рм╕рнНрмерм╛рми
ЁЯЖШ => ЁЯЖШ, SOS, SOS рмЪрм┐рм╣рнНрми, рм╕рм╣рм╛рнЯрмдрм╛, рмЪрм┐рм╣рнНрми
ЁЯЖЩ => ЁЯЖЩ, UP!, UP! рмЪрм┐рм╣рнНрми, рмЪрм┐рм╣рнНрми
ЁЯЖЪ => ЁЯЖЪ, рммрмирм╛рмо, рммрмирм╛рмо рмЪрм┐рм╣рнНрми, рмЪрм┐рм╣рнНрми
ЁЯИБ => ЁЯИБ, рмЬрм╛рмкрм╛рмирнА рм╢рмжрнНрмж
ЁЯИВ => ЁЯИВ, рмЬрм╛рмкрм╛рмирнА рм╢рмжрнНрмж
ЁЯИ╖ => ЁЯИ╖, рмЬрм╛рмкрм╛рмирнА рм╢рмжрнНрмж
ЁЯИ╢ => ЁЯИ╢, рмЬрм╛рмкрм╛рмирнА рм╢рмжрнНрмж
ЁЯИп => ЁЯИп, рмЬрм╛рмкрм╛рмирнА рм╢рмжрнНрмж
ЁЯЙР => ЁЯЙР, рмЬрм╛рмкрм╛рмирнА рм╢рмжрнНрмж
ЁЯИ╣ => ЁЯИ╣, рмЬрм╛рмкрм╛рмирнА рм╢рмжрнНрмж
ЁЯИЪ => ЁЯИЪ, рмЬрм╛рмкрм╛рмирнА рм╢рмжрнНрмж
ЁЯИ▓ => ЁЯИ▓, рмЬрм╛рмкрм╛рмирнА рм╢рмжрнНрмж
ЁЯЙС => ЁЯЙС, рмЪрнАрмирм┐рнЯ рм╢рмжрнНрмж
ЁЯИ╕ => ЁЯИ╕, рмЪрнАрмирм┐рнЯ рм╢рмжрнНрмж
ЁЯИ┤ => ЁЯИ┤, рмЪрнАрмирм┐рнЯ рм╢рмжрнНрмж
ЁЯИ│ => ЁЯИ│, рмЪрнАрмирм┐рнЯ рм╢рмжрнНрмж
ЁЯИ║ => ЁЯИ║, рмЪрнАрмирм┐рнЯ рм╢рмжрнНрмж
ЁЯИ╡ => ЁЯИ╡, рмЪрнАрмирм┐рнЯ рм╢рмжрнНрмж
ЁЯФ╢ => ЁЯФ╢, рммрнГрм╣рмдрнН рм╣рнАрм░рм╛, рммрнГрм╣рмдрнН рмХрморм│рм╛ рм╣рнАрм░рм╛, рмХрморм│рм╛ рм░рмЩрнНрмЧ, рм╣рнАрм░рм╛
ЁЯФ╖ => ЁЯФ╖, рммрнГрм╣рмдрнН рм╣рнАрм░рм╛, рммрнГрм╣рмдрнН рмирнАрм│ рм╣рнАрм░рм╛, рмирнАрм│, рм╣рнАрм░рм╛
ЁЯФ╕ => ЁЯФ╕, рмЫрнЛрмЯ рм╣рнАрм░рм╛, рмЫрнЛрмЯ рмХрморм│рм╛ рм╣рнАрм░рм╛, рмХрморм│рм╛ рм░рмЩрнНрмЧ, рм╣рнАрм░рм╛
ЁЯФ╣ => ЁЯФ╣, рмЫрнЛрмЯ рм╣рнАрм░рм╛, рмЫрнЛрмЯ рмирнАрм│ рм╣рнАрм░рм╛, рмирнАрм│, рм╣рнАрм░рм╛
ЁЯФ║ => ЁЯФ║, рмЙрмкрм░ рмдрнНрм░рм┐рмХрнЛрмг, рмЙрмкрм░ рм▓рм╛рм▓рнН рмдрнНрм░рм┐рмХрнЛрмг, рм▓рм╛рм▓рнН, рмдрнНрм░рм┐рмХрнЛрмг
ЁЯФ╗ => ЁЯФ╗, рмдрм│ рмдрнНрм░рм┐рмХрнЛрмг, рмдрм│ рм▓рм╛рм▓рнН рмдрнНрм░рм┐рмХрнЛрмг, рм▓рм╛рм▓рнН, рмдрнНрм░рм┐рмХрнЛрмг
ЁЯТа => ЁЯТа, рмлрнБрм▓ рмкрм╛рмЦрнБрмбрм╛, рмЕрмдрм┐ рм╕рнБрмирнНрмжрм░, рмлрнБрм▓, рм╣рнАрм░рм╛ рмЖрмХрнГрмдрм┐, рм╣рнАрм░рм╛, рмнрм╛рммрмирм╛
ЁЯФШ => ЁЯФШ, рм░рнЗрмбрм┐рмУ рммрмЯрмирнН, рммрмЯрмирнН, рм░рнЗрмбрм┐рмУ
ЁЯФ▓ => ЁЯФ▓, рмЪрмдрнБрм░рнНрмнрнБрмЬ рммрмЯрмирнН, рмЪрмдрнБрм░рнНрмнрнБрмЬ, рммрмЯрмирнН
ЁЯФ│ => ЁЯФ│, рмЪрмдрнБрм░рнНрмнрнБрмЬ рммрмЯрмирнН, рмЪрмдрнБрм░рнНрмнрнБрмЬ, рммрмЯрмирнН
ЁЯФ┤ => ЁЯФ┤, рммрнГрм╣рмдрнН рммрнГрмдрнНрмд, рммрнГрм╣рмдрнН рм▓рм╛рм▓рнН рммрнГрмдрнНрмд, рм▓рм╛рм▓рнН, рммрнГрмдрнНрмд
ЁЯФ╡ => ЁЯФ╡, рммрнГрм╣рмдрнН рммрнГрмдрнНрмд, рммрнГрм╣рмдрнН рмирнАрм│ рммрнГрмдрнНрмд, рмирнАрм│, рммрнГрмдрнНрмд
