тЩА => тЩА, ржорж╣рж┐рж▓рж╛, рж╕рзНрждрзНрж░рж┐
тЩВ => тЩВ, ржкрзБрж░рзБрж╖, ржЫрзЗрж▓рзЗ
тЪХ => тЪХ, ржЕрзНржпрж╛рж╕ржХрзНрж▓рж┐ржкрж┐ржпрж╝рж╕, ржФржпржж, ржЪрж┐ржХрж┐рзОрж╕рж╛, рж╕рзНржЯрж╛ржл
ЁЯХ║ => ЁЯХ║, ржирж╛ржЪржЫрзЗ, ржкрзБрж░рзБрж╖
ЁЯЦд => ЁЯЦд, ржХрж╛рж▓рзЛ, рж╣рж╛рж░рзНржЯ, ржжрзБрж╖рзНржЯ, ржмрж╛ржЬрзЗ
ЁЯдЩ => ЁЯдЩ, ржХрж▓, рж╣рж╛ржд
ЁЯдЪ => ЁЯдЪ, рж╣рж╛рждрзЗрж░ ржкрзЗржЫржи ржжрж┐ржХ, рж╣рж╛ржд рждрзЛрж▓рж╛
ЁЯдЫ => ЁЯдЫ, ржШрзБржБрж╖рж┐, ржмрж╛ржБржжрж┐ржХрзЗ
ЁЯдЬ => ЁЯдЬ, ржШрзБржБрж╖рж┐, ржбрж╛ржиржжрж┐ржХрзЗ
ЁЯдЭ => ЁЯдЭ, ржХрж░ржорж░рзНржжржи, рж░рж╛ржЬрж┐, ржорж┐ржЯ ржХрж░рж╛, рж╣рж╛ржд ржорзЗрж▓рж╛ржирзЛ, рж╣рж╛ржд
ЁЯдЮ => ЁЯдЮ, ржЖрж╢рж╛ ржХрж░рж┐, ржЖржЩрзНржЧрзБрж▓, ржнрж╛ржЧрзНржп
ЁЯда => ЁЯда, ржХрж╛ржЙржмржпрж╝, ржорзБржЦ, ржЯрзБржкрж┐, ржХрж╛ржЙржЧрж╛рж░рзНрж▓
ЁЯдб => ЁЯдб, ржЬрзЛржХрж╛рж░, ржорзБржЦ
ЁЯдв => ЁЯдв, ржорзБржЦ, ржмржорж┐ ржмржорж┐ ржнрж╛ржЧ, ржмржорж┐
ЁЯдг => ЁЯдг, ржорж╛ржЯрж┐, рж╣рж╛рж╕рж┐, ржЧржбрж╝рж╛ржЧржбрж╝рж┐, ржорзБржЦ
ЁЯдд => ЁЯдд, рж▓рзЛржнрзА, ржорзБржЦ
ЁЯде => ЁЯде, ржорзБржЦ, ржорж┐ржерзНржпрж╛, ржкрж┐ржирж╛ржХрж┐ржУ
ЁЯдж => ЁЯдж, ржорж╛ржерж╛ржпрж╝, рж╣рж╛ржд, ржЕржмрж┐рж╢рзНржмрж╛рж╕, ржмрж┐рж░ржХрзНрждрж┐
ЁЯджтАНтЩА => ЁЯджтАНтЩА, ржЕржмрж┐рж╢рзНржмрж╛рж╕, ржХрзНрж░рзЛржз, ржорж╛ржерж╛ржпрж╝ рж╣рж╛ржд, ржХржкрж╛рж▓рзЗ рж╣рж╛ржд, ржорж╣рж┐рж▓рж╛, ржорзЗржпрж╝рзЗ
ЁЯджтАНтЩВ => ЁЯджтАНтЩВ, ржЕржмрж┐рж╢рзНржмрж╛рж╕, ржХрзНрж░рзЛржз, ржорж╛ржерж╛ржпрж╝ рж╣рж╛ржд, ржХржкрж╛рж▓рзЗ рж╣рж╛ржд, ржкрзБрж░рзБрж╖, ржЫрзЗрж▓рзЗ
ЁЯдз => ЁЯдз, ржорзБржЦ, ржнрж╛рж▓ ржерж╛ржХ, рж╣рж╛ржБржЪрж┐
ЁЯд░ => ЁЯд░, ржЧрж░рзНржнржмрждрзА, ржорж╣рж┐рж▓рж╛
ЁЯд│ => ЁЯд│, рж╕рзЗрж▓ржлрж┐, ржХрзНржпрж╛ржорзЗрж░рж╛, ржлрзЛржи
ЁЯд┤ => ЁЯд┤, рж░рж╛ржЬржкрзБрждрзНрж░
ЁЯд╡ => ЁЯд╡, рж╕рзБрж╕ржЬрзНржЬрж┐ржд, ржкрзБрж░рзБрж╖, рж╕рзБржЯ
ЁЯд╢ => ЁЯд╢, ржорж┐рж╕рзЗрж╕ ржХрзНрж▓ржЬ, ржЦрзНрж░рж┐рж╖рзНржЯржорж╛рж╕, ржорж╛
ЁЯд╖ => ЁЯд╖, ржХрж╛ржБржз ржирж╛ржбрж╝рж┐ржпрж╝рзЗ ржЙрждрзНрждрж░рж▓ ржжрзЗржУржпрж╝рж╛, ржЕржирж┐рж╢рзНржЪрж┐ржд, ржЕржЬрзНржЮрж╛ржи, ржЙржжрж╛рж╕рзАржирждрж╛
ЁЯд╖тАНтЩА => ЁЯд╖тАНтЩА, рж╕ржирзНржжрзЗрж╣, рж╕ржВрж╢ржпрж╝, ржЕржмрж┐рж╢рзНржмрж╛рж╕, ржЙржжрж╛рж╕рзАржирждрж╛, ржорж╣рж┐рж▓рж╛, ржорзЗржпрж╝рзЗ, ржХрж╛ржБржз ржЭрж╛ржБржХрж╛ржирзЛ
ЁЯд╖тАНтЩВ => ЁЯд╖тАНтЩВ, рж╕ржирзНржжрзЗрж╣, рж╕ржВрж╢ржпрж╝, ржЕржмрж┐рж╢рзНржмрж╛рж╕, ржЙржжрж╛рж╕рзАржирждрж╛, ржкрзБрж░рзБрж╖, ржЫрзЗрж▓рзЗ, ржХрж╛ржБржз ржЭрж╛ржБржХрж╛ржирзЛ
ЁЯд╕ => ЁЯд╕, ржХрж╛рж░рзНржЯрж╣рзБржЗрж▓, ржЬрж┐ржоржирзНржпрж╛рж╕рзНржЯ, ржмрзНржпржХрзНрждрж┐, ржЦрзЗрж▓рж╛
ЁЯд╕тАНтЩА => ЁЯд╕тАНтЩА, ржХрж╛рж░рзНржЯрж╣рзБржЗрж▓, ржЬрж┐ржоржирзНржпрж╛рж╕рзНржЯрж┐ржХ, ржорж╣рж┐рж▓рж╛, ржмрзНржпржХрзНрждрж┐, ржЦрзЗрж▓рж╛ржзрзБрж▓рж╛
ЁЯд╕тАНтЩВ => ЁЯд╕тАНтЩВ, ржХрж╛рж░рзНржЯрж╣рзБржЗрж▓, ржЬрж┐ржоржирзНржпрж╛рж╕рзНржЯрж┐ржХ, ржкрзБрж░рзБрж╖, ржмрзНржпржХрзНрждрж┐, ржЦрзЗрж▓рж╛ржзрзБрж▓рж╛
ЁЯд╣ => ЁЯд╣, ржЬрж╛ржЧрж▓рж┐ржВ, ржПржХ рж╕рж╛ржерзЗ ржЕржирзЗржХржЧрзБрж▓рзЛ ржХрж╛ржЬ ржХрж░рж╛, ржмрзНржпрж╛рж▓рзЗржирзНрж╕, ржжржХрзНрж╖рждрж╛
ЁЯд╣тАНтЩА => ЁЯд╣тАНтЩА, ржЬрж╛ржЧрж▓рж┐ржВ, ржорж╣рж┐рж▓рж╛, ржПржХ рж╕рж╛ржерж╛ ржЕржирзЗржХржЧрзБрж▓рзЛ ржХрж╛ржЬ ржХрж░рж╛
ЁЯд╣тАНтЩВ => ЁЯд╣тАНтЩВ, ржЬрж╛ржЧрж▓рж┐ржВ, ржкрзБрж░рзБржп, ржПржХ рж╕рж╛ржерж╛ ржЕржирзЗржХржЧрзБрж▓рзЛ ржХрж╛ржЬ ржХрж░рж╛
ЁЯд║ => ЁЯд║, рждрж▓рзЛржпрж╝рж╛рж░ ржЦрзЗрж▓рзЛржпрж╝рж╛ржбрж╝, рждрж▓рзЛржпрж╝рж╛рж░ ржЦрзЗрж▓рж╛, рждрж▓рзЛржпрж╝рж╛рж░, ржЦрзЗрж▓рж╛, ржмрзНржпржХрзНрждрж┐
ЁЯд╝ => ЁЯд╝, ржХрзБрж╕рзНрждрж┐ржЧрзАрж░, ржХрзБрж╕рзНрждрж┐, ржЦрзЗрж▓рж╛, ржмрзНржпржХрзНрждрж┐
ЁЯд╝тАНтЩА => ЁЯд╝тАНтЩА, ржорж╣рж┐рж▓рж╛, ржмрзНржпржХрзНрждрж┐, ржЦрзЗрж▓рж╛ржзрзБрж▓рж╛, ржХрзБрж╕рзНрждрж┐
ЁЯд╝тАНтЩВ => ЁЯд╝тАНтЩВ, ржкрзБрж░рзБрж╖, ржХрзБрж╕рзНрждрж┐, ржЦрзЗрж▓рж╛ржзрзБрж▓рж╛, ржмрзНржпржХрзНрждрж┐
ЁЯд╜ => ЁЯд╜, ржкрзЛрж▓рзЛ, ржУржпрж╝рж╛ржЯрж╛рж░, ржЬрж▓, ржмрзНржпржХрзНрждрж┐, ржЦрзЗрж▓рж╛
ЁЯд╜тАНтЩА => ЁЯд╜тАНтЩА, ржорж╣рж┐рж▓рж╛, ржУржпрж╝рж╛ржЯрж╛рж░, ржЦрзЗрж▓рж╛, ржЬрж▓, ржкрзЛрж▓рзЛ, ржмрзНржпржХрзНрждрж┐
ЁЯд╜тАНтЩВ => ЁЯд╜тАНтЩВ, ржкрзБрж░рзБрж╖, ржУржпрж╝рж╛ржЯрж╛рж░, ржЦрзЗрж▓рж╛ржзрзБрж▓рж╛, ржЬрж▓, ржкрзЛрж▓рзЛ, ржмрзНржпржХрзНрждрж┐
ЁЯд╛ => ЁЯд╛, рж╣рзНржпрж╛ржирзНржбржмрж▓, ржмрж▓, ржЦрзЗрж▓рж╛, ржмрзНржпржХрзНрждрж┐
ЁЯд╛тАНтЩА => ЁЯд╛тАНтЩА, ржЦрзЗрж▓рж╛ржзрзБрж▓рж╛, ржорж╣рж┐рж▓рж╛, ржмрзНржпржХрзНрждрж┐, рж╣рзНржпрж╛ржирзНржбржмрж▓
ЁЯд╛тАНтЩВ => ЁЯд╛тАНтЩВ, ржЦрзЗрж▓рж╛ржзрзБрж▓рж╛, ржкрзБрж░рзБрж╖, ржмрзНржпржХрзНрждрж┐, рж╣рзНржпрж╛ржирзНржбржмрж▓
ЁЯеА => ЁЯеА, ржлрзБрж▓, ржирзЗрждрж╛ржирзЛ
ЁЯеБ => ЁЯеБ, ржбрзНрж░рж╛ржо, ржбрзНрж░рж╛ржорж╕рзНржЯрж┐ржХ, рж╕ржВржЧрзАржд
ЁЯеВ => ЁЯеВ, ржарзБржВржарж╛ржВ, ржЧрзНрж▓рж╛рж╕, ржЦрж╛ржУржпрж╝рж╛, ржЙржжржпрж╛ржкржи
ЁЯеГ => ЁЯеГ, ржЧрзНрж▓рж╛рж╕, ржЪржУржбрж╝рж╛ ржЧрзНрж▓рж╛рж╕, рж╣рзБржЗрж╕рзНржХрж┐, ржкрж╛ржирзАржпрж╝, рж╢ржЯ
ЁЯеД => ЁЯеД, ржЪрж╛ржоржЪ, ржХрж╛ржБржЯрж╛ ржЪрж╛ржоржЪ
ЁЯеЕ => ЁЯеЕ, ржЧрзЛрж▓, ржирзЗржЯ, ржЦрзЗрж▓рж╛
ЁЯеЗ => ЁЯеЗ, ржкрзНрж░ржержо, ржорзЛржирж╛рж░, ржорзЗржбрзЗрж▓
ЁЯеИ => ЁЯеИ, ржорзЗржбрзЗрж▓, ржжрзНржмрж┐рждрзАржпрж╝, рж░рзБржкрзЛ
ЁЯеЙ => ЁЯеЙ, ржмрзНрж░рзЛржЮрзНржЬ, ржорзЗржбрзЗрж▓, рждрзГрждрзАржпрж╝
ЁЯеК => ЁЯеК, ржмржХрзНрж╕рж┐ржВ, ржЧрзНрж▓рж╛ржмрзНрж╕, ржЦрзЗрж▓рж╛
ЁЯеЛ => ЁЯеЛ, ржЬрзБржбрзЛ, ржХрж╛рж░рж╛ржЯрзЗ, рждрж╛ржЗржХрзБржирзНржбрзЛ, ржорж╛рж░рзНрж╢рж╛рж▓ ржЖрж░рзНржЯрзЗрж░, ржЙржЗржирж┐ржлрж░рзНржо, ржЦрзЗрж▓рж╛
ЁЯеР => ЁЯеР, ржХрзНрж░рзЛрж╕рзЗржирзНржЯ, ржХрзНрж░рж┐рж╕рзЗржирзНржЯ рж░рзЛрж▓, ржлрж░рж╛рж╕рж┐, ржЦрж╛ржмрж╛рж░, ржкрж╛ржЙрж░рзБржЯрж┐
ЁЯеС => ЁЯеС, ржЕрзНржпрж╛ржнрзЛржХрзНржпрж╛ржбрзЛ, ржлрж▓, ржЦрж╛ржмрж╛рж░
ЁЯеТ => ЁЯеТ, рж╢рж╕рж╛, ржЖржЪрж╛рж░, рж╕ржмржЬрж┐, ржЦрж╛ржмрж╛рж░
ЁЯеУ => ЁЯеУ, ржмрзЗржХржи, ржорж╛ржВрж╢, ржЦрж╛ржмрж╛рж░
ЁЯеФ => ЁЯеФ, ржЖрж▓рзБ, рж╕ржмржЬрж┐, ржЦрж╛ржмрж╛рж░
ЁЯеХ => ЁЯеХ, ржЧрж╛ржЬрж░, рж╕ржмржЬрж┐, ржЦрж╛ржмрж╛рж░
ЁЯеЦ => ЁЯеЦ, ржмрзНржпрж╛ржЧрж╛ржЯ, ржкрж╛ржЙрж░рзБржЯрж┐, ржлрж░рж╛рж╕рж┐, ржЦрж╛ржмрж╛рж░
ЁЯеЧ => ЁЯеЧ, ржЧрзНрж░рж┐ржи, рж╕рзНржпрж╛рж▓рж╛ржж, ржЦрж╛ржмрж╛рж░
ЁЯеШ => ЁЯеШ, ржкрзЗржи, ржХрзНржпрж╛рж╕рж░рзЛрж▓, ржХржбрж╝рж╛, ржЦрж╛ржмрж╛рж░
ЁЯеЩ => ЁЯеЩ, ржХрж╛ржмрж╛ржм, ржлрж▓рж╛ржлрзЗрж▓, ржЧрж╛ржЗрж░рзЛ, ржЪрзЗржкрзНржЯрж╛рж░рзБржЯрж┐, ржкрзБрж░ржнрж░рж╛, ржЦрж╛ржмрж╛рж░
ЁЯеЪ => ЁЯеЪ, ржбрж┐ржо, ржЦрж╛ржмрж╛рж░
ЁЯеЫ => ЁЯеЫ, ржЧрзНрж▓рж╛рж╕, ржжрзБржз, ржерж╛ржУржпрж╝рж╛
ЁЯеЬ => ЁЯеЬ, ржЪрж┐ржирж╛ржмрж╛ржжрж╛ржо, ржмрж╛ржжрж╛ржо, ржЦрж╛ржмрж╛рж░, рж╕ржмржЬрж┐
ЁЯеЭ => ЁЯеЭ, ржХрж┐ржЙржЗ, ржлрж▓, ржЦрж╛ржмрж╛рж░
ЁЯеЮ => ЁЯеЮ, рж╣ржЯржХрзЗржХ, ржХрзНрж░рзЗржк, ржкрзНржпрж╛ржиржХрзЗржХ, ржЦрж╛ржмрж╛рж░
ЁЯжЕ => ЁЯжЕ, ржИржЧрж▓, ржкрж╛ржЦрж┐
ЁЯжЖ => ЁЯжЖ, рж╣рж╛ржБрж╕, ржкрж╛ржЦрж┐
ЁЯжЗ => ЁЯжЗ, ржмрж╛ржжрзБрж░, рж░ржХрзНрждржЪрзЛрж╖рж╛, ржкрж╢рзБ
ЁЯжИ => ЁЯжИ, рж╣рж╛ржЩрзНржЧрж░, ржорж╛ржЫ
ЁЯжЙ => ЁЯжЙ, ржкрзЗржБржЪрж╛, ржмрж┐ржЬрзНржЮ, ржкрж╛ржЦрж┐
ЁЯжК => ЁЯжК, рж╢рзЗржпрж╝рж╛рж▓, ржорзБржЦрзЛ, ржкрж╢рзБ
ЁЯжЛ => ЁЯжЛ, ржкрзНрж░ржЬрж╛ржкрждрж┐, ржкрждржЩрзНржЧ, рж╕рзБржирзНржжрж░
ЁЯжМ => ЁЯжМ, ржЩрж░рж┐ржг, ржкрж╢рзБ
ЁЯжН => ЁЯжН, ржЧрзЛрж░рж┐рж▓рж╛, ржкрж╢рзБ
ЁЯжО => ЁЯжО, ржЯрж┐ржХржЯрж┐ржХрж┐, рж╕рж░рзАрж╕рзГржк
ЁЯжП => ЁЯжП, ржЧржгрзНржбрж╛рж░, ржкрж╢рзБ
ЁЯжР => ЁЯжР, ржЪрж┐ржВржбрж╝рж┐, ржЫрзЛржЯ, ржЦрзЛрж▓рж╛ржУржпрж╝рж╛рж▓рж╛ ржорж╛ржЫ, ржЦрж╛ржмрж╛рж░
ЁЯжС => ЁЯжС, рж╕рзНржХрзБржЗржб, рж╢ржорзНржмрзБржХ ржХрзЛржорж▓рж╛ржЩрзНржЧ ржЬржирзНрждрзБ, ржЦрж╛ржмрж╛рж░
ЁЯША => ЁЯША, ржорзБржЦ, ржжрзЗржБрждрзЛ рж╣рж╛рж╕рж┐
ЁЯШБ => ЁЯШБ, ржЪрзЛржЦ, ржорзБржЦ, ржжрзЗржБрждрзЛ рж╣рж╛рж╕рж┐, рж╣рж╛рж╕рж┐
ЁЯШВ => ЁЯШВ, ржорзБржЦ, ржЖржиржирзНржж, ржЬрзЛрж░рзЗ рж╣рж╛рж╕рж╛, ржХрж╛ржирзНржирж╛
ЁЯШГ => ЁЯШГ, ржорзБржЦ, ржарзЛржБржЯ, ржЦрзЛрж▓рж╛, рж╣рж╛рж╕рж┐
ЁЯШД => ЁЯШД, ржЪрзЛржЦ, ржорзБржЦ, ржарзЛржБржЯ, ржЦрзЛрж▓рж╛, рж╣рж╛рж╕рж┐
ЁЯШЕ => ЁЯШЕ, ржарж╛ржирзНржбрж╛, ржорзБржЦ, ржЦрзЛрж▓рж╛, рж╣рж╛рж╕рж┐, ржШрж░рзНржорж╛ржХрзНржд ржЕржмрж╕рзНржерж╛
ЁЯШЖ => ЁЯШЖ, ржорзБржЦ, ржЬрзЛрж░рзЗ рж╣рж╛рж╕рж╛, ржарзЛржБржЯ, ржЦрзЛрж▓рж╛, рж╕ржирзНрждрзБрж╖рзНржЯ, рж╣рж╛рж╕рж┐
ЁЯШЙ => ЁЯШЙ, ржорзБржЦ
ЁЯШК => ЁЯШК, ржЧрж╛рж▓рзЗ рж▓ржЬрзНржЬрж╛рж░ ржЧрзЛрж▓рж╛ржкрзА ржЖржнрж╛, ржЪрзЛржЦ, ржорзБржЦ, рж╣рж╛рж╕рж┐
ЁЯШЛ => ЁЯШЛ, рж╕рзБрж╕рзНржмрж╛ржжрзБ, ржорзБржЦ, ржШрзНрж░рж╛ржг ржирзЗржУржпрж╝рж╛, рж╣рж╛рж╕рж┐, ржЙржо ржХрж░рзЗ ржЖржУржпрж╝рж╛ржЬ ржХрж░рж╛, ржЗржпрж╝рж╛ржо ржХрж░рзЗ ржЖржУржпрж╝рж╛ржЬ ржХрж░рж╛
ЁЯШО => ЁЯШО, ржЙржЬрзНржЬрзНржмрж▓, рж╢рзАрждрж▓, ржЪрзЛржЦ, ржЪрж╢ржорж╛, ржорзБржЦ, рж╣рж╛рж╕рж┐, рж╕рзВрж░рзНржп, рж╕рж╛ржиржЧрзНрж▓рж╛рж╕, ржЖржмрж╣рж╛ржУржпрж╝рж╛
ЁЯШН => ЁЯШН, ржЪрзЛржЦ, ржорзБржЦ, рж╣рж╛рж░рзНржЯ, ржнрж╛рж▓ржмрж╛рж╕рж╛, рж╣рж╛рж╕рж┐
ЁЯШШ => ЁЯШШ, ржорзБржЦ, рж╣рж╛рж░рзНржЯ, ржЪрзБржорзНржмржи
ЁЯШЧ => ЁЯШЧ, ржорзБржЦ, ржЪрзБржорзНржмржи
ЁЯШЩ => ЁЯШЩ, ржЪрзЛржЦ, ржорзБржЦ, ржЪрзБржорзНржмржи, рж╣рж╛рж╕рж┐
ЁЯШЪ => ЁЯШЪ, ржмржирзНржз, ржЪрзЛржЦ, ржорзБржЦ, ржЪрзБржорзНржмржи
тШ║ => тШ║, ржорзБржЦ, рж░рзВржкрж░рзЗржЦрж╛, ржирж┐рж╢рзНржЪрж┐ржирзНржд, рж╣рж╛рж╕рж┐
ЁЯЩВ => ЁЯЩВ, ржорзБржЦ, рж╣рж╛рж╕рж┐
ЁЯдЧ => ЁЯдЧ, ржорзБржЦ, ржЖрж▓рж┐ржЩрзНржЧржи, ржЧрж╛ржврж╝ ржЖрж▓рж┐ржЩрзНржЧржи
ЁЯШЗ => ЁЯШЗ, ржжрзЗржмржжрзВржд, ржорзБржЦ, рж░рзВржкржХржерж╛, ржХрж▓рзНржкржирж╛, ржЬрзНржпрзЛрждрж┐рж░рзНржмрж▓ржпрж╝, ржирж┐рж░рзАрж╣, рж╣рж╛рж╕рж┐
ЁЯдФ => ЁЯдФ, ржорзБржЦ, ржЪрж┐ржирзНрждрж┐ржд
ЁЯШР => ЁЯШР, ржнрж╛ржмрж▓рзЗрж╢рж╣рзАржи, ржорзБржЦ, ржирж┐рж░ржкрзЗржХрзНрж╖
ЁЯШС => ЁЯШС, ржнрж╛ржмрж╢рзВржирзНржп, ржорзБржЦ, ржЕрж░рзНржерж╣рзАржи, ржЕрж░рзНржерж╢рзВржирзНржп
ЁЯШ╢ => ЁЯШ╢, ржорзБржЦ, ржарзЛржБржЯ, рж╢рж╛ржирзНржд, ржирзАрж░ржм
ЁЯЩД => ЁЯЩД, ржЪрзЛржЦржжрзБтАШржЯрж┐, ржорзБржЦ, ржШрзВрж░рзНржгрж╛ржпрж╝ржорж╛ржи
ЁЯШП => ЁЯШП, ржорзБржЦ, ржмрзНржпржЩрзНржЧ ржХрж░рзЗ рж╣рж╛рж╕рж╛
ЁЯШг => ЁЯШг, ржорзБржЦ, ржЬрж┐ржж ржХрж░рж╛
ЁЯШе => ЁЯШе, рж╣рждрж╛рж╢, ржорзБржЦ, рж╕рзНржмрж╕рзНрждрж┐ ржкрж╛ржУржпрж╝рж╛, ржЖрж╢рзНржЪрж░рзНржп рж╣ржУржпрж╝рж╛
ЁЯШо => ЁЯШо, ржорзБржЦ, ржарзЛржБржЯ, ржЦрзЛрж▓рж╛, рж╕рж╣рж╛ржирзБржнрзВрждрж┐
ЁЯдР => ЁЯдР, ржорзБржЦ, ржарзЛржБржЯ, ржорзБржЦрзЗ ржХрзБрж▓рзБржк ржЖржБржЯрж╛
ЁЯШп => ЁЯШп, ржорзБржЦ, ржЪрзБржк ржХрж░рж╛рж░ ржЗржЩрзНржЧрж┐ржд ржХрж░рж╛, рж╣рждржнржорзНржм рж╣ржУржпрж╝рж╛, ржмрж┐рж╕рзНржорж┐ржд рж╣ржУржпрж╝рж╛
ЁЯШк => ЁЯШк, ржорзБржЦ, ржШрзБржоржирзНржд ржЕржмрж╕рзНржерж╛
ЁЯШл => ЁЯШл, ржорзБржЦ, ржХрзНрж▓рж╛ржирзНржд
ЁЯШ┤ => ЁЯШ┤, ржорзБржЦ, ржШрзБржоржирзНржд ржЕржмрж╕рзНржерж╛, ржирж╛ржХ ржбрж╛ржХрж╛
ЁЯШМ => ЁЯШМ, ржорзБржЦ, рж╕рзНржмрж╕рзНрждрж┐ ржкрж╛ржУржпрж╝рж╛
ЁЯдУ => ЁЯдУ, ржорзБржЦ, ржЧрзБрж░рзБ, ржмрзЛржХрж╛
ЁЯШЫ => ЁЯШЫ, ржорзБржЦ, ржЬрж┐ржн ржнрзЗржЩрж╛ржирзЛ
ЁЯШЬ => ЁЯШЬ, ржЪрзЛржЦ, ржорзБржЦ, ржоржЬрж╛ ржХрж░рж╛, ржЬрж┐ржн ржмрж╛рж░ ржХрж░рж╛, ржЪрзЛржЦ ржорж╛рж░рж╛
ЁЯШЭ => ЁЯШЭ, ржЪрзЛржЦ, ржорзБржЦ, ржнржпрж╝ржЩрзНржХрж░, рж╕рзНржмрж╛ржж, ржЬрж┐ржн ржмрж╛рж░ ржХрж░рж╛
тШ╣ => тШ╣, ржорзБржЦ, ржнрзНрж░рзВ ржХрзБржЪржБржХрж╛ржирзЛ
ЁЯЩБ => ЁЯЩБ, ржорзБржЦ, ржнрзНрж░рзВ ржХрзБржЪржБржХрж╛ржирзЛ
ЁЯШТ => ЁЯШТ, ржорзБржЦ, ржмрж┐рж░ржХрзНржд, ржЕрж╕рзБржЦрзА
ЁЯШУ => ЁЯШУ, ржарж╛ржирзНржбрж╛, ржорзБржЦ, ржШрж░рзНржорж╛ржХрзНржд ржЕржмрж╕рзНржерж╛
ЁЯШФ => ЁЯШФ, ржоржиржорж░рж╛, ржорзБржЦ, ржмрж┐рж╖ржгрзНржг
ЁЯШХ => ЁЯШХ, ржмрж┐ржнрзНрж░рж╛ржирзНржд, ржорзБржЦ
ЁЯШЦ => ЁЯШЦ, рж╣ржХржЪржХрж┐ржпрж╝рзЗ ржпрж╛ржУржпрж╝рж╛, ржорзБржЦ
ЁЯЩГ => ЁЯЩГ, ржорзБржЦ, ржУрж▓рзНржЯрж╛ржирзЛ ржЪрзЗрж╣рж╛рж░рж╛
ЁЯШ╖ => ЁЯШ╖, ржарж╛ржирзНржбрж╛, ржбрж╛ржХрзНрждрж╛рж░, ржорзБржЦ, ржорзБржЦрзЛрж╢, ржУрж╖рзБржз, ржЕрж╕рзБрж╕рзНрже
ЁЯдТ => ЁЯдТ, ржорзБржЦ, рж░рзЛржЧржЧрзНрж░рж╕рзНржд, ржЕрж╕рзБрж╕рзНрже, ржерж╛рж░рзНржорзЛржорж┐ржЯрж╛рж░
ЁЯдХ => ЁЯдХ, ржмрзНржпрж╛ржирзНржбрзЗржЬ, ржорзБржЦ, ржЖржШрж╛ржд, ржЪрзЛржЯ
ЁЯдС => ЁЯдС, ржорзБржЦ, ржЯрж╛ржХрж╛, ржарзЛржБржЯ
ЁЯШ▓ => ЁЯШ▓, ржЖрж╢рзНржЪрж░рзНржп рж╣ржУржпрж╝рж╛, ржорзБржЦ, ржорж░рзНржорж╛рж╣ржд, рж╕ржорзНржкрзВрж░рзНржг
ЁЯШЮ => ЁЯШЮ, рж╣рждрж╛рж╢, ржорзБржЦ
ЁЯШЯ => ЁЯШЯ, ржорзБржЦ, ржЙржжрзНржмрж┐ржЧрзНржи
ЁЯШд => ЁЯШд, ржорзБржЦ, ржЬржпрж╝ржЬржпрж╝ржХрж╛рж░, ржмрж┐ржЬржпрж╝рзА
ЁЯШв => ЁЯШв, ржХрж╛ржирзНржирж╛ржХрж╛ржЯрж┐ ржХрж░рж╛, ржорзБржЦ, ржжрзБржГржЦрж┐ржд, ржХрж╛ржирзНржирж╛
ЁЯШн => ЁЯШн, ржХрж╛ржирзНржирж╛ржХрж╛ржЯрж┐ ржХрж░рж╛, ржорзБржЦ, ржжрзБржГржЦрж┐ржд, ржЕрж╢рзНрж░рзБрж╕ржЬрж▓ ржорзБржЦ, ржХрж╛ржирзНржирж╛
ЁЯШж => ЁЯШж, ржорзБржЦ, ржнрзНрж░рзВ ржХрзБржЪржБржХрж╛ржирзЛ, ржарзЛржБржЯ, ржЦрзЛрж▓рж╛
ЁЯШз => ЁЯШз, ржмрзЗржжржирж╛рж░рзНржд, ржорзБржЦ
ЁЯШи => ЁЯШи, ржорзБржЦ, ржнржпрж╝, ржнрзАрждрж┐ржЬржиржХ, ржнрзАржд
ЁЯШй => ЁЯШй, ржорзБржЦ, ржХрзНрж▓рж╛ржирзНржд рж╣ржУржпрж╝рж╛, ржкрж░рж┐рж╢рзНрж░рж╛ржирзНржд
ЁЯШм => ЁЯШм, ржорзБржЦ, ржнрзЗржВржЪрж╛ржирзЛ
ЁЯШ░ => ЁЯШ░, ржирзАрж▓, ржарж╛ржирзНржбрж╛, ржорзБржЦ, ржарзЛржБржЯ, ржЦрзЛрж▓рж╛, ржЖржХрж╕рзНржорж┐ржХрждрж╛, ржШрж░рзНржорж╛ржХрзНржд ржЕржмрж╕рзНржерж╛
ЁЯШ▒ => ЁЯШ▒, ржорзБржЦ, ржнржпрж╝, ржнрзАрждрж┐ржЬржиржХ, ржЦрзЛрж▓рж╛ ржорзБржЦ, ржнрзАржд, ржЪрж┐рзОржХрж╛рж░ ржХрж░рж╛
ЁЯШ│ => ЁЯШ│, ржЪржоржХрж┐ржд, ржорзБржЦ, рж░ржХрзНрждрж┐ржо
ЁЯШ╡ => ЁЯШ╡, рж╣рждржмрзБржжрзНржзрж┐, ржорзБржЦ
ЁЯШб => ЁЯШб, ржХрзНрж░рзБржжрзНржз, ржорзБржЦ, ржХрзНрж╖рж┐ржкрзНржд, ржмрж┐рж╕рзНржлрж╛рж░рж┐ржд ржЪрзЛржЦ, ржЧрж░рзНржЬржи, рж▓рж╛рж▓
ЁЯШа => ЁЯШа, ржХрзНрж░рзБржжрзНржз, ржорзБржЦ, ржХрзНрж╖рж┐ржкрзНржд
ЁЯШИ => ЁЯШИ, ржорзБржЦ, рж░рзВржкржХржерж╛, ржХрж▓рзНржкржирж╛, рж╢рж┐ржВ, рж╣рж╛рж╕рж┐
ЁЯС┐ => ЁЯС┐, ржжрзИрждрзНржп, рж╢ржпрж╝рждрж╛ржи, ржорзБржЦ, рж░рзВржкржХржерж╛, ржХрж▓рзНржкржирж╛
ЁЯС╣ => ЁЯС╣, ржмрзБржирзЛ ржЬрзАржм, ржорзБржЦ, рж░рзВржкржХржерж╛, ржХрж▓рзНржкржирж╛, ржЬрж╛ржкрж╛ржирж┐, ржжрж╛ржиржм
ЁЯС║ => ЁЯС║, ржмрзБржирзЛ ржЬрзАржм, ржорзБржЦ, рж░рзВржкржХржерж╛, ржХрж▓рзНржкржирж╛, ржЬрж╛ржкрж╛ржирж┐, ржжрж╛ржиржм
ЁЯТА => ЁЯТА, рж╢рж░рзАрж░, ржорзГрждрзНржпрзБ, ржорзБржЦ, рж░рзВржкржХржерж╛, ржжрж╛ржиржм
тШа => тШа, рж╢рж░рзАрж░, ржЖржбрж╝рж╛ржЖржбрж╝рж┐ржнрж╛ржмрзЗ ржерж╛ржХрж╛ ржжрзБтАШржЯрж┐ рж╣рж╛ржбрж╝, ржорзГрждрзНржпрзБ, ржорзБржЦ, ржжрж╛ржиржм, ржЦрзБрж▓рж┐
ЁЯС╗ => ЁЯС╗, ржмрзБржирзЛ ржЬрзАржм, ржорзБржЦ, рж░рзВржкржХржерж╛, ржХрж▓рзНржкржирж╛, ржжрж╛ржиржм
ЁЯС╜ => ЁЯС╜, ржмрзБржирзЛ ржЬрзАржм, ржЖржкрж╛рж░рзНржерж┐ржм ржЬрзАржм, ржорзБржЦ, рж░рзВржкржХржерж╛, ржХрж▓рзНржкржирж╛, ржжрж╛ржиржм, ржорж╣рж╛ржХрж╛рж╢, ржЙржбрж╝ржирзНржд ржЪрж╛ржХрждрж┐
ЁЯС╛ => ЁЯС╛, ржнрзАржи ржЧрзНрж░рж╣рзЗрж░ ржкрзНрж░рж╛ржгрзА, ржмрзБржирзЛ ржЬрзАржм, ржЖржкрж╛рж░рзНржерж┐ржм ржЬрзАржм, ржорзБржЦ, рж░рзВржкржХржерж╛, ржХрж▓рзНржкржирж╛, ржжрж╛ржиржм, ржорж╣рж╛ржХрж╛рж╢, ржЙржбрж╝ржирзНржд ржЪрж╛ржХрждрж┐
ЁЯдЦ => ЁЯдЦ, ржорзБржЦ, ржжрж╛ржиржм, ржпржирзНрждрзНрж░ржорж╛ржиржм
ЁЯТй => ЁЯТй, ржХржорж┐ржХ, ржЧрзЛржмрж░, ржорзБржЦ, ржжрж╛ржиржм, ржЕржзрзИрж░рзНржпрзНржп ржкрзНрж░ржХрж╛рж╢ ржХрж░рж╛, ржЙрж▓рзНржЯрж╛ржи ржжрж┐ржХ
ЁЯШ║ => ЁЯШ║, ржмрж┐ржбрж╝рж╛рж▓, ржорзБржЦ, ржарзЛржБржЯ, ржЦрзЛрж▓рж╛, рж╣рж╛рж╕рж┐
ЁЯШ╕ => ЁЯШ╕, ржмрж┐ржбрж╝рж╛рж▓, ржЪрзЛржЦ, ржорзБржЦ, ржжрзЗржБрждрзЛ рж╣рж╛рж╕рж┐, рж╣рж╛рж╕рж┐
ЁЯШ╣ => ЁЯШ╣, ржмрж┐ржбрж╝рж╛рж▓, ржорзБржЦ, ржЖржиржирзНржж, ржХрж╛ржирзНржирж╛
ЁЯШ╗ => ЁЯШ╗, ржмрж┐ржбрж╝рж╛рж▓, ржЪрзЛржЦ, ржорзБржЦ, рж╣рж╛рж░рзНржЯ, ржнрж╛рж▓ржмрж╛рж╕рж╛, рж╣рж╛рж╕рж┐
ЁЯШ╝ => ЁЯШ╝, ржмрж┐ржбрж╝рж╛рж▓, ржорзБржЦ, рж╢рзНрж▓рзЗрж╖рж╛рждрзНржоржХ, рж╣рж╛рж╕рж┐, ржмрж┐ржХрзГржд
ЁЯШ╜ => ЁЯШ╜, ржмрж┐ржбрж╝рж╛рж▓, ржЪрзЛржЦ, ржорзБржЦ, ржЪрзБржорзНржмржи
ЁЯЩА => ЁЯЩА, ржмрж┐ржбрж╝рж╛рж▓, ржорзБржЦ, ржмрж┐рж╕рзНржоржпрж╝рж╕рзВржЪржХ ржорзБржЦ ржЧрзЛрж▓ ржХрж░рзЗ ржУрж╣ржГ ржХрж░рж╛, ржмрж┐рж╕рзНржорж┐ржд рж╣ржУржпрж╝рж╛, ржкрж░рж┐рж╢рзНрж░рж╛ржирзНржд
ЁЯШ┐ => ЁЯШ┐, ржмрж┐ржбрж╝рж╛рж▓, ржХрж╛ржирзНржирж╛ржХрж╛ржЯрж┐ ржХрж░рж╛, ржорзБржЦ, ржжрзБржГржЦрж┐ржд, ржХрж╛ржирзНржирж╛
ЁЯШ╛ => ЁЯШ╛, ржмрж┐ржбрж╝рж╛рж▓, ржорзБржЦ, ржмрж┐рж╕рзНржлрж╛рж░рж┐ржд ржЪрзЛржЦ
ЁЯЩИ => ЁЯЩИ, ржжрзБрж╖рзНржЯ, ржорзБржЦ, ржирж┐рж╖рж┐ржжрзНржз, ржЕржЩрзНржЧржнржЩрзНржЧрж┐, ржмрж╛ржирж░, ржирж╛, ржиржпрж╝, ржирж┐рж╖рж┐ржжрзНржз ржерж╛ржХрж╛, ржжрзЗржЦрж╛
ЁЯЩЙ => ЁЯЩЙ, ржжрзБрж╖рзНржЯ, ржорзБржЦ, ржирж┐рж╖рж┐ржжрзНржз, ржЕржЩрзНржЧржнржЩрзНржЧрж┐, рж╢рзЛржирж╛, ржмрж╛ржирж░, ржирж╛, ржиржпрж╝, ржирж┐рж╖рж┐ржжрзНржз ржерж╛ржХрж╛
ЁЯЩК => ЁЯЩК, ржжрзБрж╖рзНржЯ, ржорзБржЦ, ржирж┐рж╖рж┐ржжрзНржз, ржЕржЩрзНржЧржнржЩрзНржЧрж┐, ржмрж╛ржирж░, ржирж╛, ржиржпрж╝, ржирж┐рж╖рж┐ржжрзНржз ржерж╛ржХрж╛, ржХржерж╛ ржмрж▓рж╛
ЁЯСж => ЁЯСж, ржЫрзЗрж▓рзЗ, ржкрзБрж░рзБрж╖
ЁЯСз => ЁЯСз, рждрж░рзБржгрзА, ржХрзБржорж╛рж░рзА, ржХржирзНржпрж╛рж░рж╛рж╢рж┐, рж░рж╛рж╢рж┐ржЪржХрзНрж░
ЁЯСи => ЁЯСи, ржирж░, ржкрзБрж░рзБрж╖
ЁЯСитАНтЪХ => ЁЯСитАНтЪХ, ржбрж╛ржХрзНрждрж╛рж░, рж╕рзНржмрж╛ржерзНржп ржкрж░рж┐ржЪрж░рзНржЬрж╛, ржкрзБрж░рзБрж╖, ржирж╛рж░рзНрж╕, ржерзЗрж░рж╛ржкрж┐рж╕рзНржЯ
ЁЯСитАНЁЯСж => ЁЯСитАНЁЯСж, ржЫрзЗрж▓рзЗ, ржмрж╛ржЪрзНржЪрж╛, ржмрж╛ржмрж╛, ржкрзБрж░рзБрж╖, ржорж╛
ЁЯСитАНЁЯСжтАНЁЯСж => ЁЯСитАНЁЯСжтАНЁЯСж, ржЫрзЗрж▓рзЗ, ржмрж╛ржЪрзНржЪрж╛, ржмрж╛ржмрж╛, ржкрзБрж░рзБрж╖, ржорж╛
ЁЯСитАНЁЯСз => ЁЯСитАНЁЯСз, ржмрж╛ржЪрзНржЪрж╛, ржмрж╛ржмрж╛, ржкрж┐рждрж╛, рж╕рзНрждрзНрж░рж┐, ржкрзБрж░рзБрж╖, ржорж╛, ржорж╣рж┐рж▓рж╛, ржХрзБржорж╛рж░рзА, ржХржирзНржпрж╛рж░рж╛рж╢рж┐, рж░рж╛рж╢рж┐
ЁЯСитАНЁЯСзтАНЁЯСж => ЁЯСитАНЁЯСзтАНЁЯСж, ржЫрзЗрж▓рзЗ, ржмрж╛ржЪрзНржЪрж╛, ржмрж╛ржмрж╛, ржорж╣рж┐рж▓рж╛, рж╕рзНрждрзНрж░рж┐, ржкрзБрж░рзБрж╖, ржорж╛, ржорж╛рждрж╛, ржХрзБржорж╛рж░рзА, ржХржирзНржпрж╛рж░рж╛рж╢рж┐, рж░рж╛рж╢рж┐
ЁЯСитАНЁЯСзтАНЁЯСз => ЁЯСитАНЁЯСзтАНЁЯСз, ржмрж╛ржЪрзНржЪрж╛, ржмрж╛ржмрж╛, ржорж╣рж┐рж▓рж╛, рж╕рзНрждрзНрж░рж┐, ржкрзБрж░рзБрж╖, ржорж╛, ржорж╛рждрж╛, ржХрзБржорж╛рж░рзА, ржХржирзНржпрж╛рж░рж╛рж╢рж┐, рж░рж╛рж╢рж┐
ЁЯСитАНЁЯОУ => ЁЯСитАНЁЯОУ, ржЧрзНрж░рзЗржЬрзБржпрж╝рзЗржЯ, рж╕рзНржирж╛рждржХ, ржкрзБрж░рзБрж╖, ржЫрзЗрж▓рзЗ, ржЫрж╛рждрзНрж░, рж╕рзНржЯрзБржбрзЗржирзНржЯ
ЁЯСитАНЁЯМ╛ => ЁЯСитАНЁЯМ╛, ржЪрж╛рж╖рзА, ржХрзГрж╖ржХ, ржкрзБрж░рзБрж╖, ржЫрзЗрж▓рзЗ, ржЦрж╛ржорж╛рж░рзЗрж░ ржорж╛рж▓рж┐ржХ
ЁЯСитАНЁЯН│ => ЁЯСитАНЁЯН│, ржкрж╛ржЪржХ, ржХрзБржХ, рж░рж╛ржБржзрзБржирж┐, ржкрзБрж░рзБрж╖, ржЫрзЗрж▓рзЗ
ЁЯСитАНЁЯПл => ЁЯСитАНЁЯПл, ржЗржирж╕рзНржЯрзНрж░рж╛ржХржЯрж░, ржкрзБрж░рзБрж╖, ржЫрзЗрж▓рзЗ, ржкрзНрж░ржлрзЗрж╕рж░, рж╢рж┐ржХрзНрж╖ржХ
ЁЯСитАНЁЯПн => ЁЯСитАНЁЯПн, ржЕрзНржпрж╛рж╕рзЗржоржмрзНрж▓рж┐, ржлрзНрж░рзЗржХржЯрзНрж░рж┐, ржЗржиржбрж╛рж╕ржЯрзНрж░рж┐, ржЫрзЗрж▓рзЗ, ржкрзБрж░рзБрж╖, ржХрж░рзНржорж┐
ЁЯСитАНЁЯОи => ЁЯСитАНЁЯОи, рж╢рж┐рж▓рзНржкрзА, ржкрзБрж░рзБрж╖, ржЫрзЗрж▓рзЗ, ржкрзНржпрж╛рж▓рзЗржХ
ЁЯСитАНЁЯЪТ => ЁЯСитАНЁЯЪТ, ржлрж╛ржпрж╝рж╛рж░ржлрж╛ржЗржЯрж╛рж░, ржлрж╛ржпрж╝рж╛рж░ржЯрзНрж░рж╛ржХ, ржкрзБрж░рзБрж╖, ржЫрзЗрж▓рзЗ
ЁЯСитАНтЬИ => ЁЯСитАНтЬИ, ржкрзБрж░рзБрж╖, ржЫрзЗрж▓рзЗ, ржкрж╛ржпрж╝рж▓ржЯ, ржкрзНрж▓рзЗржи
ЁЯСитАНЁЯЪА => ЁЯСитАНЁЯЪА, ржорж╣рж╛ржХрж╛рж╢ ржЕржнрж┐ржпрж╛рждрзНрж░рзА, ржкрзБрж░рзБрж╖, ржЫрзЗрж▓рзЗ, рж░ржХрзЗржЯ, рж╕рзНржкрзЗрж╕
ЁЯСитАНЁЯОд => ЁЯСитАНЁЯОд, ржЕржнрж┐ржирзЗрждрж╛, ржПржирзНржЯрж╛ржЯрзЗржирж╛рж░, ржкрзБрж░рзБрж╖, ржЫрзЗрж▓рзЗ, рж░ржХ, ржЧрж╛ржпрж╝ржХ, рж╕рзНржЯрж╛рж░
ЁЯСитАНЁЯТ╗ => ЁЯСитАНЁЯТ╗, ржХрзЛржбрж╛рж░, ржбрзЗржнрзЗрж▓ржкрж╛рж░, ржЗржиржнрзЗржирзНржЯрж░, ржЙржжрзНржнрж╛ржмржХ, ржЫрзЗрж▓рзЗ, ржкрзБрж░рзБрж╖, рж╕ржлрзНржЯржУржпрж╝рзНржпрж╛рж░, ржЯрзЗржХржирзЛрж▓ржЬрж┐рж╕рзНржЯ
ЁЯСитАНЁЯФм => ЁЯСитАНЁЯФм, ржЬрзАржмржмрж┐ржЬрзНржЮрж╛ржирзА, рж░рж╕рж╛ржпрж╝ржиржмрж┐ржж, ржЗржЮрзНржЬрж┐ржирж┐ржпрж╝рж╛рж░, ржЫрзЗрж▓рзЗ, ржкрзБрж░рзБрж╖, ржЧржгрж┐рждржЬрзНржЮ, ржкрзНрж░ржХрзГрждрж┐ржмрж┐ржЬрзНржЮрж╛ржирзА, ржмрж┐ржЬрзНржЮрж╛ржирзА
ЁЯСитАНЁЯТ╝ => ЁЯСитАНЁЯТ╝, ржЖрж░рзНржХрж┐ржЯрзЗржХрзНржЯ, ржмрзНржпржмрж╕рж╛, ржЫрзЗрж▓рзЗ, ржкрзБрж░рзБрж╖, ржорзНржпрж╛ржирзЗржЬрзЗрж░, ржЕржлрж┐рж╕, рж╣рзЛржпрж╝рж╛ржЗржЯ - ржХрж▓рж╛рж░
ЁЯСитАНЁЯФз => ЁЯСитАНЁЯФз, ржЗрж▓рзЗржХржЯрзНрж░рж┐рж╢рж┐ржпрж╝рж╛ржи, ржкрзБрж░рзБрж╖, ржЫрзЗрж▓рзЗ, ржорзЗржХрж╛ржирж┐ржХ, ржкрзНрж▓рж╛ржорзНржмрж╛рж░, ржЯрзНрж░рзЗржбржкрж╛рж░рзНрж╕ржи
ЁЯСитАНтЪЦ => ЁЯСитАНтЪЦ, ржмрж┐ржЪрж╛рж░, ржкрзБрж░рзБрж╖, ржЫрзЗрж▓рзЗ, ржжрж╛ржБржбрж╝рж┐ржкрж╛рж▓рзНрж▓рж╛, рждрзБрж▓рж╛ржжржгрзНржб
ЁЯСй => ЁЯСй, ржирж╛рж░рзА
ЁЯСйтАНтЪХ => ЁЯСйтАНтЪХ, ржбрж╛ржХрзНрждрж╛рж░, рж╕рзНржмрж╛ржерзНржп ржкрж░рж┐ржЪрж░рзНржЬрж╛, ржорж╣рж┐рж▓рж╛, ржирж╛рж░рзНрж╕, ржерзЗрж░рж╛ржкрж┐рж╕рзНржЯ
ЁЯСйтАНЁЯСж => ЁЯСйтАНЁЯСж, ржЫрзЗрж▓рзЗ, ржмрж╛ржЪрзНржЪрж╛, ржмрж╛ржмрж╛, ржкрж┐рждрж╛, ржорж╣рж┐рж▓рж╛, ржорж╛, рж╕рзНрждрзНрж░рж┐
ЁЯСйтАНЁЯСжтАНЁЯСж => ЁЯСйтАНЁЯСжтАНЁЯСж, ржЫрзЗрж▓рзЗ, ржмрж╛ржЪрзНржЪрж╛, ржмрж╛ржмрж╛, ржкрж┐рждрж╛, ржорж╣рж┐рж▓рж╛, ржорж╛, рж╕рзНрждрзНрж░рж┐
ЁЯСйтАНЁЯСзтАНЁЯСж => ЁЯСйтАНЁЯСзтАНЁЯСж, ржЫрзЗрж▓рзЗ, ржмрж╛ржЪрзНржЪрж╛, ржмрж╛ржмрж╛, ржорж╣рж┐рж▓рж╛, рж╕рзНрждрзНрж░рж┐, ржкрзБрж░рзБрж╖, ржорж╛, ржорж╛рждрж╛, ржХрзБржорж╛рж░рзА, ржХржирзНржпрж╛рж░рж╛рж╢рж┐, рж░рж╛рж╢рж┐
ЁЯСйтАНЁЯОУ => ЁЯСйтАНЁЯОУ, ржЧрзНрж░рзЗржЬрзБржпрж╝рзЗржЯ, рж╕рзНржирж╛рждржХ, ржкрзБрж░рзБрж╖, ржЫрзЗрж▓рзЗ, ржЫрж╛рждрзНрж░, рж╕рзНржЯрзБржбрзЗржирзНржЯ
ЁЯСйтАНЁЯМ╛ => ЁЯСйтАНЁЯМ╛, ржЪрж╛рж╖рзА, ржХрзГрж╖ржХ, ржорзЗржпрж╝рзЗ, ржорж╣рж┐рж▓рж╛, ржЦрж╛ржорж╛рж░рзЗрж░ ржорж╛рж▓рж┐ржХ
ЁЯСйтАНЁЯН│ => ЁЯСйтАНЁЯН│, ржкрж╛ржЪржХ, ржХрзБржХ, рж░рж╛ржБржзрзБржирж┐, ржорж╣рж┐рж▓рж╛, ржорзЗржпрж╝рзЗ
ЁЯСйтАНЁЯПл => ЁЯСйтАНЁЯПл, ржЗржирж╕рзНржЯрзНрж░рж╛ржХржЯрж░, ржорж╣рж┐рж▓рж╛, ржорзЗрж▓рзЗ, ржкрзНрж░ржлрзЗрж╕рж░, рж╢рж┐ржХрзНрж╖ржХ
ЁЯСйтАНЁЯПн => ЁЯСйтАНЁЯПн, ржЕрзНржпрж╛рж╕рзЗржоржмрзНрж▓рж┐, ржлрзНрж░рзЗржХржЯрзНрж░рж┐, ржЗржиржбрж╛рж╕ржЯрзНрж░рж┐, ржорзЗржпрж╝рзЗ, ржорж╣рж┐рж▓рж╛, ржХрж░рзНржорж┐
ЁЯСйтАНЁЯОи => ЁЯСйтАНЁЯОи, рж╢рж┐рж▓рзНржкрзА, ржорж╣рж┐рж▓рж╛, ржорзЗржпрж╝рзЗ, ржкрзНржпрж╛рж▓рзЗржХ
ЁЯСйтАНЁЯЪТ => ЁЯСйтАНЁЯЪТ, ржлрж╛ржпрж╝рж╛рж░ржлрж╛ржЗржЯрж╛рж░, ржлрж╛ржпрж╝рж╛рж░ржЯрзНрж░рж╛ржХ, ржорж╣рж┐рж▓рж╛, ржорзЗржпрж╝рзЗ
ЁЯСйтАНтЬИ => ЁЯСйтАНтЬИ, ржорж╣рж┐рж▓рж╛, ржорзЗржпрж╝рзЗ, ржкрж╛ржпрж╝рж▓ржЯ, ржкрзНрж▓рзЗржи
ЁЯСйтАНЁЯЪА => ЁЯСйтАНЁЯЪА, ржорж╣рж╛ржХрж╛рж╢ ржЕржнрж┐ржпрж╛рждрзНрж░рзА, ржорж╣рж┐рж▓рж╛, ржорзЗржпрж╝рзЗ, рж░ржХрзЗржЯ, рж╕рзНржкрзЗрж╕
ЁЯСйтАНЁЯОд => ЁЯСйтАНЁЯОд, ржЕржнрж┐ржирзЗрждрж╛, ржПржирзНржЯрж╛ржЯрзЗржирж╛рж░, ржорж╣рж┐рж▓рж╛, ржорзЗржпрж╝рзЗ, рж░ржХ, ржЧрж╛ржпрж╝ржХ, рж╕рзНржЯрж╛рж░
ЁЯСйтАНЁЯТ╗ => ЁЯСйтАНЁЯТ╗, ржХрзЛржбрж╛рж░, ржбрзЗржнрзЗрж▓ржкрж╛рж░, ржЗржиржнрзЗржирзНржЯрж░, ржЙржжрзНржнрж╛ржмржХ, ржорзЗржпрж╝рзЗ, ржорж╣рж┐рж▓рж╛, рж╕ржлрзНржЯржУржпрж╝рзНржпрж╛рж░, ржЯрзЗржХржирзЛрж▓ржЬрж┐рж╕рзНржЯ
ЁЯСйтАНЁЯФм => ЁЯСйтАНЁЯФм, ржЬрзАржмржмрж┐ржЬрзНржЮрж╛ржирзА, рж░рж╕рж╛ржпрж╝ржиржмрж┐ржж, ржЗржЮрзНржЬрж┐ржирж┐ржпрж╝рж╛рж░, ржЫрзЗрж▓рзЗ, ржорж╣рж┐рж▓рж╛, ржЧржгрж┐рждржЬрзНржЮ, ржкрзНрж░ржХрзГрждрж┐ржмрж┐ржЬрзНржЮрж╛ржирзА, ржмрж┐ржЬрзНржЮрж╛ржирзА
ЁЯСйтАНЁЯТ╝ => ЁЯСйтАНЁЯТ╝, ржЖрж░рзНржХрж┐ржЯрзЗржХрзНржЯ, ржмрзНржпржмрж╕рж╛, ржорж╣рж┐рж▓рж╛, ржорзНржпрж╛ржирзЗржЬрзЗрж░, ржЕржлрж┐рж╕, рж╣рзЛржпрж╝рж╛ржЗржЯ - ржХрж▓рж╛рж░
ЁЯСйтАНЁЯФз => ЁЯСйтАНЁЯФз, ржЗрж▓рзЗржХржЯрзНрж░рж┐рж╢рж┐ржпрж╝рж╛ржи, ржорж╣рж┐рж▓рж╛, ржорзЗржпрж╝рзЗ, ржорзЗржХрж╛ржирж┐ржХ, ржкрзНрж▓рж╛ржорзНржмрж╛рж░, ржЯрзНрж░рзЗржбржкрж╛рж░рзНрж╕ржи
ЁЯСйтАНтЪЦ => ЁЯСйтАНтЪЦ, ржмрж┐ржЪрж╛рж░, ржорзЗржпрж╝рзЗ, ржорж╣рж┐рж▓рж╛, ржжрж╛ржБржбрж╝рж┐ржкрж╛рж▓рзНрж▓рж╛, рждрзБрж▓рж╛ржжржгрзНржб
ЁЯС┤ => ЁЯС┤, ржкрзБрж░рзБрж╖, ржмржпрж╝рж╕рзНржХ
ЁЯС╡ => ЁЯС╡, ржмржпрж╝рж╕рзНржХ ржирж╛рж░рзА
ЁЯС╢ => ЁЯС╢, ржмрж╛ржЪрзНржЪрж╛
ЁЯС▒ => ЁЯС▒, рж╕рзНржмрж░рзНржгржХрзЗрж╢рзА
ЁЯС▒тАНтЩА => ЁЯС▒тАНтЩА, рж╕рзНржмрж░рзНржгржХрзЗрж╢рзА, ржорж╣рж┐рж▓рж╛, ржорзЗржпрж╝рзЗ
ЁЯС▒тАНтЩВ => ЁЯС▒тАНтЩВ, рж╕рзНржмрж░рзНржгржХрзЗрж╢, ржкрзБрж░рзБрж╖, ржЫрзЗрж▓рзЗ
ЁЯСо => ЁЯСо, рж╢рж╛ржирзНрждрж┐рж░ржХрзНрж╖ржХ, ржЕржлрж┐рж╕рж╛рж░, ржкрзБрж▓рж┐рж╢
ЁЯСотАНтЩА => ЁЯСотАНтЩА, ржорж╣рж┐рж▓рж╛, ржорзЗржпрж╝рзЗ, ржЕржлрж┐рж╕рж╛рж░, ржкрзБрж▓рж┐рж╕
ЁЯСотАНтЩВ => ЁЯСотАНтЩВ, ржкрзБрж░рзБрж╖, ржЫрзЗрж▓рзЗ, ржЕржлрж┐рж╕рж╛рж░, ржкрзБрж▓рж┐рж╕
ЁЯС▓ => ЁЯС▓, ржЧрзБржпрж╝рж╛ ржкрж┐ ржорж╛ржУ, ржЯрзБржкрж┐, ржкрзБрж░рзБрж╖
ЁЯС│ => ЁЯС│, ржкрзБрж░рзБрж╖, ржкрж╛ржЧржбрж╝рж┐
ЁЯС│тАНтЩА => ЁЯС│тАНтЩА, ржорж╣рж┐рж▓рж╛, ржорзЗржпрж╝рзЗ, ржкрж╛ржЧржбрж╝рж┐
ЁЯС│тАНтЩВ => ЁЯС│тАНтЩВ, ржкрзБрж░рзБрж╖, ржЫрзЗрж▓рзЗ, ржкрж╛ржЧржбрж╝рж┐
ЁЯС╖ => ЁЯС╖, ржирж┐рж░рзНржорж╛ржг, ржЯрзБржкрж┐, ржХрж░рзНржорзА
ЁЯС╖тАНтЩА => ЁЯС╖тАНтЩА, ржЧрж╛ржБржержирж┐, ржорзЗржпрж╝рзЗ, ржЧрж╛ржБржержи ржХрж░рзНржорж┐, ржорж╣рж┐рж▓рж╛
ЁЯС╖тАНтЩВ => ЁЯС╖тАНтЩВ, ржЧрж╛ржБржержирж┐, ржЫрзЗрж▓рзЗ, ржЧрж╛ржБржержи ржХрж░рзНржорж┐, ржкрзБрж░рзБрж╖
тЫС => тЫС, ржЪрж┐ржХрж┐рзОрж╕рж╛, ржХрзНрж░рж╕, ржорзБржЦ, ржЯрзБржкрж┐, рж╢рж┐рж░рж╕рзНрждрзНрж░рж╛ржг
ЁЯС╕ => ЁЯС╕, рж░рзВржкржХржерж╛, ржХрж▓рзНржкржирж╛
ЁЯТВ => ЁЯТВ, ржкрж╛рж╣рж╛рж░рж╛ржжрж╛рж░
ЁЯТВтАНтЩА => ЁЯТВтАНтЩА, ржЧрж╛рж░рзНржб, ржорж╣рж┐рж▓рж╛, ржорзЗржпрж╝рзЗ
ЁЯТВтАНтЩВ => ЁЯТВтАНтЩВ, ржЧрж╛рж░рзНржб, ржкрзБрж░рзБрж╖, ржЫрзЗрж▓рзЗ
ЁЯХ╡ => ЁЯХ╡, ржЧрзЛржпрж╝рзЗржирзНржжрж╛, ржЧрзБржкрзНрждржЪрж░
ЁЯХ╡тАНтЩА => ЁЯХ╡тАНтЩА, ржбрж┐ржЯрзЗржХржЯрж┐ржн, ржорж╣рж┐рж▓рж╛, ржорзЗржпрж╝рзЗ, ржЯрж┐ржХржЯрж┐ржХрж┐, ржЧрзБржкрзНрждржЪрж░
ЁЯХ╡тАНтЩВ => ЁЯХ╡тАНтЩВ, ржбрж┐ржЯрзЗржХржЯрж┐ржн, ржкрзБрж░рзБрж╖, ржЫрзЗрж▓рзЗ, ржЯрж┐ржХржЯрж┐ржХрж┐, ржЧрзБржкрзНрждржЪрж░
ЁЯОЕ => ЁЯОЕ, ржЙржжржпрж╛ржкржи ржХрж░рж╛, ржХрзНрж░рж┐рж╕ржорж╛рж╕, рж░рзВржкржХржерж╛, ржХрж▓рзНржкржирж╛, ржмрж╛ржмрж╛, рж╕рж╛ржирзНрждрж╛
ЁЯС╝ => ЁЯС╝, ржжрзЗржмржжрзВржд, ржмрж╛ржЪрзНржЪрж╛, ржорзБржЦ, рж░рзВржкржХржерж╛, ржХрж▓рзНржкржирж╛
ЁЯСп => ЁЯСп, ржЦрж░ржЧрзЛрж╢, ржирж░рзНрждржХрзА, ржХрж╛ржи, ржорзЗржпрж╝рзЗ, ржирж╛рж░рзА
ЁЯСптАНтЩА => ЁЯСптАНтЩА, ржмрж╛ржирж┐ ржЗржпрж╝рж╛рж░, ржбрж╛ржирж╕рж╛рж░, ржорзЗржпрж╝рзЗ, ржкрж╛рж░рзНржЯрж┐
ЁЯСптАНтЩВ => ЁЯСптАНтЩВ, ржмрж╛ржирж┐ ржЗржпрж╝рж╛рж░, ржбрж╛ржирж╕рж╛рж░, ржЫрзЗрж▓рзЗ, ржкрж╛рж░рзНржЯрж┐
ЁЯТЖ => ЁЯТЖ, ржорзНржпрж╛рж╕рж╛ржЬ, рж╕рзЗрж▓рзБржи
ЁЯТЖтАНтЩА => ЁЯТЖтАНтЩА, ржорзБржЦ, ржорж╣рж┐рж▓рж╛, ржорзЗржпрж╝рзЗ, ржорж╛рж╕рж╛ржЬ
ЁЯТЖтАНтЩВ => ЁЯТЖтАНтЩВ, ржорзБржЦ, ржкрзБрж░рзБрж╖, ржЫрзЗрж▓рзЗ, ржорж╛рж╕рж╛ржЬ
ЁЯТЗ => ЁЯТЗ, ржирж╛ржкрж┐ржд, рж╕рзМржирзНржжрж░рзНржпрзНржп, ржкрж╛рж░рзНрж▓рж╛рж░
ЁЯТЗтАНтЩА => ЁЯТЗтАНтЩА, ржЪрзБрж▓ ржХрж╛ржЯрж╛, ржорж╣рж┐рж▓рж╛, ржорзЗржпрж╝рзЗ
ЁЯТЗтАНтЩВ => ЁЯТЗтАНтЩВ, ржЪрзБрж▓ ржХрж╛ржЯрж╛, ржкрзБрж░рзБрж╖, ржЫрзЗрж▓рзЗ
ЁЯС░ => ЁЯС░, ржиржмржмржзрзВ, ржШрзЛржоржЯрж╛, ржмрж┐ржмрж╛рж╣
ЁЯЩН => ЁЯЩН, ржнрзНрж░рзВ ржХрзБржЪржБржХрж╛ржирзЛ, ржЕржЩрзНржЧржнржЩрзНржЧрж┐
ЁЯЩНтАНтЩА => ЁЯЩНтАНтЩА, ржнрзБрж░рзБ ржХрзБржБржЪржХрж╛ржирзЛ, ржорж╣рж┐рж▓рж╛, ржорзЗржпрж╝рзЗ, ржЕржЩрзНржЧрж┐ржнржЩрзНржЧрж┐
ЁЯЩНтАНтЩВ => ЁЯЩНтАНтЩВ, ржнрзБрж░рзБ ржХрзБржБржЪржХрж╛ржирзЛ, ржкрзБрж░рзБрж╖, ржЫрзЗрж▓рзЗ, ржЕржЩрзНржЧрж┐ржнржЩрзНржЧрж┐
ЁЯЩО => ЁЯЩО, ржЕржЩрзНржЧржнржЩрзНржЧрж┐, ржмрж┐рж╕рзНржлрж╛рж░рж┐ржд ржЪрзЛржЦ
ЁЯЩОтАНтЩА => ЁЯЩОтАНтЩА, ржЕржЩрзНржЧрж┐ржнржЩрзНржЧрж┐, ржкрж╛ржЙржЯрж┐ржВ, ржорж╣рж┐рж▓рж╛, ржорзЗржпрж╝рзЗ
ЁЯЩОтАНтЩВ => ЁЯЩОтАНтЩВ, ржЕржЩрзНржЧрж┐ржнржЩрзНржЧрж┐, ржкрж╛ржЙржЯрж┐ржВ, ржкрзБрж░рзБрж╖, ржЫрзЗрж▓рзЗ
ЁЯЩЕ => ЁЯЩЕ, ржирж┐рж╖рж┐ржжрзНржз, ржЕржЩрзНржЧржнржЩрзНржЧрж┐, рж╣рж╛ржд, ржирж╛, ржиржпрж╝, ржирж┐рж╖рж┐ржжрзНржз ржерж╛ржХрж╛
ЁЯЩЕтАНтЩА => ЁЯЩЕтАНтЩА, ржирж┐рж╖рж┐ржжрзНржз, ржЕржЩрзНржЧрж┐ржнржЩрзНржЧрж┐, рж╣рж╛ржд, ржорж╣рж┐рж▓рж╛, ржорзЗржпрж╝рзЗ, ржирж╛, ржарж┐ржХ ржирзЗржЗ, ржЕржмрзИржз
ЁЯЩЕтАНтЩВ => ЁЯЩЕтАНтЩВ, ржирж┐рж╖рж┐ржжрзНржз, ржЕржЩрзНржЧрж┐ржнржЩрзНржЧрж┐, рж╣рж╛ржд, ржкрзБрж░рзБрж╖, ржирж╛, ржарж┐ржХ ржирзЗржЗ, ржЕржмрзИржз
ЁЯЩЖ => ЁЯЩЖ, ржЕржЩрзНржЧржнржЩрзНржЧрж┐, рж╣рж╛ржд, ржарж┐ржХ ржЖржЫрзЗ
ЁЯЩЖтАНтЩА => ЁЯЩЖтАНтЩА, ржЕржЩрзНржЧрж┐ржнржЩрзНржЧрж┐, рж╣рж╛ржд, ржорж╣рж┐рж▓рж╛, ржарж┐ржХ ржЖржЫрзЗ
ЁЯЩЖтАНтЩВ => ЁЯЩЖтАНтЩВ, ржЕржЩрзНржЧрж┐ржнржЩрзНржЧрж┐, рж╣рж╛ржд, ржкрзБрж░рзБрж╖, ржЫрзЗрж▓рзЗ, ржарж┐ржХ ржЖржЫрзЗ
ЁЯТБ => ЁЯТБ, рж╣рж╛ржд, рж╕рж╣рж╛ржпрж╝рждрж╛, рждржерзНржп, ржкрзНрж░рж╛ржгржмржирзНржд
ЁЯТБтАНтЩА => ЁЯТБтАНтЩА, ржорж╣рж┐рж▓рж╛, ржорзЗржпрж╝рзЗ, ржоржЬрж╛ржжрж╛рж░, ржЯрж┐ржк ржЪрж╛ржУржпрж╝рж╛
ЁЯТБтАНтЩВ => ЁЯТБтАНтЩВ, ржкрзБрж░рзБрж╖, ржЫрзЗрж▓рзЗ, ржоржЬрж╛ржжрж╛рж░, ржЯрж┐ржк ржЪрж╛ржУржпрж╝рж╛
ЁЯЩЛ => ЁЯЩЛ, ржЕржЩрзНржЧржнржЩрзНржЧрж┐, рж╣рж╛ржд, ржЦрзБрж╢рж┐, ржЙрждрзНржерж┐ржд
ЁЯЩЛтАНтЩА => ЁЯЩЛтАНтЩА, ржЕржЩрзНржЧрж┐ржнржЩрзНржЧрж┐, рж╣рж╛ржд, ржорж╣рж┐рж▓рж╛, ржорзЗржпрж╝рзЗ, рж╣рж╛ржд рждрзЛрж▓рж╛
ЁЯЩЛтАНтЩВ => ЁЯЩЛтАНтЩВ, ржЕржЩрзНржЧрж┐ржнржЩрзНржЧрж┐, рж╣рж╛ржд, ржкрзБрж░рзБрж╖, ржЫрзЗрж▓рзЗ, рж╣рж╛ржд рждрзЛрж▓рж╛
ЁЯЩЗ => ЁЯЩЗ, ржХрзНрж╖ржорж╛ ржкрзНрж░рж╛рж░рзНржержирж╛, ржорж╛ржерж╛ ржиржд, ржЕржЩрзНржЧржнржЩрзНржЧрж┐, ржжрзБржГржЦрж┐ржд
ЁЯЩЗтАНтЩА => ЁЯЩЗтАНтЩА, ржорж╛ржк ржЪрж╛ржУржпрж╝рж╛, ржорж╛ржерж╛ ржиржд ржХрж░рж╛, ржЕржЩрзНржЧрж┐ржнржЩрзНржЧрж┐, ржорж╣рж┐рж▓рж╛, ржорзЗрж▓рзЗ, ржжрзБржГржЦрж┐ржд
ЁЯЩЗтАНтЩВ => ЁЯЩЗтАНтЩВ, ржорж╛ржк ржЪрж╛ржУржпрж╝рж╛, ржорж╛ржерж╛ ржиржд ржХрж░рж╛, ржЕржЩрзНржЧрж┐ржнржЩрзНржЧрж┐, ржкрзБрж░рзБрж╖, ржЫрзЗрж▓рзЗ, ржжрзБржГржЦрж┐ржд
ЁЯЩМ => ЁЯЩМ, рж╢рж░рзАрж░, ржЙржжржпрж╛ржкржи ржХрж░рж╛, ржЕржЩрзНржЧржнржЩрзНржЧрж┐, рж╣рж╛ржд, ржЖржиржирзНржж ржзрзНржмржирж┐ ржХрж░рж╛, ржЙрждрзНржерж┐ржд
ЁЯЩП => ЁЯЩП, ржЬрж╛ржирждрзЗ ржЪрж╛ржУржпрж╝рж╛, рж╢рж░рзАрж░, ржорж╛ржерж╛ ржиржд, ржнрж╛ржБржЬ ржХрж░рж╛, ржЕржЩрзНржЧржнржЩрзНржЧрж┐, рж╣рж╛ржд, ржЕржирзБржЧрзНрж░рж╣ ржХрж░рзЗ, ржзржирзНржпржмрж╛ржж
ЁЯЧг => ЁЯЧг, ржорзБржЦ, рж╣рж╛ржд, ржЫрж╛ржпрж╝рж╛, ржХржерж╛ ржмрж▓рж╛, ржХржерж╛рж░ржд
ЁЯСд => ЁЯСд, ржЖржмржХрзНрж╖, ржЫрж╛ржпрж╝рж╛
ЁЯСе => ЁЯСе, ржЖржмржХрзНрж╖, ржЫрж╛ржпрж╝рж╛
ЁЯЪ╢ => ЁЯЪ╢, ржнрзНрж░ржоржг ржХрж░рж╛, ржЪрж▓рж╛, ржЪрж▓ржорж╛ржи
ЁЯЪ╢тАНтЩА => ЁЯЪ╢тАНтЩА, рж╣рж╛ржБржЯрж╛, ржорж╣рж┐рж▓рж╛, ржорзЗржпрж╝рзЗ, рж╣ржиржЯржи
ЁЯЪ╢тАНтЩВ => ЁЯЪ╢тАНтЩВ, рж╣рж╛ржБржЯрж╛, ржкрзБрж░рзБрж╖, ржЫрзЗрж▓рзЗ, рж╣ржиржЯржи
ЁЯПГ => ЁЯПГ, ржорзНржпрж╛рж░рж╛ржержи, ржжрзМржбрж╝рж░ржд
ЁЯПГтАНтЩА => ЁЯПГтАНтЩА, ржорж╣рж┐рж▓рж╛, ржорзЗржпрж╝рзЗ, ржорзНржпрж╛рж░рж╛ржержи, рж░рзЗрж╕рж┐ржВ, ржжрзМржбрж╝
ЁЯПГтАНтЩВ => ЁЯПГтАНтЩВ, ржкрзБрж░рзБрж╖, ржЫрзЗрж▓рзЗ, ржорзНржпрж╛рж░рж╛ржержи, рж░рзЗрж╕рж┐ржВ, ржжрзМржбрж╝
ЁЯТГ => ЁЯТГ, ржбрж╛ржирж╕рж╛рж░
ЁЯХ┤ => ЁЯХ┤, ржмрзНржпржмрж╕рж╛, ржкрзБрж░рзБрж╖, рж╕рзНржпрзБржЯ
ЁЯТП => ЁЯТП, ржЬрзЛржбрж╝, рж░рзЛржорж╛ржирзНрж╕
ЁЯСйтАНтЭдтАНЁЯТЛтАНЁЯСи => ЁЯСйтАНтЭдтАНЁЯТЛтАНЁЯСи, ржжржорзНржкрждрж┐, ржЬрзБрж░рж┐, ржкрзБрж░рзБрж╖, ржорж╣рж┐рж▓рж╛
ЁЯСитАНтЭдтАНЁЯТЛтАНЁЯСи => ЁЯСитАНтЭдтАНЁЯТЛтАНЁЯСи, ржжржорзНржкрждрж┐, ржЬрзБрж░рж┐, ржкрзБрж░рзБрж╖, ржЫрзЗрж▓рзЗ
ЁЯТС => ЁЯТС, ржЬрзЛржбрж╝, рж╣рж╛рж░рзНржЯ, ржнрж╛рж▓ржмрж╛рж╕рж╛, рж░рзЛржорж╛ржирзНрж╕
ЁЯСйтАНтЭдтАНЁЯСи => ЁЯСйтАНтЭдтАНЁЯСи, ржжржорзНржкрждрж┐, ржорж╣рж┐рж▓рж╛, рж╣рж╛рж░рзНржЯ, ржнрж╛рж▓ржмрж╛рж╕рж╛, ржкрзБрж░рзБрж╖
ЁЯСитАНтЭдтАНЁЯСи => ЁЯСитАНтЭдтАНЁЯСи, ржжржорзНржкрждрж┐, рж╣рж╛рж░рзНржЯ, ржнрж╛рж▓ржмрж╛рж╕рж╛, ржкрзБрж░рзБрж╖, ржЫрзЗрж▓рзЗ
ЁЯСк => ЁЯСк, рж╢рж┐рж╢рзБ, ржмрж╛ржмрж╛, ржорж╛
ЁЯСитАНЁЯСйтАНЁЯСж => ЁЯСитАНЁЯСйтАНЁЯСж, ржЫрзЗрж▓рзЗ, ржмрж╛ржЪрзНржЪрж╛, ржмрж╛ржмрж╛, ржкрж┐рждрж╛, ржорж╣рж┐рж▓рж╛, ржкрзБрж░рзБрж╖, ржорж╛, рж╕рзНрждрзНрж░рж┐
ЁЯСитАНЁЯСйтАНЁЯСз => ЁЯСитАНЁЯСйтАНЁЯСз, рж╕ржирзНрждрж╛ржи, ржмрж╛ржЪрзНржЪрж╛, ржмрж╛ржмрж╛, ржорж╣рж┐рж▓рж╛, ржкрзБрж░рзБрж╖, ржкрж┐рждрж╛, ржорж╛, ржорж╛рждрж╛, ржХрзБржорж╛рж░рзА, ржХржирзНржпрж╛рж░рж╛рж╢рж┐, рж░рж╛рж╢рж┐
ЁЯСитАНЁЯСйтАНЁЯСжтАНЁЯСж => ЁЯСитАНЁЯСйтАНЁЯСжтАНЁЯСж, ржЫрзЗрж▓рзЗ, ржмрж╛ржЪрзНржЪрж╛, ржмрж╛ржмрж╛, ржкрж┐рждрж╛, ржорж╣рж┐рж▓рж╛, ржкрзБрж░рзБрж╖, ржорж╛, рж╕рзНрждрзНрж░рж┐
ЁЯСитАНЁЯСйтАНЁЯСзтАНЁЯСж => ЁЯСитАНЁЯСйтАНЁЯСзтАНЁЯСж, ржЫрзЗрж▓рзЗ, ржмрж╛ржЪрзНржЪрж╛, ржмрж╛ржмрж╛, ржорж╣рж┐рж▓рж╛, ржХрзБржорж╛рж░рзА, ржкрзБрж░рзБрж╖, ржорж╛, ржорж╛рждрж╛, ржХржирзНржпрж╛рж░рж╛рж╢рж┐, рж░рж╛рж╢рж┐
ЁЯСитАНЁЯСйтАНЁЯСзтАНЁЯСз => ЁЯСитАНЁЯСйтАНЁЯСзтАНЁЯСз, ржорзЗржпрж╝рзЗ, ржмрж╛ржмрж╛, ржорж╣рж┐рж▓рж╛, рж╕рзНрждрзНрж░рж┐, ржкрзБрж░рзБрж╖, ржорж╛, ржорж╛рждрж╛, ржХрзБржорж╛рж░рзА, ржХржирзНржпрж╛рж░рж╛рж╢рж┐, рж░рж╛рж╢рж┐
ЁЯСитАНЁЯСитАНЁЯСж => ЁЯСитАНЁЯСитАНЁЯСж, ржЫрзЗрж▓рзЗ, ржмрж╛ржЪрзНржЪрж╛, ржмрж╛ржмрж╛, ржкрж┐рждрж╛, ржкрзБрж░рзБрж╖, ржорж╛
ЁЯСитАНЁЯСитАНЁЯСз => ЁЯСитАНЁЯСитАНЁЯСз, ржмрж╛ржЪрзНржЪрж╛, ржмрж╛ржмрж╛, ржкрж┐рждрж╛, рж╕рзНрждрзНрж░рж┐, ржкрзБрж░рзБрж╖, ржорж╛, ржХрзБржорж╛рж░рзА, ржХржирзНржпрж╛рж░рж╛рж╢рж┐, рж░рж╛рж╢рж┐
ЁЯСитАНЁЯСитАНЁЯСжтАНЁЯСж => ЁЯСитАНЁЯСитАНЁЯСжтАНЁЯСж, ржЫрзЗрж▓рзЗ, ржмрж╛ржЪрзНржЪрж╛, ржмрж╛ржмрж╛, ржкрзБрж░рзБрж╖, ржорж╛
ЁЯСитАНЁЯСитАНЁЯСзтАНЁЯСж => ЁЯСитАНЁЯСитАНЁЯСзтАНЁЯСж, ржЫрзЗрж▓рзЗ, ржмрж╛ржЪрзНржЪрж╛, ржкрж┐рждрж╛, ржмрж╛ржмрж╛, ржорж╣рж┐рж▓рж╛, рж╕рзНрждрзНрж░рж┐, ржкрзБрж░рзБрж╖, ржорж╛, ржХрзБржорж╛рж░рзА, ржХржирзНржпрж╛рж░рж╛рж╢рж┐, рж░рж╛рж╢рж┐
ЁЯСитАНЁЯСитАНЁЯСзтАНЁЯСз => ЁЯСитАНЁЯСитАНЁЯСзтАНЁЯСз, ржмрж╛ржЪрзНржЪрж╛, ржмрж╛ржмрж╛, ржкрж┐рждрж╛, рж╕рзНрждрзНрж░рж┐, ржкрзБрж░рзБрж╖, ржорж╛, ржХрзБржорж╛рж░рзА, ржХржирзНржпрж╛рж░рж╛рж╢рж┐, рж░рж╛рж╢рж┐
ЁЯСйтАНЁЯСйтАНЁЯСж => ЁЯСйтАНЁЯСйтАНЁЯСж, ржЫрзЗрж▓рзЗ, ржмрж╛ржЪрзНржЪрж╛, ржкрж┐рждрж╛, ржмрж╛ржмрж╛, ржорж╣рж┐рж▓рж╛
ЁЯСйтАНЁЯСйтАНЁЯСжтАНЁЯСж => ЁЯСйтАНЁЯСйтАНЁЯСжтАНЁЯСж, ржЫрзЗрж▓рзЗ, ржмрж╛ржЪрзНржЪрж╛, ржмрж╛ржмрж╛, ржорж╣рж┐рж▓рж╛, ржкрзБрж░рзБрж╖, ржорж╛, рж╕рзНрждрзНрж░рж┐
ЁЯСйтАНЁЯСйтАНЁЯСзтАНЁЯСж => ЁЯСйтАНЁЯСйтАНЁЯСзтАНЁЯСж, ржЫрзЗрж▓рзЗ, ржмрж╛ржЪрзНржЪрж╛, ржмрж╛ржмрж╛, ржорж╣рж┐рж▓рж╛, рж╕рзНрждрзНрж░рж┐, ржХрзБржорж╛рж░рзА, ржХржирзНржпрж╛рж░рж╛рж╢рж┐, рж░рж╛рж╢рж┐
ЁЯСл => ЁЯСл, ржЬрзЛржбрж╝, рж╣рж╛ржд, ржзрж░рзЗ рж░рж╛ржЦрж╛, ржкрзБрж░рзБрж╖, ржирж╛рж░рзА
ЁЯСм => ЁЯСм, ржЬрзЛржбрж╝, ржорж┐ржерзБржи, рж╣рж╛ржд, ржзрж░рзЗ рж░рж╛ржЦрж╛, ржкрзБрж░рзБрж╖, ржпржоржЬ, рж░рж╛рж╢рж┐ржЪржХрзНрж░
ЁЯСн => ЁЯСн, ржЬрзЛржбрж╝, рж╣рж╛ржд, ржзрж░рзЗ рж░рж╛ржЦрж╛, ржирж╛рж░рзА
ЁЯП╗ => ЁЯП╗, ржЗржорзЛржЬрж┐ ржкрж░рж┐ржмрж░рзНрждржиржХрж╛рж░рзА, ржлрж┐ржЯржЬржкрзНржпрж╛ржЯрзНрж░рж┐ржХ, рждрзНржмржХ, ржЯрзЛржи
ЁЯП╝ => ЁЯП╝, ржЗржорзЛржЬрж┐ ржкрж░рж┐ржмрж░рзНрждржиржХрж╛рж░рзА, ржлрж┐ржЯржЬржкрзНржпрж╛ржЯрзНрж░рж┐ржХ, рждрзНржмржХ, ржЯрзЛржи
ЁЯП╜ => ЁЯП╜, ржЗржорзЛржЬрж┐ ржкрж░рж┐ржмрж░рзНрждржиржХрж╛рж░рзА, ржлрж┐ржЯржЬржкрзНржпрж╛ржЯрзНрж░рж┐ржХ, рждрзНржмржХ, ржЯрзЛржи
ЁЯП╛ => ЁЯП╛, ржЗржорзЛржЬрж┐ ржкрж░рж┐ржмрж░рзНрждржиржХрж╛рж░рзА, ржлрж┐ржЯржЬржкрзНржпрж╛ржЯрзНрж░рж┐ржХ, рждрзНржмржХ, ржЯрзЛржи
ЁЯП┐ => ЁЯП┐, ржЗржорзЛржЬрж┐ ржкрж░рж┐ржмрж░рзНрждржиржХрж╛рж░рзА, ржлрж┐ржЯржЬржкрзНржпрж╛ржЯрзНрж░рж┐ржХ, рждрзНржмржХ, ржЯрзЛржи
ЁЯТк => ЁЯТк, ржмрж╛ржЗрж╕рзЗржк, рж╢рж░рзАрж░, ржХржорж┐ржХ, ржлрзНрж▓рзЗржХрзНрж╕, ржкрзЗрж╢рзА
ЁЯСИ => ЁЯСИ, ржмрзНржпрж╛ржХрж╣рзНржпрж╛ржирзНржб, рж╢рж░рзАрж░, ржЖржЩрзНржЧрзБрж▓, рж╣рж╛ржд, рж╕рзВржЪржХ, ржкржпрж╝рзЗржирзНржЯ
ЁЯСЙ => ЁЯСЙ, ржмрзНржпрж╛ржХрж╣рзНржпрж╛ржирзНржб, рж╢рж░рзАрж░, ржЖржЩрзНржЧрзБрж▓, рж╣рж╛ржд, рж╕рзВржЪржХ, ржкржпрж╝рзЗржирзНржЯ
тШЭ => тШЭ, рж╢рж░рзАрж░, ржЖржЩрзНржЧрзБрж▓, рж╣рж╛ржд, рж╕рзВржЪржХ, ржкржпрж╝рзЗржирзНржЯ, ржЖржк
ЁЯСЖ => ЁЯСЖ, ржмрзНржпрж╛ржХрж╣рзНржпрж╛ржирзНржб, рж╢рж░рзАрж░, ржЖржЩрзНржЧрзБрж▓, рж╣рж╛ржд, рж╕рзВржЪржХ, ржкржпрж╝рзЗржирзНржЯ, ржЖржк
ЁЯЦХ => ЁЯЦХ, рж╢рж░рзАрж░, ржЖржЩрзНржЧрзБрж▓, рж╣рж╛ржд
ЁЯСЗ => ЁЯСЗ, ржмрзНржпрж╛ржХрж╣рзНржпрж╛ржирзНржб, рж╢рж░рзАрж░, ржирж┐ржЪрзЗрж░ ржжрж┐ржХрзЗ, ржЖржЩрзНржЧрзБрж▓, рж╣рж╛ржд, ржЗржиржбрзЗржХрзНрж╕, ржкржпрж╝рзЗржирзНржЯ
тЬМ => тЬМ, рж╢рж░рзАрж░, рж╣рж╛ржд, ржнрж┐ ржЖржХрж╛рж░, ржЬржпрж╝
ЁЯЦЦ => ЁЯЦЦ, рж╢рж░рзАрж░, ржЖржЩрзНржЧрзБрж▓, рж╣рж╛ржд, ржЖржХрж╛рж░ ржЗржЩрзНржЧрж┐ржд, ржнрж╛рж▓ржХрж╛ржи
ЁЯдШ => ЁЯдШ, рж╢рж░рзАрж░, ржЖржЩрзНржЧрзБрж▓, рж╣рж╛ржд, рж╢рж┐ржВ, ржоржи ржорж╛рждрж╛ржи
ЁЯЦР => ЁЯЦР, рж╢рж░рзАрж░, ржЖржЩрзНржЧрзБрж▓, рж╣рж╛ржд, ржкрзНрж░рж╕рж╛рж░рж┐ржд ржХрж░рж╛
тЬК => тЬК, рж╢рж░рзАрж░, ржорзБрж╖рзНржЯрж┐ржмржжрзНржз, ржХрж┐рж▓, рж╣рж╛ржд, ржорзБрж╖рзНржЯрж╛ржШрж╛ржд
тЬЛ => тЬЛ, рж╢рж░рзАрж░, рж╣рж╛ржд
ЁЯСК => ЁЯСК, рж╢рж░рзАрж░, ржорзБрж╖рзНржЯрж┐ржмржжрзНржз, ржХрж┐рж▓, рж╣рж╛ржд, ржорзБрж╖рзНржЯрж╛ржШрж╛ржд
ЁЯСМ => ЁЯСМ, рж╢рж░рзАрж░, рж╣рж╛ржд
ЁЯСН => ЁЯСН, 1, рж╢рж░рзАрж░, рж╣рж╛ржд, ржмрзБржбрж╝рзЛ ржЖржЩрзНржЧрзБрж▓, ржЙрж░рзНржжрзНржзржорзБржЦрзА
ЁЯСО => ЁЯСО, 1, рж╢рж░рзАрж░, ржирж┐ржорзНржиржорзБржЦрзА, рж╣рж╛ржд, ржмрзБржбрж╝рзЛ ржЖржЩрзНржЧрзБрж▓
ЁЯСЛ => ЁЯСЛ, рж╢рж░рзАрж░, рж╣рж╛ржд, ржжрзЛрж▓рж╛ржирзЛ, ржирж╛ржбрж╝рж╛ржирзЛ
ЁЯСП => ЁЯСП, рж╢рж░рзАрж░, рж╣рж╛рждрждрж╛рж▓рж┐, рж╣рж╛ржд
ЁЯСР => ЁЯСР, рж╢рж░рзАрж░, рж╣рж╛ржд, ржЦрзЛрж▓рж╛
тЬН => тЬН, рж╢рж░рзАрж░, рж╣рж╛ржд, рж▓рзЗржЦрж╛
ЁЯТЕ => ЁЯТЕ, рж╢рж░рзАрж░, ржпрждрзНржи, ржкрзНрж░рж╕рж╛ржзржирзА, ржорзНржпрж╛ржирж┐ржХрж┐ржЙрж░, ржиржЦ, ржкрж╛рж▓рж┐рж╢
ЁЯСВ => ЁЯСВ, рж╢рж░рзАрж░
ЁЯСГ => ЁЯСГ, рж╢рж░рзАрж░
ЁЯСг => ЁЯСг, рж╢рж░рзАрж░, ржкрзЛрж╢рж╛ржХ, ржкрж╛ржпрж╝рзЗрж░ ржЫрж╛ржк, ржЫрж╛ржк
ЁЯСА => ЁЯСА, рж╢рж░рзАрж░, ржЪрзЛржЦ, ржорзБржЦ
ЁЯСБ => ЁЯСБ, рж╢рж░рзАрж░
ЁЯСБтАНЁЯЧи => ЁЯСБтАНЁЯЧи, ржЪрзЛржЦ, рж╕рзНржкрж┐ржЪ ржмрж╛ржмрж▓, рж╕рж╛ржХрзНрж╖рзА
ЁЯСЕ => ЁЯСЕ, рж╢рж░рзАрж░
ЁЯСД => ЁЯСД, рж╢рж░рзАрж░, ржУрж╖рзНржа
ЁЯТЛ => ЁЯТЛ, рж╣рж╛рж░рзНржЯ, ржЪрзБржорзНржмржи, ржУрж╖рзНржа, ржЪрж┐рж╣рзНржи, рж░рзЛржорж╛ржирзНрж╕
ЁЯТШ => ЁЯТШ, рждрзАрж░, ржХрж┐ржЙржкрж┐ржб, рж╣рзГржжржпрж╝, рж░рзЛржорж╛ржирзНрж╕
тЭд => тЭд, рж╣рзГржжржпрж╝
ЁЯТУ => ЁЯТУ, рж╕рзНржкржирзНржжрж┐ржд, рж╣рзГржжржпрж╝, рж╣рзГржжрж╕рзНржкржирзНржжржи, рж╕рзНржкржирзНржжржирж╢рзАрж▓
ЁЯТФ => ЁЯТФ, ржнрж╛ржЩрж╛, ржнрзЗржЩрзЗ ржпрж╛ржУржпрж╝рж╛, рж╣рж╛рж░рзНржЯ
ЁЯТХ => ЁЯТХ, рж╣рзГржжржпрж╝, ржнрж╛рж▓ржмрж╛рж╕рж╛
ЁЯТЦ => ЁЯТЦ, ржЙрждрзНрждрзЗржЬрж┐ржд, рж╣рзГржжржпрж╝, ржЭржХржоржХ ржХрж░рж╛
ЁЯТЧ => ЁЯТЧ, ржЙрждрзНрждрзЗржЬрж┐ржд, ржХрзНрж░ржоржмрж░рзНржзржорж╛ржи, рж╣рзГржжржпрж╝, рж╣рзГржжржпрж╝ ржзрзНржмржирж┐, рж╕рзНржирж╛ржпрж╝рзБржмрзИржХрж▓рзНржп
ЁЯТЩ => ЁЯТЩ, ржирзАрж▓, рж╣рзГржжржпрж╝
ЁЯТЪ => ЁЯТЪ, рж╕ржмрзБржЬ, рж╣рзГржжржпрж╝
ЁЯТЫ => ЁЯТЫ, рж╣рж╛рж░рзНржЯ, рж╣рж▓рзБржж
ЁЯТЬ => ЁЯТЬ, рж╣рж╛рж░рзНржЯ, ржмрзЗржЧрзБржирзА
ЁЯТЭ => ЁЯТЭ, рж╣рж╛рж░рзНржЯ, ржлрж┐рждрж╛, ржнрзНржпрж╛рж▓рзЗржирзНржЯрж╛ржЗржи
ЁЯТЮ => ЁЯТЮ, рж╣рзГржжржпрж╝, ржШрзБрж░ржкрж╛ржХ
ЁЯТЯ => ЁЯТЯ, рж╣рзГржжржпрж╝
тЭг => тЭг, ржмрж┐рж╕рзНржоржпрж╝ржмрзЛржзржХ, рж╣рзГржжржпрж╝, ржЪрж┐рж╣рзНржи, ржпрждрж┐ржЪрж┐рж╣рзНржи
ЁЯТМ => ЁЯТМ, рж╣рзГржжржпрж╝, ржЪрж┐ржарж┐, ржнрж╛рж▓ржмрж╛рж╕рж╛, ржорзЗрж▓, рж░рзЛржорж╛ржирзНрж╕
ЁЯТд => ЁЯТд, ржХржорж┐ржХ, ржШрзБржоржирзНржд ржЕржмрж╕рзНржерж╛
ЁЯТв => ЁЯТв, ржХрзНрж░рзБржжрзНржз, ржХржорж┐ржХ, ржХрзНрж╖рж┐ржкрзНржд
ЁЯТг => ЁЯТг, ржХржорж┐ржХ
ЁЯТе => ЁЯТе, ржмрзБржо ржХрж░рзЗ рж╢ржмрзНржж рж╣ржУржпрж╝рж╛, ржХржорж┐ржХ
ЁЯТж => ЁЯТж, ржХржорж┐ржХ, ржЬрж▓рзЗрж░ ржлрзЛржЯрж╛, ржШрж░рзНржорж╛ржХрзНржд ржЕржмрж╕рзНржерж╛
ЁЯТи => ЁЯТи, ржХржорж┐ржХ, рж╣рж╛ржирж╛рж╣рж╛ржирж┐, ржжрзМржбрж╝рж░ржд
ЁЯТл => ЁЯТл, ржХржорж┐ржХ, рждрж╛рж░рж╛
ЁЯТм => ЁЯТм, ржмрзЗрж▓рзБржи, ржмрзБржжрзНржмрзБржж, ржХржорж┐ржХ, ржбрж╛ржпрж╝рж╛рж▓ржЧ, ржмржХрзНрждрзГрждрж╛
ЁЯЧи => ЁЯЧи, ржбрж╛ржпрж╝рж╛рж▓ржЧ, ржмржХрзНрждрзГрждрж╛
ЁЯЧп => ЁЯЧп, ржХрзНрж░рзБржжрзНржз, ржмрзЗрж▓рзБржи, ржмрзБржжрзНржмрзБржж, ржХрзНрж╖рж┐ржкрзНржд
ЁЯТн => ЁЯТн, ржмрзЗрж▓рзБржи, ржмрзБржжрзНржмрзБржж, ржХржорж┐ржХ, ржнрж╛ржмржирж╛
ЁЯХ│ => ЁЯХ│, ржЧрж░рзНржд
ЁЯСУ => ЁЯСУ, ржкрзЛрж╢рж╛ржХ, ржЪрзЛржЦ
ЁЯХ╢ => ЁЯХ╢, ржЧрж╛ржврж╝, ржЪрзЛржЦ, ржЪрж╢ржорж╛
ЁЯСФ => ЁЯСФ, ржкрзЛрж╢рж╛ржХ
ЁЯСХ => ЁЯСХ, ржкрзЛрж╢рж╛ржХ, рж╢рж╛рж░рзНржЯ, ржЯрж┐ рж╢рж╛рж░рзНржЯ
ЁЯСЦ => ЁЯСЦ, ржкрзЛрж╢рж╛ржХ, ржкрзНржпрж╛ржирзНржЯ, ржЯрзНрж░рж╛ржЙржЬрж╛рж░рзНрж╕
ЁЯСЧ => ЁЯСЧ, ржЬрж╛ржорж╛
ЁЯСШ => ЁЯСШ, ржкрзЛрж╢рж╛ржХ
ЁЯСЩ => ЁЯСЩ, ржкрзЛрж╢рж╛ржХ, рж╕рж╛ржБрждрж╛рж░ ржХрж╛ржЯрж╛
ЁЯСЪ => ЁЯСЪ, ржкрзЛрж╢рж╛ржХ, ржирж╛рж░рзА
ЁЯСЫ => ЁЯСЫ, ржкрзЛрж╢рж╛ржХ, ржорзБржжрзНрж░рж╛
ЁЯСЬ => ЁЯСЬ, ржмрзНржпрж╛ржЧ, ржкрзЛрж╢рж╛ржХ
ЁЯСЭ => ЁЯСЭ, ржкрзЛрж╢рж╛ржХ
ЁЯЫН => ЁЯЫН, ржмрзНржпрж╛ржЧ, рж╣рзЛржЯрзЗрж▓, ржХрзЗржирж╛ржХрж╛ржЯрж╛
ЁЯОТ => ЁЯОТ, ржмрзНржпрж╛ржЧ, рж╕рзНржХрзБрж▓рзЗрж░ ржмрзНржпрж╛ржЧ, рж╕рзНржХрзБрж▓
ЁЯСЮ => ЁЯСЮ, ржкрзЛрж╢рж╛ржХ, ржкрзБрж░рзБрж╖, ржЬрзБрждрзЛ
ЁЯСЯ => ЁЯСЯ, ржХрзНрж░рзАржбрж╝рж╛ржмрж┐рж╖ржпрж╝ржХ, ржкрзЛрж╢рж╛ржХ, ржЬрзБрждрзЛ, рж╕рзНржирзАржХрж╛рж░
ЁЯСа => ЁЯСа, ржкрзЛрж╢рж╛ржХ, ржЧрзЛржбрж╝рж╛рж▓рж┐, ржЬрзБрждрзЛ, ржирж╛рж░рзА
ЁЯСб => ЁЯСб, ржкрзЛрж╢рж╛ржХ, рж╕рзНржпрж╛ржирзНржбрзЗрж▓, ржЬрзБрждрзЛ, ржирж╛рж░рзА
ЁЯСв => ЁЯСв, ржмрзБржЯ, ржкрзЛрж╢рж╛ржХ, ржЬрзБрждрзЛ, ржирж╛рж░рзА
ЁЯСС => ЁЯСС, ржкрзЛрж╢рж╛ржХ, рж░рж╛ржЬрж╛, рж░рж╛ржгрзА
ЁЯСТ => ЁЯСТ, ржкрзЛрж╢рж╛ржХ, ржЯрзБржкрж┐, ржирж╛рж░рзА
ЁЯОй => ЁЯОй, ржкрзЛрж╢рж╛ржХ, ржЯрзБржкрж┐, ржЯржк
ЁЯОУ => ЁЯОУ, ржЫрж┐ржкрж┐, ржЙржжржпрж╛ржкржи, ржкрзЛрж╢рж╛ржХ, рж╕рзНржирж╛рждржХ рж╣ржУржпрж╝рж╛, ржЯрзБржкрж┐
ЁЯУ┐ => ЁЯУ┐, ржЬржкржорж╛рж▓рж╛, ржкрзЛрж╢рж╛ржХ, ржирзЗржХрж▓рзЗрж╕, ржкрзНрж░рж╛рж░рзНржержирж╛, ржзрж░рзНржо
ЁЯТД => ЁЯТД, ржкрзНрж░рж╕рж╛ржзржирзА, ржорзЗржХржЖржк
ЁЯТН => ЁЯТН, рж╣рзАрж░рж╛, рж░рзЛржорж╛ржирзНрж╕
ЁЯТО => ЁЯТО, рж╣рзАрж░рж╛, рж░рждрзНржи, ржоржгрж┐, рж░рзЛржорж╛ржирзНрж╕
ЁЯР╡ => ЁЯР╡, ржорзБржЦ, ржмрж╛ржирж░
ЁЯРТ => ЁЯРТ, ржмрж╛ржирж░
ЁЯР╢ => ЁЯР╢, ржХрзБржХрзБрж░, ржорзБржЦ, ржкрзЛрж╖рзНржп
ЁЯРХ => ЁЯРХ, ржкрзЛрж╖рзНржп
ЁЯРй => ЁЯРй, ржХрзБржХрзБрж░
ЁЯР║ => ЁЯР║, ржорзБржЦ, ржирзЗржХржбрж╝рзЗ
ЁЯР▒ => ЁЯР▒, ржмрж┐ржбрж╝рж╛рж▓, ржорзБржЦ, ржкрзЛрж╖рзНржп
ЁЯРИ => ЁЯРИ, ржкрзЛрж╖рзНржп
ЁЯжБ => ЁЯжБ, ржорзБржЦ, рж╕рж┐ржВрж╣рж░рж╛рж╢рж┐, рж╕рж┐ржВрж╣, рж░рж╛рж╢рж┐ржЪржХрзНрж░
ЁЯРп => ЁЯРп, ржорзБржЦ, ржмрж╛ржШ
ЁЯРЕ => ЁЯРЕ, ржмрж╛ржШ
ЁЯРЖ => ЁЯРЖ, ржЪрж┐рждрж╛ржмрж╛ржШ
ЁЯР┤ => ЁЯР┤, ржорзБржЦ, ржШрзЛржбрж╝рж╛
ЁЯРО => ЁЯРО, ржШрзЛржбрж╝ржжрзМржбрж╝рзЗрж░ ржШрзЛржбрж╝рж╛, ржШрзЛржбрж╝ржжрзМржбрж╝
ЁЯжД => ЁЯжД, ржорзБржЦ, ржЗржЙржирж┐ржХрж░рзНржи
ЁЯРо => ЁЯРо, ржЧрж░рзБ, ржорзБржЦ
ЁЯРВ => ЁЯРВ, рж╖рж╛ржБржбрж╝, ржмрзГрж╖рж░рж╛рж╢рж┐, рж░рж╛рж╢рж┐ржЪржХрзНрж░
ЁЯРГ => ЁЯРГ, ржорж╣рж┐рж╖, ржЬрж▓
ЁЯРД => ЁЯРД, ржЧрж░рзБ
ЁЯР╖ => ЁЯР╖, ржорзБржЦ, рж╢рзВржХрж░
ЁЯРЦ => ЁЯРЦ, рж╢рзВржХрж░рзА
ЁЯРЧ => ЁЯРЧ, рж╢рзВржХрж░
ЁЯР╜ => ЁЯР╜, ржорзБржЦ, ржирж╛ржХ, рж╢рзВржХрж░
ЁЯРП => ЁЯРП, ржорзЗрж╖, ржнрзЗржбрж╝рж╛, рж░рж╛рж╢рж┐ржЪржХрзНрж░
ЁЯРС => ЁЯРС, ржнрзЗржбрж╝рзА
ЁЯРР => ЁЯРР, ржоржХрж░ рж░рж╛рж╢рж┐, рж░рж╛рж╢рж┐ржЪржХрзНрж░
ЁЯРк => ЁЯРк, ржЖрж░ржмрзА ржЙржЯ, ржХрзБржБржЬ
ЁЯРл => ЁЯРл, ржЙржЯ, ржХрзБржБржЬ
ЁЯРШ => ЁЯРШ, рж╣рж╛рждрж┐
ЁЯРн => ЁЯРн, ржорзБржЦ, ржирзЗржВржЯрж┐ ржЗржБржжрзБрж░
ЁЯРБ => ЁЯРБ, ржирзЗржВржЯрж┐ ржЗржБржжрзБрж░
ЁЯРА => ЁЯРА, ржЗржБржжрзБрж░
ЁЯР╣ => ЁЯР╣, ржорзБржЦ, ржзрзЗржбрж╝рзЗ ржЗржБржжрзБрж░рзЗрж░ ржорждрзЛ ржкрзНрж░рж╛ржгрзА, ржкрзЛрж╖рзНржп
ЁЯР░ => ЁЯР░, ржЦрж░ржЧрзЛрж╢, ржорзБржЦ, ржкрзЛрж╖рзНржп
ЁЯРЗ => ЁЯРЗ, ржЦрж░ржЧрзЛрж╢, ржкрзЛрж╖рзНржп
ЁЯР┐ => ЁЯР┐, ржХрж╛ржаржмрж┐ржбрж╝рж╛рж▓
ЁЯР╗ => ЁЯР╗, ржнрж╛рж▓рзБржХ, ржорзБржЦ
ЁЯРи => ЁЯРи, ржнрж╛рж▓рзБржХ
ЁЯР╝ => ЁЯР╝, ржорзБржЦ, ржкрж╛ржирзНржбрж╛
ЁЯР╛ => ЁЯР╛, ржкрж╛, ржерж╛ржмрж╛, ржЫрж╛ржк
ЁЯжГ => ЁЯжГ, ржЯрж╛рж░рзНржХрж┐ ржорзБрж░ржЧрзА
ЁЯРФ => ЁЯРФ, ржорзБрж░ржЧрж┐
ЁЯРУ => ЁЯРУ, ржорзЛрж░ржЧ
ЁЯРг => ЁЯРг, ржмрж╛ржЪрзНржЪрж╛, ржмрж╛ржЪрзНржЪрж╛ ржорзБрж░ржЧрж┐, рж╣рзНржпрж╛ржЪрж┐ржВ
ЁЯРд => ЁЯРд, ржмрж╛ржЪрзНржЪрж╛, ржмрж╛ржЪрзНржЪрж╛ ржорзБрж░ржЧрж┐
ЁЯРе => ЁЯРе, ржмрж╛ржЪрзНржЪрж╛, ржмрж╛ржЪрзНржЪрж╛ ржорзБрж░ржЧрж┐
ЁЯРж => ЁЯРж, ржкрж╛ржЦрж┐
ЁЯРз => ЁЯРз, ржкрзЗржВржЧрзБржЗржи
ЁЯХК => ЁЯХК, ржкрж╛ржЦрж┐, ржУржбрж╝рж╛, рж╢рж╛ржирзНрждрж┐
ЁЯР╕ => ЁЯР╕, ржорзБржЦ, ржмрзНржпрж╛ржВ
ЁЯРК => ЁЯРК, ржХрзБржорж┐рж░
ЁЯРв => ЁЯРв, ржХржЪрзНржЫржк
ЁЯРН => ЁЯРН, ржмрж╛рж╣ржХ, ржЕржлрж┐ржЙржХрж╛рж╕, рж░рж╛рж╢рж┐ржЪржХрзНрж░
ЁЯР▓ => ЁЯР▓, ржбрзНрж░рж╛ржЧржи, ржорзБржЦ, рж░рзВржкржХржерж╛
ЁЯРЙ => ЁЯРЙ, рж░рзВржкржХржерж╛
ЁЯР│ => ЁЯР│, ржорзБржЦ, ржЬрж▓ ржЫрзЛржбрж╝рж╛, рждрж┐ржорж┐
ЁЯРЛ => ЁЯРЛ, рждрж┐ржорж┐
ЁЯРм => ЁЯРм, рж╕рж╛ржорзБржжрзНрж░рж┐ржХ ржкрзНрж░рж╛ржгрзАрж░ рж╕рж╛ржБрждрж╛рж░
ЁЯРЯ => ЁЯРЯ, ржорзАржи, рж░рж╛рж╢рж┐ржЪржХрзНрж░
ЁЯРа => ЁЯРа, ржорж╛ржЫ, ржХрзНрж░рж╛ржирзНрждрзАржпрж╝
ЁЯРб => ЁЯРб, ржорж╛ржЫ
ЁЯРЩ => ЁЯРЩ, ржЕржХрзНржЯрзЛржкрж╛рж╕
ЁЯРЪ => ЁЯРЪ, ржЭрж┐ржирзБржХ, рж╕рж░рзНржкрж┐рж▓
ЁЯжА => ЁЯжА, ржХрж░рзНржХржЯ, рж░рж╛рж╢рж┐ржЪржХрзНрж░
ЁЯРМ => ЁЯРМ, рж╢рж╛ржорзБржХ
ЁЯРЫ => ЁЯРЫ, ржкрзЛржХрж╛
ЁЯРЬ => ЁЯРЬ, ржкрзЛржХрж╛
ЁЯРЭ => ЁЯРЭ, ржкрзЛржХрж╛
ЁЯРЮ => ЁЯРЮ, ржЧрзБржмрж░рзЗ ржкрзЛржХрж╛, ржкрзЛржХрж╛, рж▓рзЗржбрж┐ржмрж╛рж░рзНржб, рж▓рзЗржбрж┐ржмрж╛ржЧ
ЁЯХ╖ => ЁЯХ╖, ржкрзЛржХрж╛
ЁЯХ╕ => ЁЯХ╕, ржорж╛ржХржбрж╝рж╕рж╛, ржЬрж╛рж▓
ЁЯжВ => ЁЯжВ, ржмрзГрж╢рзНржЪрж┐ржХрж░рж╛рж╢рж┐, рж░рж╛рж╢рж┐ржЪржХрзНрж░
ЁЯТР => ЁЯТР, ржлрзБрж▓, ржЧрж╛ржЫ, рж░рзЛржорж╛ржирзНрж╕
ЁЯМ╕ => ЁЯМ╕, ржмрж┐ржХрж╢рж┐ржд рж╣ржУржпрж╝рж╛, ржЪрзЗрж░рж┐, ржлрзБрж▓, ржЧрж╛ржЫ
ЁЯТо => ЁЯТо, ржлрзБрж▓
ЁЯП╡ => ЁЯП╡, ржЧрж╛ржЫ
ЁЯМ╣ => ЁЯМ╣, ржлрзБрж▓, ржЧрж╛ржЫ
ЁЯМ║ => ЁЯМ║, ржлрзБрж▓, ржЧрж╛ржЫ
ЁЯМ╗ => ЁЯМ╗, ржлрзБрж▓, ржЧрж╛ржЫ, рж╕рзВрж░рзНржп
ЁЯМ╝ => ЁЯМ╝, ржЧрж╛ржЫ
ЁЯМ╖ => ЁЯМ╖, ржлрзБрж▓, ржЧрж╛ржЫ
тШШ => тШШ, ржЧрж╛ржЫ
ЁЯМ▒ => ЁЯМ▒, ржЧрж╛ржЫ, ржиржмрзАржи
ЁЯМ▓ => ЁЯМ▓, ржЧрж╛ржЫ
ЁЯМ│ => ЁЯМ│, ржкрж░рзНржгржорзЛржЪрзА, ржЧрж╛ржЫ, ржЫрж╛ржБржЯрж╛
ЁЯМ┤ => ЁЯМ┤, ржкрж╛ржо, ржЧрж╛ржЫ
ЁЯМ╡ => ЁЯМ╡, ржЧрж╛ржЫ
ЁЯМ╛ => ЁЯМ╛, рж╢рзАрж╖, ржЧрж╛ржЫ, ржзрж╛ржи
ЁЯМ┐ => ЁЯМ┐, ржкрж╛рждрж╛, ржЧрж╛ржЫ
ЁЯНА => ЁЯНА, 4, ржХрзНрж▓рзЛржнрж╛рж░, ржЪрж╛рж░, ржкрж╛рждрж╛, ржЧрж╛ржЫ
ЁЯНБ => ЁЯНБ, ржкрждржирж╢рзАрж▓, ржкрж╛рждрж╛, ржорзНржпрж╛ржкрзЗрж▓, ржЧрж╛ржЫ
ЁЯНВ => ЁЯНВ, ржкрждржирж╢рзАрж▓, ржкрж╛рждрж╛, ржЧрж╛ржЫ
ЁЯНГ => ЁЯНГ, рж╣рж╛рж▓рзНржХрж╛ рж╣рж╛ржУржпрж╝рж╛, ржЭрж╛ржкржЯрж╛ржирж┐, ржкрж╛рждрж╛, ржЧрж╛ржЫ, рж╣рж╛ржУржпрж╝рж╛
ЁЯНЗ => ЁЯНЗ, ржлрж▓, ржЖржЩрзНржЧрзБрж░, ржЧрж╛ржЫ
ЁЯНИ => ЁЯНИ, ржлрж▓, ржЧрж╛ржЫ
ЁЯНЙ => ЁЯНЙ, ржлрж▓, ржЧрж╛ржЫ
ЁЯНК => ЁЯНК, ржлрж▓, ржХржорж▓рж╛, ржЧрж╛ржЫ
ЁЯНЛ => ЁЯНЛ, ржлрж▓, ржЧрж╛ржЫ
ЁЯНМ => ЁЯНМ, ржлрж▓, ржЧрж╛ржЫ
ЁЯНН => ЁЯНН, ржлрж▓, ржЧрж╛ржЫ
ЁЯНО => ЁЯНО, ржЖржкрзЗрж▓, ржлрж▓, ржЧрж╛ржЫ, рж▓рж╛рж▓
ЁЯНП => ЁЯНП, ржЖржкрзЗрж▓, ржлрж▓, рж╕ржмрзБржЬ, ржЧрж╛ржЫ
ЁЯНР => ЁЯНР, ржлрж▓, ржЧрж╛ржЫ
ЁЯНС => ЁЯНС, ржлрж▓, ржЧрж╛ржЫ
ЁЯНТ => ЁЯНТ, ржлрж▓, ржЧрж╛ржЫ
ЁЯНУ => ЁЯНУ, ржмрзЗрж░рж┐, ржлрж▓, ржЧрж╛ржЫ
ЁЯНЕ => ЁЯНЕ, ржЧрж╛ржЫ, рж╕ржмрзНржЬрж┐
ЁЯНЖ => ЁЯНЖ, ржЧрж╛ржЫ, рж╕ржмрзНржЬрж┐
ЁЯМ╜ => ЁЯМ╜, ржнрзВржЯрзНржЯрж╛, рж╢рзАрж╖, ржнрзБржЯрзНржЯрж╛, ржзрж╛ржБржзрж╛, ржЧрж╛ржЫ
ЁЯМ╢ => ЁЯМ╢, ржЧрж░ржо, рж▓ржЩрзНржХрж╛, ржЧрж╛ржЫ
ЁЯНД => ЁЯНД, ржЧрж╛ржЫ
ЁЯМ░ => ЁЯМ░, ржЧрж╛ржЫ
ЁЯНЮ => ЁЯНЮ, ржкрж╛ржБрж░рзБржЯрж┐
ЁЯзА => ЁЯзА, ржЪрж┐ржЬ
ЁЯНЦ => ЁЯНЦ, рж╣рж╛ржбрж╝, ржорж╛ржВрж╕
ЁЯНЧ => ЁЯНЧ, рж╣рж╛ржбрж╝, ржЪрж┐ржХрзЗржи, рж▓рзЗржЧ, ржкрзЛрж▓рзНржЯрзНрж░рж┐
ЁЯНФ => ЁЯНФ, ржмрж╛рж░рзНржЧрж╛рж░
ЁЯНЯ => ЁЯНЯ, ржлрзНрж░рзЗржЮрзНржЪ, ржлрзНрж░рж╛ржЗ
ЁЯНХ => ЁЯНХ, ржЪрж┐ржЬ, ржлрж╛рж▓рж┐
ЁЯМн => ЁЯМн, ржлрзНрж░рзНржпрж╛ржЩрзНржХржлрж╛рж░рзНржЯрж╛рж░, рж╕рж╕рзЗржЬ
ЁЯМо => ЁЯМо, ржорзЗржХрзНрж╕рж┐ржХрж╛ржи
ЁЯМп => ЁЯМп, ржорзЗржХрзНрж╕рж┐ржХрж╛ржи
ЁЯН┐ => ЁЯН┐, ржкржкржХрж░рзНржг
ЁЯН▓ => ЁЯН▓, ржкрж╛рждрзНрж░, рж╕рзНржЯрзНржпрзБ
ЁЯН▒ => ЁЯН▒, ржмрзЗржирзНржЯрзЛ, ржмрж╛ржХрзНрж╕
ЁЯНШ => ЁЯНШ, ржХрзНрж░рзНржпрж╛ржХрж╛рж░, ржЪрж╛рж▓
ЁЯНЩ => ЁЯНЩ, ржмрж▓, ржЬрж╛ржкрж╛ржирж┐, ржЪрж╛рж▓
ЁЯНЪ => ЁЯНЪ, рж░рж╛ржирзНржирж╛ ржХрж░рж╛, ржЪрж╛рж▓
ЁЯНЫ => ЁЯНЫ, рждрж░ржХрж╛рж░рж┐, ржЪрж╛рж▓
ЁЯНЬ => ЁЯНЬ, ржмрж╛ржЯрж┐, ржирзБржбрж▓, рж░рж╛ржорзЗржи, ржнрж╛ржкрж╛ржирзЛ
ЁЯНЭ => ЁЯНЭ, ржкрж╛рж╕рзНрждрж╛
ЁЯНа => ЁЯНа, ржЖрж▓рзБ, рж░рзЛрж╕рзНржЯ ржХрж░рж╛, ржорж┐рж╖рзНржЯрж┐
ЁЯНв => ЁЯНв, ржХрж╛ржмрж╛ржм, рж╕рж╛ржорзБржжрзНрж░рж┐ржХ ржЦрж╛ржмрж╛рж░, ржХрж╛ржарж┐, ржмрж┐ржжрзНржз ржХрж░рж╛
ЁЯНг => ЁЯНг, рж╕рзБрж╢рж┐
ЁЯНд => ЁЯНд, ржнрж╛ржЬрж╛, ржЧрж▓ржжрж╛ ржЪрж┐ржВржбрж╝рж┐, ржмрж╛ржЧржжрж╛ ржЪрж┐ржВржбрж╝рж┐, ржЯрзЗржорзНржкрзБрж░рж╛
ЁЯНе => ЁЯНе, ржХрзЗржХ, ржорж╛ржЫ, ржкрзНржпрж╛рж╕рзНржЯрзНрж░рж┐, ржШрзЛрж░рж╛ржирзЛ
ЁЯНб => ЁЯНб, ржбрзЗржЬрж╛рж░рзНржЯ, ржЬрж╛ржкрж╛ржирж┐, ржХрж╛ржарж┐, ржмрж┐ржжрзНржз ржХрж░рж╛, ржорж┐рж╖рзНржЯрж┐
ЁЯНж => ЁЯНж, ржХрзНрж░рж┐ржо, ржбрзЗржЬрж╛рж░рзНржЯ, ржмрж░ржл, ржЖржЗрж╕ржХрзНрж░рж┐ржо, ржирж░ржо, ржорж┐рж╖рзНржЯрж┐
ЁЯНз => ЁЯНз, ржбрзЗржЬрж╛рж░рзНржЯ, ржмрж░ржл, ржЪрж╛ржБржЪрж╛, ржорж┐рж╖рзНржЯрж┐
ЁЯНи => ЁЯНи, ржХрзНрж░рж┐ржо, ржбрзЗржЬрж╛рж░рзНржЯ, ржмрж░ржл, ржорж┐рж╖рзНржЯрж┐
ЁЯНй => ЁЯНй, ржбрзЗржЬрж╛рж░рзНржЯ, ржорж┐рж╖рзНржЯрж┐
ЁЯНк => ЁЯНк, ржбрзЗржЬрж╛рж░рзНржЯ, ржорж┐рж╖рзНржЯрж┐
ЁЯОВ => ЁЯОВ, ржЬржирзНржоржжрж┐ржи, ржХрзЗржХ, ржЙржжржпрж╛ржкржи, ржбрзЗржЬрж╛рж░рзНржЯ, ржкрзНржпрж╛рж╕рзНржЯрзНрж░рж┐, ржорж┐рж╖рзНржЯрж┐
ЁЯН░ => ЁЯН░, ржХрзЗржХ, ржбрзЗржЬрж╛рж░рзНржЯ, ржкрзНржпрж╛рж╕рзНржЯрзНрж░рж┐, ржлрж╛рж▓рж┐, ржорж┐рж╖рзНржЯрж┐
ЁЯНл => ЁЯНл, ржмрж╛рж░, ржЪржХрж▓рзЗржЯ, ржбрзЗржЬрж╛рж░рзНржЯ, ржорж┐рж╖рзНржЯрж┐
ЁЯНм => ЁЯНм, ржбрзЗржЬрж╛рж░рзНржЯ, ржорж┐рж╖рзНржЯрж┐
ЁЯНн => ЁЯНн, ржХрзНржпрж╛ржирзНржбрж┐, ржбрзЗржЬрж╛рж░рзНржЯ, ржорж┐рж╖рзНржЯрж┐
ЁЯНо => ЁЯНо, ржбрзЗржЬрж╛рж░рзНржЯ, ржкрзБржбрж┐ржВ, ржорж┐рж╖рзНржЯрж┐
ЁЯНп => ЁЯНп, ржоржзрзБ, ржкрж╛рждрзНрж░, ржорж┐рж╖рзНржЯрж┐
ЁЯН╝ => ЁЯН╝, ржмрж╛ржЪрзНржЪрж╛, ржмрзЛрждрж▓, ржкрж╛ржи ржХрж░рж╛, ржжрзБржз
тШХ => тШХ, ржкрж╛ржирзАржпрж╝, ржХржлрж┐, ржкрж╛ржи ржХрж░рж╛, ржЧрж░ржо, ржнрж╛ржкрж╛ржирзЛ, ржЪрж╛
ЁЯН╡ => ЁЯН╡, ржкрж╛ржирзАржпрж╝, ржХрж╛ржк, ржкрж╛ржи ржХрж░рж╛, ржЪрж╛, ржЪрж╛ржпрж╝рзЗрж░ ржкрзЗржпрж╝рж╛рж▓рж╛
ЁЯН╢ => ЁЯН╢, ржмрж╛рж░, ржкрж╛ржирзАржпрж╝, ржмрзЛрждрж▓, ржХрж╛ржк, ржкрж╛ржи ржХрж░рж╛
ЁЯН╛ => ЁЯН╛, ржмрж╛рж░, ржмрзЛрждрж▓, ржХрж░рзНржХ, ржкрж╛ржи ржХрж░рж╛, ржкржкрж┐ржВ
ЁЯН╖ => ЁЯН╖, ржмрж╛рж░, ржкрж╛ржирзАржпрж╝, ржкрж╛ржи ржХрж░рж╛, ржЧрзНрж▓рж╛рж╕, ржУржпрж╝рж╛ржЗржи
ЁЯН╕ => ЁЯН╕, ржмрж╛рж░, ржХржХржЯрзЗрж▓, ржкрж╛ржи ржХрж░рж╛, ржЧрзНрж▓рж╛рж╕
ЁЯН╣ => ЁЯН╣, ржмрж╛рж░, ржкрж╛ржи ржХрж░рж╛, ржХрзНрж░рж╛ржирзНрждрзАржпрж╝
ЁЯН║ => ЁЯН║, ржмрж╛рж░, ржмрж┐ржпрж╝рж╛рж░, ржкрж╛ржи ржХрж░рж╛, ржоржЧ
ЁЯН╗ => ЁЯН╗, ржмрж╛рж░, ржмрж┐ржпрж╝рж╛рж░, ржарзБржВ ржарзБржВ ржЖржУржпрж╝рж╛ржЬ ржХрж░рж╛, ржкрж╛ржи ржХрж░рж╛, ржоржЧ
ЁЯН╜ => ЁЯН╜, рж░ржирзНржзржи, ржХрж╛ржБржЯрж╛ржЪрж╛ржоржЪ, ржЫрзБрж░рж┐, ржкрзНрж▓рзЗржЯ
ЁЯН┤ => ЁЯН┤, рж░ржирзНржзржи, ржХрж╛ржБржЯрж╛ржЪрж╛ржоржЪ, ржЫрзБрж░рж┐
ЁЯН│ => ЁЯН│, ржбрж┐ржо, ржнрж╛ржЬрж╛, ржЪрж╛ржЯрзБ
ЁЯП║ => ЁЯП║, ржХрзБржорзНржнрж░рж╛рж╢рж┐, рж░ржирзНржзржи, ржкрж╛ржи ржХрж░рж╛, ржЬрж╛ржЧ, рж╕рж░ржЮрзНржЬрж╛ржо, ржЕрж╕рзНрждрзНрж░, рж░рж╛рж╢рж┐ржЪржХрзНрж░
ЁЯМН => ЁЯМН, ржЖржлрзНрж░рж┐ржХрж╛, ржкрзГржерж┐ржмрзА, ржЗржЙрж░рзЛржк, ржЧрзНрж▓рзЛржм, ржмрж┐рж╢рзНржм
ЁЯМО => ЁЯМО, ржЖржорзЗрж░рж┐ржХрж╛, ржкрзГржерж┐ржмрзА, ржЧрзНрж▓рзЛржм, ржмрж┐рж╢рзНржм
ЁЯМП => ЁЯМП, ржПрж╢рж┐ржпрж╝рж╛, ржЕрж╕рзНржЯрзНрж░рзЗрж▓рж┐ржпрж╝рж╛, ржкрзГржерж┐ржмрзА, ржЧрзНрж▓рзЛржм, ржмрж┐рж╢рзНржм
ЁЯМР => ЁЯМР, ржкрзГржерж┐ржмрзА, ржЧрзНрж▓рзЛржм, ржкрзГржерж┐ржмрзАрж░ ржоржзрзНржпрж░рзЗржЦрж╛, ржмрж┐рж╢рзНржм
ЁЯЧ║ => ЁЯЧ║, ржорж╛ржиржЪрж┐рждрзНрж░, ржмрж┐рж╢рзНржм
ЁЯПФ => ЁЯПФ, ржарж╛ржирзНржбрж╛, ржкрж░рзНржмржд, рждрзБрж╖рж╛рж░
тЫ░ => тЫ░, ржкрж╛рж╣рж╛ржбрж╝
ЁЯМЛ => ЁЯМЛ, ржЕржЧрзНржирзНржпрзБрзОржкрж╛ржд, ржкрж░рзНржмржд, ржЖржмрж╣рж╛ржУржпрж╝рж╛
ЁЯЧ╗ => ЁЯЧ╗, ржлрзБржЬрж┐, ржкрж░рзНржмржд
ЁЯПХ => ЁЯПХ, рждрж╛ржмрзБ ржЦрж╛ржБржЯрж╛ржирзЛ
ЁЯПЦ => ЁЯПЦ, рж╕рзИржХржд, ржЫрж╛рждрж╛
ЁЯПЬ => ЁЯПЬ, ржорж░рзБржнрзБржорж┐
ЁЯПЭ => ЁЯПЭ, ржорж░рзБржнрзВржорж┐, ржжрзНржмрзАржк
ЁЯПЮ => ЁЯПЮ, ржкрж╛рж░рзНржХ
ЁЯПЯ => ЁЯПЯ, рж╕рзНржЯрзЗржбрж┐ржпрж╝рж╛ржо
ЁЯПЫ => ЁЯПЫ, ржмрж┐рж▓рзНржбрж┐ржВ, ржХрзНрж▓рж╛рж╕рж┐ржХрзНржпрж╛рж▓
ЁЯПЧ => ЁЯПЧ, ржмрж┐рж▓рзНржбрж┐ржВ, ржирж┐рж░рзНржорж╛ржг
ЁЯПШ => ЁЯПШ, ржмрж┐рж▓рзНржбрж┐ржВ, ржмрж╛ржбрж╝рж┐
ЁЯПЩ => ЁЯПЩ, ржмрж┐рж▓рзНржбрж┐ржВ, рж╢рж╣рж░
ЁЯПЪ => ЁЯПЪ, ржмрж┐рж▓рзНржбрж┐ржВ, ржкрж░рж┐рждрзНржпржХрзНржд, ржмрж╛ржбрж╝рж┐
ЁЯПа => ЁЯПа, ржмрж┐рж▓рзНржбрж┐ржВ, ржмрж╛ржбрж╝рж┐
ЁЯПб => ЁЯПб, ржмрж┐рж▓рзНржбрж┐ржВ, ржмрж╛ржЧрж╛ржи, ржмрж╛ржбрж╝рж┐
тЫк => тЫк, ржмрж┐рж▓рзНржбрж┐ржВ, ржЦрзГрж╕рзНржЯрж╛ржи, ржХрзНрж░рж╕, ржзрж░рзНржо
ЁЯХЛ => ЁЯХЛ, ржЗрж╕рж▓рж╛ржо, ржорзБрж╕рж▓рж┐ржо, ржзрж░рзНржо
ЁЯХМ => ЁЯХМ, ржЗрж╕рж▓рж╛ржо, ржорзБрж╕рж▓рж┐ржо, ржзрж░рзНржо
ЁЯХН => ЁЯХН, ржЗрж╣рзБржжрж┐, ржЗрж╣рзБржжрж┐ ржзрж░рзНржо, ржзрж░рзНржо, ржоржирзНржжрж┐рж░
тЫй => тЫй, ржзрж░рзНржо, рж╢рж┐ржирзНржЯрзЛ, ржоржа
ЁЯПв => ЁЯПв, ржмрж┐рж▓рзНржбрж┐ржВ
ЁЯПг => ЁЯПг, ржмрж┐рж▓рзНржбрж┐ржВ, ржЬрж╛ржкрж╛ржирж┐, ржкрзЛрж╕рзНржЯ
ЁЯПд => ЁЯПд, ржмрж┐рж▓рзНржбрж┐ржВ, ржЗржЙрж░рзЛржкрзАржпрж╝, ржкрзЛрж╕рзНржЯ
ЁЯПе => ЁЯПе, ржмрж┐рж▓рзНржбрж┐ржВ, ржбрж╛ржХрзНрждрж╛рж░, ржУрж╖рзБржз
ЁЯПж => ЁЯПж, ржмрж┐рж▓рзНржбрж┐ржВ
ЁЯПи => ЁЯПи, ржмрж┐рж▓рзНржбрж┐ржВ
ЁЯПй => ЁЯПй, ржмрж┐рж▓рзНржбрж┐ржВ, рж╣рзЛржЯрзЗрж▓, ржнрж╛рж▓ржмрж╛рж╕рж╛
ЁЯПк => ЁЯПк, ржмрж┐рж▓рзНржбрж┐ржВ, рж╕рзБржмрж┐ржзрж╛, ржжрзЛржХрж╛ржи
ЁЯПл => ЁЯПл, ржмрж┐рж▓рзНржбрж┐ржВ
ЁЯПм => ЁЯПм, ржмрж┐рж▓рзНржбрж┐ржВ, ржбрж┐ржкрж╛рж░рзНржЯржорзЗржирзНржЯ, ржжрзЛржХрж╛ржи
ЁЯПн => ЁЯПн, ржмрж┐рж▓рзНржбрж┐ржВ
ЁЯПп => ЁЯПп, ржмрж┐рж▓рзНржбрж┐ржВ, ржжрзБрж░рзНржЧ, ржЬрж╛ржкрж╛ржирж┐
ЁЯП░ => ЁЯП░, ржмрж┐рж▓рзНржбрж┐ржВ, ржЗржЙрж░рзЛржкрзАржпрж╝
ЁЯТТ => ЁЯТТ, ржЪрзНржпрж╛ржкрзЗрж▓, рж░рзЛржорж╛ржирзНрж╕
ЁЯЧ╝ => ЁЯЧ╝, ржЯрзЛржХрж┐ржУ, ржЯрж╛ржУржпрж╝рж╛рж░
ЁЯЧ╜ => ЁЯЧ╜, рж▓рж┐ржмрж╛рж░рзНржЯрж┐, ржорзВрж░рзНрждрж┐
ЁЯЧ╛ => ЁЯЧ╛, ржЬрж╛ржкрж╛ржи, ржорж╛ржиржЪрж┐рждрзНрж░
тЫ▓ => тЫ▓, ржлрзЛржпрж╝рж╛рж░рж╛
тЫ║ => тЫ║, рждрж╛ржмрзБ ржЦрж╛ржБржЯрж╛ржирзЛ
ЁЯМБ => ЁЯМБ, ржХрзБржпрж╝рж╛рж╢рж╛, ржЖржмрж╣рж╛ржУржпрж╝рж╛
ЁЯМГ => ЁЯМГ, рж░рж╛ржд, рждрж╛рж░рж╛, ржЖржмрж╣рж╛ржУржпрж╝рж╛
ЁЯМД => ЁЯМД, рж╕ржХрж╛рж▓, ржкрж░рзНржмржд, рж╕рзВрж░рзНржп, рж╕рзВрж░рзНржпрзЛржжржпрж╝, ржЖржмрж╣рж╛ржУржпрж╝рж╛
ЁЯМЕ => ЁЯМЕ, рж╕ржХрж╛рж▓, рж╕рзВрж░рзНржп, ржЖржмрж╣рж╛ржУржпрж╝рж╛
ЁЯМЖ => ЁЯМЖ, ржмрж┐рж▓рзНржбрж┐ржВ, рж╢рж╣рж░, ржЧрзЛржзрзВрж▓рж┐, рж╕ржирзНржзрзНржпрж╛, ржнрзВржжрзГрж╢рзНржп, рж╕рзВрж░рзНржп, рж╕рзВрж░рзНржпрж╛рж╕рзНржд, ржЖржмрж╣рж╛ржУржпрж╝рж╛
ЁЯМЗ => ЁЯМЗ, ржмрж┐рж▓рзНржбрж┐ржВ, ржЧрзЛржзрзВрж▓рж┐, рж╕рзВрж░рзНржп, ржЖржмрж╣рж╛ржУржпрж╝рж╛
ЁЯМЙ => ЁЯМЙ, рж╕рзЗрждрзБ, рж░рж╛ржд, ржЖржмрж╣рж╛ржУржпрж╝рж╛
тЩи => тЩи, ржЧрж░ржо, ржкрзНрж░рж╕рзНрж░ржмржг, ржнрж╛ржкрж╛ржирзЛ
ЁЯММ => ЁЯММ, ржорж╣рж╛ржХрж╛рж╢, ржЖржмрж╣рж╛ржУржпрж╝рж╛
ЁЯОа => ЁЯОа, ржирж╛ржЧрж░ржжрзЛрж▓ржирж╛, ржШрзЛржбрж╝рж╛
ЁЯОб => ЁЯОб, ржЪрж┐рждрзНрждржмрж┐ржирзЛржжржи ржкрж╛рж░рзНржХ, ржлрзЗрж░рж┐рж╕, ржЪрж╛ржХрж╛
ЁЯОв => ЁЯОв, ржЪрж┐рждрзНрждржмрж┐ржирзЛржжржи ржкрж╛рж░рзНржХ, ржХрзЛрж╕рзНржЯрж╛рж░, рж░рзЛрж▓рж╛рж░
ЁЯТИ => ЁЯТИ, ржирж╛ржкрж┐ржд, ржЪрзБрж▓ ржХрж╛ржЯрж╛, ржкрзЛрж▓
ЁЯОк => ЁЯОк, рж╕рж╛рж░рзНржХрж╛рж╕, рждрж╛ржБржмрзБ
ЁЯОн => ЁЯОн, ржХрж▓рж╛, ржорзБржЦрзЛрж╢, ржкрж╛рж░ржлрж░рзНржо ржХрж░рж╛, ржерж┐ржпрж╝рзЗржЯрж╛рж░
ЁЯЦ╝ => ЁЯЦ╝, ржХрж▓рж╛, ржлрзНрж░рзЗржо, ржорж┐ржЙржЬрж┐ржпрж╝рж╛ржо, ржкрзЗржирзНржЯрж┐ржВ, ржЫржмрж┐
ЁЯОи => ЁЯОи, ржХрж▓рж╛, ржорж┐ржЙржЬрж┐ржпрж╝рж╛ржо, ржкрзЗржирзНржЯрж┐ржВ, ржкрзНржпрж╛рж▓рзЗржЯ
ЁЯО░ => ЁЯО░, ржЦрзЗрж▓рж╛, рж╕рзНрж▓ржЯ
ЁЯЪВ => ЁЯЪВ, ржЗржЮрзНржЬрж┐ржи, рж░рзЗрж▓ржУржпрж╝рзЗ, ржмрж╛рж╖рзНржк, ржЯрзНрж░рзЗржи, ржпрж╛ржиржмрж╛рж╣ржи
ЁЯЪГ => ЁЯЪГ, ржорзЛржЯрж░ржЧрж╛ржбрж╝рж┐, ржмрзИржжрзНржпрзБрждрж┐ржХ, рж░рзЗрж▓ржУржпрж╝рзЗ, ржЯрзНрж░рзЗржи, ржЯрзНрж░рж╛ржо, ржЯрзНрж░рж▓рж┐ржмрж╛рж╕, ржпрж╛ржиржмрж╛рж╣ржи
ЁЯЪД => ЁЯЪД, рж░рзЗрж▓ржУржпрж╝рзЗ, рж╢рж┐ржиржХрж╛ржирж╕рзЗржи, ржЧрждрж┐, ржЯрзНрж░рзЗржи, ржпрж╛ржиржмрж╛рж╣ржи
ЁЯЪЕ => ЁЯЪЕ, ржмрзБрж▓рзЗржЯ, рж░рзЗрж▓ржУржпрж╝рзЗ, рж╢рж┐ржиржХрж╛ржирж╕рзЗржи, ржЧрждрж┐, ржЯрзНрж░рзЗржи, ржпрж╛ржиржмрж╛рж╣ржи
ЁЯЪЖ => ЁЯЪЖ, рж░рзЗрж▓ржУржпрж╝рзЗ, ржпрж╛ржиржмрж╛рж╣ржи
ЁЯЪЗ => ЁЯЪЗ, рж╕рж╛ржмржУржпрж╝рзЗ, ржпрж╛ржиржмрж╛рж╣ржи
ЁЯЪИ => ЁЯЪИ, рж░рзЗрж▓ржУржпрж╝рзЗ, ржпрж╛ржиржмрж╛рж╣ржи
ЁЯЪЙ => ЁЯЪЙ, рж░рзЗрж▓ржУржпрж╝рзЗ, ржЯрзНрж░рзЗржи, ржпрж╛ржиржмрж╛рж╣ржи
ЁЯЪК => ЁЯЪК, ржЯрзНрж░рж▓рж┐ржмрж╛рж╕, ржпрж╛ржиржмрж╛рж╣ржи
ЁЯЪЭ => ЁЯЪЭ, ржпрж╛ржиржмрж╛рж╣ржи
ЁЯЪЮ => ЁЯЪЮ, ржорзЛржЯрж░ржЧрж╛ржбрж╝рж┐, ржкрж░рзНржмржд, рж░рзЗрж▓ржУржпрж╝рзЗ, ржпрж╛ржиржмрж╛рж╣ржи
ЁЯЪЛ => ЁЯЪЛ, ржорзЛржЯрж░ржЧрж╛ржбрж╝рж┐, ржЯрзНрж░рж╛ржо, ржЯрзНрж░рж▓рж┐ржмрж╛рж╕, ржпрж╛ржиржмрж╛рж╣ржи
ЁЯЪМ => ЁЯЪМ, ржпрж╛ржиржмрж╛рж╣ржи
ЁЯЪН => ЁЯЪН, ржмрж╛рж╕, ржЕржЧрзНрж░рж╕рж░ржорж╛ржи, ржпрж╛ржиржмрж╛рж╣ржи
ЁЯЪО => ЁЯЪО, ржмрж╛рж╕, ржЯрзНрж░рж╛ржо, ржЯрзНрж░рж▓рж┐, ржпрж╛ржиржмрж╛рж╣ржи
ЁЯЪП => ЁЯЪП, ржмрж╛рж╕, ржмрж╛рж╕ рж╕рзНржЯржк, ржерж╛ржорж╛
ЁЯЪР => ЁЯЪР, ржмрж╛рж╕, ржпрж╛ржиржмрж╛рж╣ржи
ЁЯЪС => ЁЯЪС, ржпрж╛ржиржмрж╛рж╣ржи
ЁЯЪТ => ЁЯЪТ, ржЗржЮрзНржЬрж┐ржи, ржЖржЧрзБржи, ржЯрзНрж░рж╛ржХ, ржпрж╛ржиржмрж╛рж╣ржи
ЁЯЪУ => ЁЯЪУ, ржорзЛржЯрж░ржЧрж╛ржбрж╝рж┐, ржЯрж╣рж▓ржжрж╛рж░рзА, ржкрзБрж▓рж┐рж╢, ржпрж╛ржиржмрж╛рж╣ржи
ЁЯЪФ => ЁЯЪФ, ржорзЛржЯрж░ржЧрж╛ржбрж╝рж┐, ржЕржЧрзНрж░рж╕рж░ржорж╛ржи, ржкрзБрж▓рж┐рж╢, ржпрж╛ржиржмрж╛рж╣ржи
ЁЯЪХ => ЁЯЪХ, ржпрж╛ржиржмрж╛рж╣ржи
ЁЯЪЦ => ЁЯЪЦ, ржЕржЧрзНрж░рж╕рж░ржорж╛ржи, ржЯрзНржпрж╛ржХрзНрж╕рж┐, ржпрж╛ржиржмрж╛рж╣ржи
ЁЯЪЧ => ЁЯЪЧ, ржЧрж╛ржбрж╝рж┐, ржпрж╛ржиржмрж╛рж╣ржи
ЁЯЪШ => ЁЯЪШ, ржЕржЯрзЛржорзЛржмрж╛ржЗрж▓, ржорзЛржЯрж░ржЧрж╛ржбрж╝рж┐, ржЕржЧрзНрж░рж╕рж░ржорж╛ржи, ржпрж╛ржиржмрж╛рж╣ржи
ЁЯЪЩ => ЁЯЪЩ, ржмрж┐ржирзЛржжржиржорзВрж▓ржХ, ржЖрж░ржнрж┐, ржпрж╛ржиржмрж╛рж╣ржи
ЁЯЪЪ => ЁЯЪЪ, рж╕рж░ржмрж░рж╛рж╣, ржЯрзНрж░рж╛ржХ, ржпрж╛ржиржмрж╛рж╣ржи
ЁЯЪЫ => ЁЯЪЫ, рж▓рж░рж┐, рж╕рзЗржорж┐, ржЯрзНрж░рж╛ржХ, ржпрж╛ржиржмрж╛рж╣ржи
ЁЯЪЬ => ЁЯЪЬ, ржпрж╛ржиржмрж╛рж╣ржи
ЁЯЪ▓ => ЁЯЪ▓, ржмрж╛ржЗржХ, ржпрж╛ржиржмрж╛рж╣ржи
тЫ╜ => тЫ╜, ржЬрзНржмрж╛рж▓рж╛ржирзА, ржЧрзНржпрж╛рж╕, ржкрж╛ржорзНржк, рж╕рзНржЯрзЗрж╢ржи
ЁЯЫг => ЁЯЫг, рж╣рж╛ржЗржУржпрж╝рзЗ, рж░рж╛рж╕рзНрждрж╛
ЁЯЫд => ЁЯЫд, рж░рзЗрж▓ржУржпрж╝рзЗ, ржЯрзНрж░рзЗржи
ЁЯЪи => ЁЯЪи, ржмрж╛рждрж┐, ржЧрж╛ржбрж╝рж┐, ржЖрж▓рзЛ, ржкрзБрж▓рж┐рж╢, ржШрзВрж░рзНржгрж╛ржпрж╝ржорж╛ржи, ржпрж╛ржиржмрж╛рж╣ржи
ЁЯЪе => ЁЯЪе, ржЖрж▓рзЛ, рж╕рж┐ржЧржирзНржпрж╛рж▓, ржЯрзНрж░рж╛ржлрж┐ржХ
ЁЯЪж => ЁЯЪж, ржЖрж▓рзЛ, рж╕рж┐ржЧржирзНржпрж╛рж▓, ржЯрзНрж░рж╛ржлрж┐ржХ
ЁЯЪз => ЁЯЪз, ржмрж╛ржзрж╛
тЪУ => тЪУ, ржЬрж╛рж╣рж╛ржЬ, рж╕рж░ржЮрзНржЬрж╛ржо
тЫ╡ => тЫ╡, ржирзМржХрж╛, рж░рж┐рж╕рзЛрж░рзНржЯ, рж╕рж╛ржЧрж░, ржпрж╛ржиржмрж╛рж╣ржи, ржЗржпрж╝ржЯ
ЁЯЪг => ЁЯЪг, ржирзМржХрж╛, ржпрж╛ржиржмрж╛рж╣ржи
ЁЯЪгтАНтЩА => ЁЯЪгтАНтЩА, ржирзМржХрж╛, ржорж╣рж┐рж▓рж╛, рж╕рзНрждрзНрж░рж┐, ржмрж╛ржЗржЪрзЗрж░ ржирзМржХрж╛
ЁЯЪгтАНтЩВ => ЁЯЪгтАНтЩВ, ржирзМржХрж╛, ржкрзБрж░рзБрж╖, ржЫрзЗрж▓рзЗ, ржмрж╛ржЗржЪрзЗрж░ ржирзМржХрж╛
ЁЯЪд => ЁЯЪд, ржирзМржХрж╛, ржпрж╛ржиржмрж╛рж╣ржи
ЁЯЫ│ => ЁЯЫ│, ржпрж╛рждрзНрж░рзА, ржЬрж╛рж╣рж╛ржЬ, ржпрж╛ржиржмрж╛рж╣ржи
тЫ┤ => тЫ┤, ржирзМржХрж╛
ЁЯЫе => ЁЯЫе, ржирзМржХрж╛, ржпрж╛ржиржмрж╛рж╣ржи
ЁЯЪв => ЁЯЪв, ржпрж╛ржиржмрж╛рж╣ржи
тЬИ => тЬИ, ржпрж╛ржиржмрж╛рж╣ржи
ЁЯЫй => ЁЯЫй, ржмрж┐ржорж╛ржи, ржпрж╛ржиржмрж╛рж╣ржи
ЁЯЫл => ЁЯЫл, ржмрж┐ржорж╛ржи, ржЪрзЗржХ ржЗржи, ржкрзНрж░рж╕рзНржерж╛ржи, ржпрж╛ржиржмрж╛рж╣ржи
ЁЯЫм => ЁЯЫм, ржмрж┐ржорж╛ржи, ржЖржЧржоржи, ржЖржЧржд, ржЕржмрждрж░ржг, ржпрж╛ржиржмрж╛рж╣ржи
ЁЯТ║ => ЁЯТ║, ржЪрзЗржпрж╝рж╛рж░
ЁЯЪБ => ЁЯЪБ, ржпрж╛ржиржмрж╛рж╣ржи
ЁЯЪЯ => ЁЯЪЯ, рж░рзЗрж▓ржУржпрж╝рзЗ, рж╕рзНржержЧрж┐рждрж╛ржжрзЗрж╢, ржпрж╛ржиржмрж╛рж╣ржи
ЁЯЪа => ЁЯЪа, ржХрзЗржмрж▓, ржЧржирзНржбрзЛрж▓рж╛, ржкрж░рзНржмржд, ржпрж╛ржиржмрж╛рж╣ржи
ЁЯЪб => ЁЯЪб, ржнрж╛рж╕ржорж╛ржи, ржХрзЗржмрж▓, ржорзЛржЯрж░ржЧрж╛ржбрж╝рж┐, ржЧржирзНржбрзЛрж▓рж╛, рж░рзЛржкржУржпрж╝рзЗ, ржЯрзНрж░рж╛ржоржУржпрж╝рзЗ, ржпрж╛ржиржмрж╛рж╣ржи
ЁЯЪА => ЁЯЪА, ржорж╣рж╛ржХрж╛рж╢, ржпрж╛ржиржмрж╛рж╣ржи
ЁЯЫ░ => ЁЯЫ░, ржорж╣рж╛ржХрж╛рж╢, ржпрж╛ржиржмрж╛рж╣ржи
ЁЯЫО => ЁЯЫО, ржШржгрзНржЯрж╛, ржмрзЗрж▓рж╣ржк, рж╣рзЛржЯрзЗрж▓
ЁЯЪк => ЁЯЪк, ржжрж░ржЬрж╛
ЁЯЫМ => ЁЯЫМ, рж╣рзЛржЯрзЗрж▓, рж╢рзЛржУржпрж╝рж╛
ЁЯЫП => ЁЯЫП, рж╣рзЛржЯрзЗрж▓, рж╢рзЛржУржпрж╝рж╛
ЁЯЫЛ => ЁЯЫЛ, ржХрж╛ржЙржЪ, рж╣рзЛржЯрзЗрж▓, рж▓рзНржпрж╛ржорзНржк
ЁЯЪ╜ => ЁЯЪ╜, ржЯржпрж╝рж▓рзЗржЯ
ЁЯЪ┐ => ЁЯЪ┐, ржЬрж▓
ЁЯЫА => ЁЯЫА, ржмрж╛ржержЯржм, рж╕рзНржирж╛ржи
ЁЯЫБ => ЁЯЫБ, рж╕рзНржирж╛ржи
тМЫ => тМЫ, ржмрж╛рж▓рж┐, ржЯрж╛ржЗржорж╛рж░
тП│ => тП│, ржмрж╛рж▓рж┐ржШржбрж╝рж┐, ржмрж╛рж▓рж┐, ржЯрж╛ржЗржорж╛рж░
тМЪ => тМЪ, ржШржбрж╝рж┐
тП░ => тП░, ржЕрзНржпрж╛рж▓рж╛рж░рзНржо, ржШржбрж╝рж┐
тП▒ => тП▒, ржШржбрж╝рж┐
тП▓ => тП▓, ржШржбрж╝рж┐, ржЯрж╛ржЗржорж╛рж░
ЁЯХ░ => ЁЯХ░, ржШржбрж╝рж┐
ЁЯХЫ => ЁЯХЫ, 00, 12, 12:00, ржШржбрж╝рж┐, ржЯрж╛, ржмрж╛рж░рзЛ
ЁЯХз => ЁЯХз, 12, 12:30, 30, ржШржбрж╝рж┐, рждрж┐рж░рж┐рж╢, ржмрж╛рж░рзЛ
ЁЯХР => ЁЯХР, 00, 1, 1:00, ржШржбрж╝рж┐, ржЯрж╛, ржПржХ
ЁЯХЬ => ЁЯХЬ, 1, 1:30, 30, ржШржбрж╝рж┐, ржПржХ, рждрж┐рж░рж┐рж╢
ЁЯХС => ЁЯХС, 00, 2, 2:00, ржШржбрж╝рж┐, ржЯрзЛ, ржжрзБ
ЁЯХЭ => ЁЯХЭ, 2, 2:30, 30, ржШржбрж╝рж┐, рждрж┐рж░рж┐рж╢, ржжрзБржЯрзЛ
ЁЯХТ => ЁЯХТ, 00, 3, 3:00, ржШржбрж╝рж┐, ржЯрзЗ, рждрж┐ржи
ЁЯХЮ => ЁЯХЮ, 3, 3:30, 30, ржШржбрж╝рж┐, рждрж┐рж░рж┐рж╢, рждрж┐ржиржЯрзЗ
ЁЯХУ => ЁЯХУ, 00, 4, 4:00, ржШржбрж╝рж┐, ржЪрж╛рж░, ржЯрзЗ
ЁЯХЯ => ЁЯХЯ, 30, 4, 4:30, ржШржбрж╝рж┐, ржЪрж╛рж░ржЯрзЗ, рждрж┐рж░рж┐рж╢
ЁЯХФ => ЁЯХФ, 00, 5, 5:00, ржШржбрж╝рж┐, ржкрж╛ржБржЪ, ржЯрж╛
ЁЯХа => ЁЯХа, 30, 5, 5:30, ржШржбрж╝рж┐, ржкрж╛ржБржЪржЯрж╛, рждрж┐рж░рж┐рж╢
ЁЯХХ => ЁЯХХ, 00, 6, 6:00, ржШржбрж╝рж┐, ржЯрж╛, ржЫржпрж╝
ЁЯХб => ЁЯХб, 30, 6, 6:30, ржШржбрж╝рж┐, ржЫржпрж╝ржЯрж╛, рждрж┐рж░рж┐рж╢
ЁЯХЦ => ЁЯХЦ, 00, 7, 7:00, ржШржбрж╝рж┐, ржЯрж╛, рж╕рж╛ржд
ЁЯХв => ЁЯХв, 30, 7, 7:30, ржШржбрж╝рж┐, рж╕рж╛рждржЯрж╛, рждрж┐рж░рж┐рж╢
ЁЯХЧ => ЁЯХЧ, 00, 8, 8:00, ржШржбрж╝рж┐, ржЖржЯ, ржЯрж╛
ЁЯХг => ЁЯХг, 30, 8, 8:30, ржШржбрж╝рж┐, ржЖржЯржЯрж╛, рждрж┐рж░рж┐рж╢
ЁЯХШ => ЁЯХШ, 00, 9, 9:00, ржШржбрж╝рж┐, ржи, ржЯрж╛
ЁЯХд => ЁЯХд, 30, 9, 9:30, ржШржбрж╝рж┐, ржиржпрж╝ржЯрж╛, рждрж┐рж░рж┐рж╢
ЁЯХЩ => ЁЯХЩ, 00, 10, 10:00, ржШржбрж╝рж┐, ржЯрж╛, ржжрж╢
ЁЯХе => ЁЯХе, 10, 10:30, 30, ржШржбрж╝рж┐, ржжрж╢ржЯрж╛, рждрж┐рж░рж┐рж╢
ЁЯХЪ => ЁЯХЪ, 00, 11, 11:00, ржШржбрж╝рж┐, ржПржЧрж╛рж░рзЛ, ржЯрж╛
ЁЯХж => ЁЯХж, 11, 11:30, 30, ржШржбрж╝рж┐, ржПржЧрж╛рж░рзЛржЯрж╛, рждрж┐рж░рж┐рж╢
ЁЯМС => ЁЯМС, ржЕржирзНржзржХрж╛рж░, ржЪрж╛ржБржж, ржорж╣рж╛ржХрж╛рж╢, ржЖржмрж╣рж╛ржУржпрж╝рж╛
ЁЯМТ => ЁЯМТ, ржЕрж░рзНржзржЪржирзНржжрзНрж░, ржЪрж╛ржБржж, ржорж╣рж╛ржХрж╛рж╢, ржУржпрж╝рж╛ржХрзНрж╕рж┐ржВ, ржЖржмрж╣рж╛ржУржпрж╝рж╛
ЁЯМУ => ЁЯМУ, ржЪрж╛ржБржж, ржЪрждрзБрж░рзНржерж╛ржВрж╢, ржорж╣рж╛ржХрж╛рж╢, ржЖржмрж╣рж╛ржУржпрж╝рж╛
ЁЯМФ => ЁЯМФ, ржЕрж░рзНржзрж╛ржзрж┐ржХ, ржЪрж╛ржБржж, ржорж╣рж╛ржХрж╛рж╢, ржУржпрж╝рж╛ржХрзНрж╕рж┐ржВ, ржЖржмрж╣рж╛ржУржпрж╝рж╛
ЁЯМХ => ЁЯМХ, ржкрзВрж░рзНржг, ржЪрж╛ржБржж, ржорж╣рж╛ржХрж╛рж╢, ржЖржмрж╣рж╛ржУржпрж╝рж╛
ЁЯМЦ => ЁЯМЦ, ржЕрж░рзНржзрж╛ржзрж┐ржХ, ржЪрж╛ржБржж, ржорж╣рж╛ржХрж╛рж╢, ржХрзНрж╖рзАржпрж╝ржорж╛ржг, ржЖржмрж╣рж╛ржУржпрж╝рж╛
ЁЯМЧ => ЁЯМЧ, ржЪрж╛ржБржж, ржЪрждрзБрж░рзНржерж╛ржВрж╢, ржорж╣рж╛ржХрж╛рж╢, ржЖржмрж╣рж╛ржУржпрж╝рж╛
ЁЯМШ => ЁЯМШ, ржЕрж░рзНржзржЪржирзНржжрзНрж░, ржЪрж╛ржБржж, ржорж╣рж╛ржХрж╛рж╢, ржХрзНрж╖рзАржпрж╝ржорж╛ржг, ржЖржмрж╣рж╛ржУржпрж╝рж╛
ЁЯМЩ => ЁЯМЩ, ржЪрж╛ржБржж, ржорж╣рж╛ржХрж╛рж╢, ржЖржмрж╣рж╛ржУржпрж╝рж╛
ЁЯМЪ => ЁЯМЪ, ржорзБржЦ, ржЪрж╛ржБржж, ржорж╣рж╛ржХрж╛рж╢, ржЖржмрж╣рж╛ржУржпрж╝рж╛
ЁЯМЫ => ЁЯМЫ, ржорзБржЦ, ржЪрж╛ржБржж, ржЪрждрзБрж░рзНржерж╛ржВрж╢, ржорж╣рж╛ржХрж╛рж╢, ржЖржмрж╣рж╛ржУржпрж╝рж╛
ЁЯМЬ => ЁЯМЬ, ржорзБржЦ, ржЪрж╛ржБржж, ржЪрждрзБрж░рзНржерж╛ржВрж╢, ржорж╣рж╛ржХрж╛рж╢, ржЖржмрж╣рж╛ржУржпрж╝рж╛
ЁЯМб => ЁЯМб, ржЖржмрж╣рж╛ржУржпрж╝рж╛
тША => тША, ржЙржЬрзНржЬрзНржмрж▓, рж░рж╢рзНржорж┐, ржорж╣рж╛ржХрж╛рж╢, рж░рзЛржж, ржЖржмрж╣рж╛ржУржпрж╝рж╛
ЁЯМЭ => ЁЯМЭ, ржЙржЬрзНржЬрзНржмрж▓, ржорзБржЦ, ржкрзВрж░рзНржг, ржЪрж╛ржБржж, ржорж╣рж╛ржХрж╛рж╢, ржЖржмрж╣рж╛ржУржпрж╝рж╛
ЁЯМЮ => ЁЯМЮ, ржЙржЬрзНржЬрзНржмрж▓, ржорзБржЦ, ржорж╣рж╛ржХрж╛рж╢, рж╕рзВрж░рзНржп, ржЖржмрж╣рж╛ржУржпрж╝рж╛
тнР => тнР, рждрж╛рж░рж╛
ЁЯМЯ => ЁЯМЯ, ржЭржХржоржХ, ржЙржжрзНржнрж╛рж╕, ржЬрзНржмрж▓ржЬрзНржмрж▓рзЗ, ржжрзНржпрзБрждрж┐, рждрж╛рж░рж╛
ЁЯМа => ЁЯМа, ржкрждрж┐ржд, рж╢рзБржЯрж┐ржВ, ржорж╣рж╛ржХрж╛рж╢, рждрж╛рж░рж╛
тШБ => тШБ, ржЖржмрж╣рж╛ржУржпрж╝рж╛
тЫЕ => тЫЕ, ржорзЗржШ, рж╕рзВрж░рзНржп, ржЖржмрж╣рж╛ржУржпрж╝рж╛
тЫИ => тЫИ, ржорзЗржШ, ржмрзГрж╖рзНржЯрж┐, ржорзЗржШрзЗрж░ ржЧрж░рзНржЬржи, ржЖржмрж╣рж╛ржУржпрж╝рж╛
ЁЯМд => ЁЯМд, ржорзЗржШ, рж╕рзВрж░рзНржп, ржЖржмрж╣рж╛ржУржпрж╝рж╛
ЁЯМе => ЁЯМе, ржорзЗржШ, рж╕рзВрж░рзНржп, ржЖржмрж╣рж╛ржУржпрж╝рж╛
ЁЯМж => ЁЯМж, ржорзЗржШ, ржмрзГрж╖рзНржЯрж┐, рж╕рзВрж░рзНржп, ржЖржмрж╣рж╛ржУржпрж╝рж╛
ЁЯМз => ЁЯМз, ржорзЗржШ, ржмрзГрж╖рзНржЯрж┐, ржЖржмрж╣рж╛ржУржпрж╝рж╛
ЁЯМи => ЁЯМи, ржорзЗржШ, ржарж╛ржирзНржбрж╛, рждрзБрж╖рж╛рж░ржкрж╛ржд, ржЖржмрж╣рж╛ржУржпрж╝рж╛
ЁЯМй => ЁЯМй, ржорзЗржШ, ржмрж┐ржжрзНржпрзБрзО ржЪржоржХ, ржЖржмрж╣рж╛ржУржпрж╝рж╛
ЁЯМк => ЁЯМк, ржорзЗржШ, ржЖржмрж╣рж╛ржУржпрж╝рж╛
ЁЯМл => ЁЯМл, ржорзЗржШ, ржЖржмрж╣рж╛ржУржпрж╝рж╛
ЁЯМм => ЁЯМм, рж╣рж╛рж▓рзНржХрж╛ рж╣рж╛ржУржпрж╝рж╛, ржорзЗржШ, ржорзБржЦ, ржЖржмрж╣рж╛ржУржпрж╝рж╛, рж╣рж╛ржУржпрж╝рж╛
ЁЯМА => ЁЯМА, рж╣рждржмрзБржжрзНржзрж┐, ржмрж┐ржнрзНрж░рж╛ржирзНрждрж┐ржХрж░, ржЯрж╛ржЗржлрзБржи, ржЖржмрж╣рж╛ржУржпрж╝рж╛
ЁЯМИ => ЁЯМИ, ржмрзГрж╖рзНржЯрж┐, ржЖржмрж╣рж╛ржУржпрж╝рж╛
ЁЯМВ => ЁЯМВ, ржкрзЛрж╢рж╛ржХ, ржмрзГрж╖рзНржЯрж┐, ржЫрж╛рждрж╛, ржЖржмрж╣рж╛ржУржпрж╝рж╛
тШВ => тШВ, ржкрзЛрж╢рж╛ржХ, ржмрзГрж╖рзНржЯрж┐, ржЖржмрж╣рж╛ржУржпрж╝рж╛
тШФ => тШФ, ржкрзЛрж╢рж╛ржХ, ржлрзЛржБржЯрж╛, ржмрзГрж╖рзНржЯрж┐, ржЫрж╛рждрж╛, ржЖржмрж╣рж╛ржУржпрж╝рж╛
тЫ▒ => тЫ▒, ржмрзГрж╖рзНржЯрж┐, рж╕рзВрж░рзНржп, ржЫрж╛рждрж╛, ржЖржмрж╣рж╛ржУржпрж╝рж╛
тЪб => тЪб, ржмрж┐ржкржж, ржмрзИржжрзНржпрзБрждрж┐ржХ, ржмрж┐ржжрзНржпрзБрзО, ржмрж┐ржжрзНржпрзБрзО ржЪржоржХ, ржнрзЛрж▓рзНржЯрзЗржЬ, ржЭржЯржХрж╛
тЭД => тЭД, ржарж╛ржирзНржбрж╛, рждрзБрж╖рж╛рж░ржкрж╛ржд, ржЖржмрж╣рж╛ржУржпрж╝рж╛
тШГ => тШГ, ржарж╛ржирзНржбрж╛, рждрзБрж╖рж╛рж░ржкрж╛ржд, ржЖржмрж╣рж╛ржУржпрж╝рж╛
тЫД => тЫД, ржарж╛ржирзНржбрж╛, рждрзБрж╖рж╛рж░ржкрж╛ржд, рждрзБрж╖рж╛рж░ржорж╛ржиржм, ржЖржмрж╣рж╛ржУржпрж╝рж╛
тШД => тШД, ржорж╣рж╛ржХрж╛рж╢
ЁЯФе => ЁЯФе, рж╢рж┐ржЦрж╛, рж╕рж░ржЮрзНржЬрж╛ржо
ЁЯТз => ЁЯТз, ржарж╛ржирзНржбрж╛, ржХржорж┐ржХ, ржШрж╛ржо, ржЖржмрж╣рж╛ржУржпрж╝рж╛
ЁЯМК => ЁЯМК, ржорж╣рж╛рж╕рж╛ржЧрж░, ржЬрж▓, ржврзЗржЙ, ржЖржмрж╣рж╛ржУржпрж╝рж╛
ЁЯОГ => ЁЯОГ, ржЙржжржпрж╛ржкржи, рж╣рзНржпрж╛рж▓рзЛржЗржи, ржЬрзНржпрж╛ржХ, рж▓ржгрзНржаржи
ЁЯОД => ЁЯОД, ржЙржжржпрж╛ржкржи, ржХрзНрж░рж┐рж╕ржорж╛рж╕, ржЧрж╛ржЫ
ЁЯОЖ => ЁЯОЖ, ржЙржжржпрж╛ржкржи
ЁЯОЗ => ЁЯОЗ, ржЙржжржпрж╛ржкржи, ржмрж╛ржЬрж┐, ржжрзНржпрзБрждрж┐
тЬи => тЬи, ржжрзНржпрзБрждрж┐, рждрж╛рж░рж╛
ЁЯОИ => ЁЯОИ, ржЙржжржпрж╛ржкржи
ЁЯОЙ => ЁЯОЙ, ржЙржжржпрж╛ржкржи, ржЕржирзБрж╖рзНржарж╛ржи, ржкржкрж╛рж░, ржЯрж╛ржбрж╛
ЁЯОК => ЁЯОК, ржмрж▓, ржЙржжржпрж╛ржкржи, ржХржиржлрзЗржЯрзНржЯрж┐
ЁЯОЛ => ЁЯОЛ, ржмрзНржпрж╛ржирж╛рж░, ржЙржжржпрж╛ржкржи, ржЬрж╛ржкрж╛ржирж┐, ржЧрж╛ржЫ
ЁЯОМ => ЁЯОМ, ржЙржжржпрж╛ржкржи, ржХрзНрж░рж╕, ржЖржбрж╝рж╛ржЖржбрж╝рж┐ ржЕржмрж╕рзНржерж╛ржпрж╝ ржерж╛ржХрж╛, ржЬрж╛ржкрж╛ржирж┐
ЁЯОН => ЁЯОН, ржмрж╛ржБрж╢, ржЙржжржпрж╛ржкржи, ржЬрж╛ржкрж╛ржирж┐, ржкрж╛ржЗржи, ржЧрж╛ржЫ
ЁЯОО => ЁЯОО, ржЙржжржпрж╛ржкржи, ржкрзБрждрзБрж▓, ржЙрзОрж╕ржм, ржЬрж╛ржкрж╛ржирж┐
ЁЯОП => ЁЯОП, ржХрж╛рж░рзНржк, ржЙржжржпрж╛ржкржи, ржЖрж▓рзЛржХрж░рж╢рзНржорж┐
ЁЯОР => ЁЯОР, ржШржгрзНржЯрж╛, ржЙржжржпрж╛ржкржи, ржРржХрждрж╛ржи, рж╣рж╛ржУржпрж╝рж╛
ЁЯОС => ЁЯОС, ржЙржжржпрж╛ржкржи, ржЕржирзБрж╖рзНржарж╛ржи, ржЪрж╛ржБржж
ЁЯОА => ЁЯОА, ржЙржжржпрж╛ржкржи
ЁЯОБ => ЁЯОБ, ржмрж╛ржХрзНрж╕, ржЙржжржпрж╛ржкржи, ржЙржкрж╣рж╛рж░, ржЬржбрж╝рж╛ржи
ЁЯОЦ => ЁЯОЦ, ржЙржжржпрж╛ржкржи, ржкржжржХ, рж╕рж╛ржорж░рж┐ржХ
ЁЯОЧ => ЁЯОЧ, ржЙржжржпрж╛ржкржи, ржЕржирзБрж╕рзНржорж╛рж░ржХ, ржлрж┐рждрж╛
ЁЯОЮ => ЁЯОЮ, рж╕рж┐ржирзЗржорж╛, ржлрж┐рж▓рзНржо, ржлрзНрж░рзЗржо, ржорзБржнрж┐
ЁЯОЯ => ЁЯОЯ, ржкрзНрж░ржмрзЗрж╢, ржЯрж┐ржХрзЗржЯ
ЁЯОл => ЁЯОл, ржкрзНрж░ржмрзЗрж╢
ЁЯП╖ => ЁЯП╖, рж▓рзЗржмрзЗрж▓
тЪ╜ => тЪ╜, ржмрж▓
тЪ╛ => тЪ╛, ржмрж▓
ЁЯПА => ЁЯПА, ржмрж▓, рж╣рзБржк
ЁЯПИ => ЁЯПИ, ржЖржорзЗрж░рж┐ржХрж╛ржи, ржмрж▓, ржлрзБржЯржмрж▓
ЁЯПЙ => ЁЯПЙ, ржмрж▓, ржлрзБржЯржмрж▓, рж░рж╛ржЧржмрж┐
ЁЯО╛ => ЁЯО╛, ржмрж▓, ржЯрзЗржирж┐рж╕ ржЦрзЗрж▓рж╛рж░ ржмрзНржпрж╛ржЯ
ЁЯО▒ => ЁЯО▒, 8, 8 ржмрж▓, ржмрж▓, ржмрж┐рж▓рж┐ржпрж╝рж╛рж░рзНржб, ржЖржЯ, ржЦрзЗрж▓рж╛
ЁЯО│ => ЁЯО│, ржмрж▓, ржЦрзЗрж▓рж╛
тЫ│ => тЫ│, ржЧрж▓ржл, ржЧрж░рзНржд
ЁЯПМ => ЁЯПМ, ржмрж▓, ржЧрж▓ржл
ЁЯПМтАНтЩА => ЁЯПМтАНтЩА, ржорж╣рж┐рж▓рж╛, ржЧрж▓рзНржл, ржорзЗржпрж╝рзЗ
ЁЯПМтАНтЩВ => ЁЯПМтАНтЩВ, ржЧрж▓рзНржл, ржкрзБрж░рзБрж╖, ржЫрзЗрж▓рзЗ
тЫ╕ => тЫ╕, ржмрж░ржл, рж╕рзНржХрзЗржЯ
ЁЯОг => ЁЯОг, ржорж╛ржЫ, ржорзЗрж░рзБ
ЁЯО╜ => ЁЯО╜, ржЪрж▓ржорж╛ржи, ржЙрждрзНрждрж░рзАржпрж╝, ржЬрж╛ржорж╛
ЁЯО┐ => ЁЯО┐, рждрзБрж╖рж╛рж░ржкрж╛ржд
тЫ╖ => тЫ╖, рж╕рзНржХрж┐, рждрзБрж╖рж╛рж░ржкрж╛ржд
ЁЯПВ => ЁЯПВ, рж╕рзНржХрж┐, рждрзБрж╖рж╛рж░ржкрж╛ржд, рж╕рзНржирзЛржмрзЛрж░рзНржб
ЁЯПД => ЁЯПД, рж╕рж╛рж░рзНржлрж┐ржВ
ЁЯПДтАНтЩА => ЁЯПДтАНтЩА, ржорж╣рж┐рж▓рж╛, рж╕рж╛рж░рзНржлрж┐ржВ
ЁЯПДтАНтЩВ => ЁЯПДтАНтЩВ, ржкрзБрж░рзБрж╖, ржЫрзЗрж▓рзЗ, рж╕рж╛рж░рзНржлрж┐ржВ
ЁЯПЗ => ЁЯПЗ, ржШрзЛржбрж╝рж╛, ржЬржХрж┐, рж░рзЗрж╕рж┐ржВ
ЁЯПК => ЁЯПК, рж╕рж╛ржБрждрж╛рж░ ржХрж╛ржЯрж╛
ЁЯПКтАНтЩА => ЁЯПКтАНтЩА, ржорж╣рж┐рж▓рж╛, рж╕рзНрждрзНрж░рж┐, рж╕рж╛ржБрждрж╛рж░
ЁЯПКтАНтЩВ => ЁЯПКтАНтЩВ, ржкрзБрж░рзБрж╖, ржЫрзЗрж▓рзЗ, рж╕рж╛ржБрждрж╛рж░
тЫ╣ => тЫ╣, ржмрж▓
тЫ╣тАНтЩА => тЫ╣тАНтЩА, ржмрж▓, ржорж╣рж┐рж▓рж╛, рж╕рзНрждрзНрж░рж┐
тЫ╣тАНтЩВ => тЫ╣тАНтЩВ, ржмрж▓, ржкрж░рзБрж╖, ржЫрзЗрж▓рзЗ
ЁЯПЛ => ЁЯПЛ, ржЙрждрзНрждрзЛрж▓ржХ ржмрзНржпржХрзНрждрж┐, ржУржЬржи
ЁЯПЛтАНтЩА => ЁЯПЛтАНтЩА, ржорж╣рж┐рж▓рж╛, рж╕рзНрждрзНрж░рж┐, ржУржпрж╝рзЗржЯрж▓рж┐ржлрзНржЯрж╛рж░
ЁЯПЛтАНтЩВ => ЁЯПЛтАНтЩВ, ржкрзБрж░рзБрж╖, ржЫрзЗрж▓рзЗ, ржУржпрж╝рзЗржЯрж▓рж┐ржлрзНржЯрж╛рж░
ЁЯЪ┤ => ЁЯЪ┤, ржмрж╛ржЗрж╕рж╛ржЗржХрзЗрж▓, ржмрж╛ржЗржХ, рж╕рж╛ржЗржХрзЗрж▓ ржЖрж░рзЛрж╣рзА
ЁЯЪ┤тАНтЩА => ЁЯЪ┤тАНтЩА, ржмрж╛ржЗрж╕рж╛ржЗржХрзЗрж▓, рж╕рж╛ржЗржХрзЗрж▓, ржорж╣рж┐рж▓рж╛, рж╕рзНрждрзНрж░рж┐
ЁЯЪ┤тАНтЩВ => ЁЯЪ┤тАНтЩВ, рж╕рж╛ржЗржХрзЗрж▓, ржмрж╛ржЗрж╕рж╛ржЗржХрзЗрж▓, ржкрзБрж░рзБрж╖, ржЫрзЗрж▓рзЗ
ЁЯЪ╡ => ЁЯЪ╡, ржмрж╛ржЗрж╕рж╛ржЗржХрзЗрж▓, рж╕рж╛ржЗржХрзЗрж▓ ржЖрж░рзЛрж╣рзА, ржмрж╛ржЗржХ, ржкрж░рзНржмржд
ЁЯЪ╡тАНтЩА => ЁЯЪ╡тАНтЩА, ржмрж╛ржЗрж╕рж╛ржЗржХрзЗрзЗрж▓, рж╕рж╛ржЗржХрзЗрж▓, ржорж╣рж┐рж▓рж╛, ржкрж╛рж╣рж╛ржбрж╝
ЁЯЪ╡тАНтЩВ => ЁЯЪ╡тАНтЩВ, ржмрж╛ржЗрж╕рж╛ржЗржХрзЗрзЗрж▓, рж╕рж╛ржЗржХрзЗрж▓, ржкрзБрж░рзБрж╖, ржкрж╛рж╣рж╛ржбрж╝
ЁЯПО => ЁЯПО, ржЧрж╛ржбрж╝рж┐, рж░рзЗрж╕рж┐ржВ
ЁЯПН => ЁЯПН, рж░рзЗрж╕рж┐ржВ
ЁЯПЕ => ЁЯПЕ, ржкржжржХ
ЁЯПЖ => ЁЯПЖ, ржкрзБрж░рж╕рзНржХрж╛рж░
ЁЯПП => ЁЯПП, ржмрж▓, ржмрзНржпрж╛ржЯ, ржЦрзЗрж▓рж╛
ЁЯПР => ЁЯПР, ржмрж▓, ржЦрзЗрж▓рж╛
ЁЯПС => ЁЯПС, ржмрж▓, ржорж╛ржа, ржЦрзЗрж▓рж╛, рж╣ржХрж┐, рж▓рж╛ржарж┐
ЁЯПТ => ЁЯПТ, ржЦрзЗрж▓рж╛, рж╣ржХрж┐, ржмрж░ржл, ржкрж╛ржХ, рж▓рж╛ржарж┐
ЁЯПУ => ЁЯПУ, ржмрж▓, ржмрзНржпрж╛ржЯ, ржЦрзЗрж▓рж╛, ржкрзНржпрж╛ржбрзЗрж▓, ржЯрзЗржмрж┐рж▓ ржЯрзЗржирж┐рж╕
ЁЯП╕ => ЁЯП╕, ржмрж╛рж░рзНржбржЖржЗ, ржЦрзЗрж▓рж╛, ржЯрзЗржирж┐рж╕ ржЦрзЗрж▓рзЗрж░ ржмрзНржпрж╛ржЯ, рж╢рж╛ржЯрж▓ржХржХ
ЁЯОп => ЁЯОп, ржмрзБрж▓, ржмрзБрж▓рзНрж╕ржЖржЗ, ржбрж╛рж░рзНржЯ, ржЪрзЛржЦ, ржЦрзЗрж▓рж╛, рж╣рж┐ржЯ, рж▓ржХрзНрж╖рзНржп
ЁЯОо => ЁЯОо, ржирж┐ржпрж╝ржирзНрждрзНрж░ржХ, ржЦрзЗрж▓рж╛
ЁЯХ╣ => ЁЯХ╣, ржЦрзЗрж▓рж╛, ржнрж┐ржбрж┐ржУ ржЧрзЗржо
ЁЯО▓ => ЁЯО▓, ржкрж╛рж╢рж╛, ржбрж╛ржЗ, ржЦрзЗрж▓рж╛
тЩа => тЩа, ржХрж╛рж░рзНржб, ржЦрзЗрж▓рж╛, рж╕рзНржкрзЗржб, рж╕рзНржпрзБржЯ
тЩе => тЩе, ржХрж╛рж░рзНржб, ржЦрзЗрж▓рж╛, рж╣рж╛рж░рзНржЯ, рж╣рж╛рж░рзНржЯрж╕, рж╕рзНржпрзБржЯ
тЩж => тЩж, ржХрж╛рж░рзНржб, ржбрж╛ржпрж╝ржоржирзНржб, ржбрж╛ржпрж╝ржоржирзНржбрж╕, ржЦрзЗрж▓рж╛, рж╕рзНржпрзБржЯ
тЩг => тЩг, ржХрж╛рж░рзНржб, ржХрзНрж▓рж╛ржм, ржХрзНрж▓рж╛ржмрж╕, ржЧрзЗржо, рж╕рзНржпрзБржЯ
ЁЯГП => ЁЯГП, ржХрж╛рж░рзНржб, ржЦрзЗрж▓рж╛, рждрж╛рж╕
ЁЯАД => ЁЯАД, ржЦрзЗрж▓рж╛, ржорж╛рж╣ржЬржЩрзНржЧ, рж▓рж╛рж▓
ЁЯО┤ => ЁЯО┤, ржХрж╛рж░рзНржб, ржлрзБрж▓, ржЦрзЗрж▓рж╛, ржЬрж╛ржкрж╛ржирж┐, рждрж╛рж╕
ЁЯФЗ => ЁЯФЗ, ржирж┐ржГрж╢ржмрзНржж, рж╢рж╛ржирзНржд, ржирзАрж░ржм, рж╕рзНржкрж┐ржХрж╛рж░, ржЖржУржпрж╝рж╛ржЬ
ЁЯФИ => ЁЯФИ, ржЖржУржпрж╝рж╛ржЬ
ЁЯФЙ => ЁЯФЙ, ржЖрж╕рзНрждрзЗ, рж╕рзНржкрж┐ржХрж╛рж░, ржнрж▓рж┐ржЙржо, рждрж░ржЩрзНржЧрзЗрж░
ЁЯФК => ЁЯФК, 3, ржЬрзЛрж░рзЗ, ржЦрзБржм ржЬрзЛрж░рзЗ, рж╕рзНржкрж┐ржХрж╛рж░, рждрж┐ржиржЯрж┐, ржЖржпрж╝рждржи
ЁЯУв => ЁЯУв, ржЕржЯрзНржЯ, ржЬржиржЧржгрзЗрж░ ржЙржжрзНржжрзЗрж╢рзНржпрзЗ
ЁЯУг => ЁЯУг, рж╣рж░рзНрж╖ржзрзНржмржирж┐
ЁЯУп => ЁЯУп, рж╢рж┐ржЩрж╛, ржкрзЛрж╕рзНржЯ, ржбрж╛ржХ
ЁЯФФ => ЁЯФФ, ржШржгрзНржЯрж╛
ЁЯФХ => ЁЯФХ, ржШржгрзНржЯрж╛, ржирж┐рж╖рж┐ржжрзНржз, ржирж┐ржГрж╢ржмрзНржж, ржирж╛, ржиржпрж╝, ржирж┐рж╖рж┐ржжрзНржз ржерж╛ржХрж╛, рж╢рж╛ржирзНржд, ржирзАрж░ржм
ЁЯО╝ => ЁЯО╝, рж╕ржЩрзНржЧрзАржд, рж╕рзНржХрзЛрж░
ЁЯО╡ => ЁЯО╡, рж╕ржЩрзНржЧрзАржд, ржирзЛржЯ
ЁЯО╢ => ЁЯО╢, рж╕ржЩрзНржЧрзАржд, ржирзЛржЯ, ржирзЛржЯрж╕
ЁЯОЩ => ЁЯОЩ, ржорж╛ржЗржХ, ржорж╛ржЗржХрзНрж░рзЛржлрзЛржи, рж╕ржЩрзНржЧрзАржд, рж╕рзНржЯрзБржбрж┐ржУ
ЁЯОЪ => ЁЯОЪ, ржорж╛рждрзНрж░рж╛, рж╕ржЩрзНржЧрзАржд, рж╕рзНрж▓рж╛ржЗржбрж╛рж░
ЁЯОЫ => ЁЯОЫ, ржирж┐ржпрж╝ржирзНрждрзНрж░ржг, ржиржм, рж╕ржЩрзНржЧрзАржд
ЁЯОд => ЁЯОд, ржХрж╛рж░рж╛ржУржХрзЗ, ржорж╛ржЗржХ
ЁЯОз => ЁЯОз, ржЗржпрж╝рж╛рж░ржмрж╛ржб
ЁЯО╖ => ЁЯО╖, рж╕ржЩрзНржЧрзАржд ржпржирзНрждрзНрж░, рж╕ржЩрзНржЧрзАржд
ЁЯО╕ => ЁЯО╕, рж╕ржЩрзНржЧрзАржд ржпржирзНрждрзНрж░, рж╕ржЩрзНржЧрзАржд
ЁЯО╣ => ЁЯО╣, рж╕ржЩрзНржЧрзАржд ржпржирзНрждрзНрж░, ржХрзАржмрзЛрж░рзНржб, рж╕ржЩрзНржЧрзАржд, ржкрж┐ржпрж╝рж╛ржирзЛ
ЁЯО║ => ЁЯО║, рж╕ржЩрзНржЧрзАржд ржпржирзНрждрзНрж░, рж╕ржЩрзНржЧрзАржд
ЁЯО╗ => ЁЯО╗, рж╕ржЩрзНржЧрзАржд ржпржирзНрждрзНрж░, рж╕ржЩрзНржЧрзАржд
ЁЯУ╗ => ЁЯУ╗, ржнрж┐ржбрж┐ржУ
ЁЯУ▒ => ЁЯУ▒, рж╕рзЗрж▓, ржорзЛржмрж╛ржЗрж▓, ржлрзЛржи, ржЯрзЗрж▓рж┐ржлрзЛржи
ЁЯУ▓ => ЁЯУ▓, рждрзАрж░, ржХрж▓, рж╕рзЗрж▓, ржорзЛржмрж╛ржЗрж▓, ржлрзЛржи, ржЧрзНрж░рж╣ржг, ржЯрзЗрж▓рж┐ржлрзЛржи
тШО => тШО, ржлрзЛржи
ЁЯУЮ => ЁЯУЮ, ржлрзЛржи, рж░рж┐рж╕рж┐ржнрж╛рж░, ржЯрзЗрж▓рж┐ржлрзЛржи
ЁЯУЯ => ЁЯУЯ, ржкрзЗржЬрж╛рж░
ЁЯУа => ЁЯУа, ржлрзНржпрж╛ржХрзНрж╕
ЁЯФЛ => ЁЯФЛ, ржмрзНржпрж╛ржЯрж╛рж░рж┐
ЁЯФМ => ЁЯФМ, ржмрзИржжрзНржпрзБрждрж┐ржХ, ржмрж┐ржжрзНржпрзБрзО, ржкрзНрж▓рж╛ржЧ
ЁЯТ╗ => ЁЯТ╗, ржХржорзНржкрж┐ржЙржЯрж╛рж░, ржкрж┐рж╕рж┐, ржмрзНржпржХрзНрждрж┐ржЧржд
ЁЯЦе => ЁЯЦе, ржХржорзНржкрж┐ржЙржЯрж╛рж░, ржбрзЗрж╕рзНржХржЯржк
ЁЯЦи => ЁЯЦи, ржХржорзНржкрж┐ржЙржЯрж╛рж░
тМи => тМи, ржХржорзНржкрж┐ржЙржЯрж╛рж░
ЁЯЦ▒ => ЁЯЦ▒, 3, ржмрзЛрждрж╛ржо, ржХржорзНржкрж┐ржЙржЯрж╛рж░, ржорж╛ржЙрж╕, рждрж┐ржиржЯрж┐
ЁЯЦ▓ => ЁЯЦ▓, ржХржорзНржкрж┐ржЙржЯрж╛рж░
ЁЯТ╜ => ЁЯТ╜, ржХржорзНржкрж┐ржЙржЯрж╛рж░, ржбрж┐рж╕рзНржХ, ржорж┐ржирж┐ ржбрж┐рж╕рзНржХ, ржЕржкржЯрж┐ржХрзНржпрж╛рж▓
ЁЯТ╛ => ЁЯТ╛, ржХржорзНржкрж┐ржЙржЯрж╛рж░, ржбрж┐рж╕рзНржХ, ржлрзНрж▓ржкрж┐
ЁЯТ┐ => ЁЯТ┐, ржбрж┐ржнрж┐ржбрж┐, ржирзАрж▓ рж░рж╢рзНржорж┐, рж╕рж┐ржбрж┐, ржХржорзНржкрж┐ржЙржЯрж╛рж░, ржбрж┐рж╕рзНржХ, ржЕржкржЯрж┐ржХрзНржпрж╛рж▓
ЁЯУА => ЁЯУА, ржирзАрж▓ рж░рж╢рзНржорж┐, рж╕рж┐ржбрж┐, ржХржорзНржкрж┐ржЙржЯрж╛рж░, ржбрж┐рж╕рзНржХ, ржЕржкржЯрж┐ржХрзНржпрж╛рж▓
ЁЯОе => ЁЯОе, ржХрзНржпрж╛ржорзЗрж░рж╛, рж╕рж┐ржирзЗржорж╛, ржорзБржнрж┐
ЁЯОм => ЁЯОм, ржХрзНрж▓рзНржпрж╛ржкрж╛рж░, ржорзБржнрж┐
ЁЯУ╜ => ЁЯУ╜, рж╕рж┐ржирзЗржорж╛, ржлрж┐рж▓рзНржо, ржорзБржнрж┐, ржкрзНрж░ржЬрзЗржХрзНржЯрж░, ржнрж┐ржбрж┐ржУ
ЁЯУ║ => ЁЯУ║, ржЯрж┐ржнрж┐, ржнрж┐ржбрж┐ржУ
ЁЯУ╖ => ЁЯУ╖, ржнрж┐ржбрж┐ржУ
ЁЯУ╕ => ЁЯУ╕, ржХрзНржпрж╛ржорзЗрж░рж╛, ржлрзНрж▓рзНржпрж╛рж╢, ржнрж┐ржбрж┐ржУ
ЁЯУ╣ => ЁЯУ╣, ржХрзНржпрж╛ржорзЗрж░рж╛, ржнрж┐ржбрж┐ржУ
ЁЯУ╝ => ЁЯУ╝, ржЯрзЗржк, ржнрж┐ржПржЪржЗржПрж╕, ржнрж┐ржбрж┐ржУ
ЁЯФН => ЁЯФН, ржХрж╛ржЪ, ржЖрждрж╕, ржЕржирзБрж╕ржирзНржзрж╛ржи, рж╕рж░ржЮрзНржЬрж╛ржо
ЁЯФО => ЁЯФО, ржХрж╛ржЪ, ржЖрждрж╕, ржЕржирзБрж╕ржирзНржзрж╛ржи, рж╕рж░ржЮрзНржЬрж╛ржо
ЁЯФм => ЁЯФм, рж╕рж░ржЮрзНржЬрж╛ржо
ЁЯФн => ЁЯФн, рж╕рж░ржЮрзНржЬрж╛ржо
ЁЯУб => ЁЯУб, ржЕрзНржпрж╛ржирзНржЯрзЗржирж╛, ржбрж┐рж╢, ржЙржкржЧрзНрж░рж╣
ЁЯХп => ЁЯХп, ржЖрж▓рзЛ
ЁЯТб => ЁЯТб, ржмрж╛рж▓рзНржм, ржХржорж┐ржХ, ржмрзИржжрзНржпрзБрждрж┐ржХ, ржзрж╛рж░ржгрж╛, ржЖрж▓рзЛ
ЁЯФж => ЁЯФж, ржмрзИржжрзНржпрзБрждрж┐ржХ, ржЖрж▓рзЛ, рж╕рж░ржЮрзНржЬрж╛ржо, ржорж╢рж╛рж▓
ЁЯПо => ЁЯПо, ржмрж╛рж░, ржЬрж╛ржкрж╛ржирж┐, рж▓ржгрзНржаржи, ржЖрж▓рзЛ, рж▓рж╛рж▓
ЁЯУФ => ЁЯУФ, ржмржЗ, ржЖржмрж░ржг, рж╕ржЬрзНржЬрж┐ржд, ржирзЛржЯржмржЗ
ЁЯУХ => ЁЯУХ, ржмржЗ, ржмржирзНржз
ЁЯУЦ => ЁЯУЦ, ржмржЗ, ржЦрзЛрж▓рж╛
ЁЯУЧ => ЁЯУЧ, ржмржЗ, рж╕ржмрзБржЬ
ЁЯУШ => ЁЯУШ, ржирзАрж▓, ржмржЗ
ЁЯУЩ => ЁЯУЩ, ржмржЗ, ржХржорж▓рж╛
ЁЯУЪ => ЁЯУЪ, ржмржЗ
ЁЯУУ => ЁЯУУ, ржирзЛржЯржмржЗ
ЁЯУТ => ЁЯУТ, ржирзЛржЯржмржЗ
ЁЯУГ => ЁЯУГ, ржХрзБржирзНржбрж▓рзА ржкрж╛ржХрж╛ржирзЛ, ржиржерж┐, ржкрзГрж╖рзНржарж╛
ЁЯУЬ => ЁЯУЬ, ржХрж╛ржЧржЬ
ЁЯУД => ЁЯУД, ржиржерж┐, ржкрзГрж╖рзНржарж╛
ЁЯУ░ => ЁЯУ░, рж╕ржВржмрж╛ржж, ржХрж╛ржЧржЬ
ЁЯЧЮ => ЁЯЧЮ, рж╕ржВржмрж╛ржж, рж╕ржВржмрж╛ржжржкрждрзНрж░, ржХрж╛ржЧржЬ, ржкрж╛ржХрж╛ржирзЛ
ЁЯУС => ЁЯУС, ржмрзБржХржорж╛рж░рзНржХ, ржЪрж┐рж╣рзНржи, ржорж╛рж░рзНржХрж╛рж░, ржЯрзНржпрж╛ржм
ЁЯФЦ => ЁЯФЦ, ржЪрж┐рж╣рзНржи
ЁЯТ░ => ЁЯТ░, ржмрзНржпрж╛ржЧ, ржбрж▓рж╛рж░, ржЯрж╛ржХрж╛, ржЯрж╛ржХрж╛ ржмрзНржпрж╛ржЧ
ЁЯТ┤ => ЁЯТ┤, ржмрзНржпрж╛ржВржХ, ржХрж╛ржЧржЬрзЗрж░ ржорзБржжрзНрж░рж╛, ржмрж┐рж▓, ржорзБржжрзНрж░рж╛, ржЯрж╛ржХрж╛, ржирзЛржЯ, ржЗржпрж╝рзЗржи
ЁЯТ╡ => ЁЯТ╡, ржмрзНржпрж╛ржВржХ, ржХрж╛ржЧржЬрзЗрж░ ржорзБржжрзНрж░рж╛, ржмрж┐рж▓, ржорзБржжрзНрж░рж╛, ржбрж▓рж╛рж░, ржЯрж╛ржХрж╛, ржирзЛржЯ
ЁЯТ╢ => ЁЯТ╢, ржмрзНржпрж╛ржВржХ, ржХрж╛ржЧржЬрзЗрж░ ржорзБржжрзНрж░рж╛, ржмрж┐рж▓, ржорзБржжрзНрж░рж╛, ржЗржЙрж░рзЛ, ржЯрж╛ржХрж╛, ржирзЛржЯ
ЁЯТ╖ => ЁЯТ╖, ржмрзНржпрж╛ржВржХ, ржХрж╛ржЧржЬрзЗрж░ ржорзБржжрзНрж░рж╛, ржмрж┐рж▓, ржорзБржжрзНрж░рж╛, ржЯрж╛ржХрж╛, ржирзЛржЯ, ржкрж╛ржЙржирзНржб
ЁЯТ╕ => ЁЯТ╕, ржмрзНржпрж╛ржВржХ, ржХрж╛ржЧржЬрзЗрж░ ржорзБржжрзНрж░рж╛, ржмрж┐рж▓, ржбрж▓рж╛рж░, ржУржбрж╝рж╛, ржЯрж╛ржХрж╛, ржирзЛржЯ, ржбрж╛ржирж╛
ЁЯТ│ => ЁЯТ│, ржмрзНржпрж╛ржВржХ, ржХрж╛рж░рзНржб, ржЛржг, ржЯрж╛ржХрж╛
ЁЯТ╣ => ЁЯТ╣, ржмрзНржпрж╛ржВржХ, ржЪрж╛рж░рзНржЯ, ржорзБржжрзНрж░рж╛, ржЧрзНрж░рж╛ржл, ржмрзГржжрзНржзрж┐, ржмрж╛ржЬрж╛рж░, ржЯрж╛ржХрж╛, ржкрзНрж░ржмржгрждрж╛, ржЙрж░рзНржзрзНржмржЧрж╛ржорзА, ржЗржпрж╝рзЗржи
тЬЙ => тЬЙ, ржЗ-ржорзЗрж▓, ржЗржорзЗрж▓
ЁЯУз => ЁЯУз, ржЗржорзЗрж▓, ржЪрж┐ржарж┐, ржорзЗрж▓
ЁЯУи => ЁЯУи, ржЗ-ржорзЗрж▓, ржЗржорзЗрж▓, ржЦрж╛ржо, ржЖржЧржд, ржЪрж┐ржарж┐, ржорзЗрж▓, ржЧрзНрж░рж╣ржг
ЁЯУй => ЁЯУй, рждрзАрж░, ржирж┐ржорзНржиржорзБржЦрзА, ржЗ-ржорзЗрж▓, ржЗржорзЗрж▓, ржЦрж╛ржо, ржЪрж┐ржарж┐, ржорзЗрж▓, ржмрж╣рж┐рж░рзНржЧрж╛ржорзА, ржкрзНрж░рзЗрж░рж┐ржд
ЁЯУд => ЁЯУд, ржмрж╛ржХрзНрж╕, ржЪрж┐ржарж┐, ржорзЗрж▓, ржЖржЙржЯржмржХрзНрж╕, ржкрзНрж░рзЗрж░рж┐ржд, ржЯрзНрж░рзЗ
ЁЯУе => ЁЯУе, ржмрж╛ржХрзНрж╕, ржЗржиржмржХрзНрж╕, ржЪрж┐ржарж┐, ржорзЗрж▓, ржЧрзНрж░рж╣ржг, ржЯрзНрж░рзЗ
ЁЯУж => ЁЯУж, ржмрж╛ржХрзНрж╕, ржорзЛржбрж╝ржХ
ЁЯУл => ЁЯУл, ржмржирзНржз, ржорзЗрж▓, ржорзЗрж▓ржмрж╛ржХрзНрж╕, ржбрж╛ржХ ржмрж╛ржХрзНрж╕
ЁЯУк => ЁЯУк, ржмржирзНржз, ржиржд, ржорзЗрж▓, ржорзЗрж▓ржмрж╛ржХрзНрж╕, ржбрж╛ржХ ржмрж╛ржХрзНрж╕
ЁЯУм => ЁЯУм, ржорзЗрж▓, ржорзЗрж▓ржмрж╛ржХрзНрж╕, ржЦрзЛрж▓рж╛, ржбрж╛ржХ ржмрж╛ржХрзНрж╕
ЁЯУн => ЁЯУн, ржиржд, ржорзЗрж▓, ржорзЗрж▓ржмрж╛ржХрзНрж╕, ржЦрзЛрж▓рж╛, ржбрж╛ржХ ржмрж╛ржХрзНрж╕
ЁЯУо => ЁЯУо, ржорзЗрж▓, ржорзЗрж▓ржмрж╛ржХрзНрж╕
ЁЯЧ│ => ЁЯЧ│, ржмрзНржпрж╛рж▓ржЯ, ржмрж╛ржХрзНрж╕
тЬП => тЬП, ржкрзЗржирж╕рж┐рж▓
тЬТ => тЬТ, ржирж┐ржм, ржХрж▓ржо
ЁЯЦЛ => ЁЯЦЛ, ржлрж╛ржЙржирзНржЯрзЗржи, ржХрж▓ржо
ЁЯЦК => ЁЯЦК, ржмрж▓ржкрзЗржи
ЁЯЦМ => ЁЯЦМ, ржкрзЗржирзНржЯрж┐ржВ
ЁЯЦН => ЁЯЦН, ржХрзНрж░рзЗржпрж╝ржи
ЁЯУЭ => ЁЯУЭ, ржкрзЗржирзНрж╕рж┐рж▓
ЁЯТ╝ => ЁЯТ╝, ржмрзНрж░рж┐ржлржХрзЗрж╕
ЁЯУБ => ЁЯУБ, ржлрж╛ржЗрж▓, ржлрзЛрж▓рзНржбрж╛рж░
ЁЯУВ => ЁЯУВ, ржлрж╛ржЗрж▓, ржлрзЛрж▓рзНржбрж╛рж░, ржЦрзЛрж▓рж╛
ЁЯЧВ => ЁЯЧВ, ржХрж╛рж░рзНржб, ржмрж┐ржнржХрзНржд, рж╕рзВржЪржХ
ЁЯУЕ => ЁЯУЕ, рждрж╛рж░рж┐ржЦ
ЁЯУЖ => ЁЯУЖ, ржХрзНржпрж╛рж▓рзЗржирзНржбрж╛рж░
ЁЯЧТ => ЁЯЧТ, ржирзЛржЯ, ржкрзНржпрж╛ржб, ржкрзЗржБржЪрж╛ржирзЛ
ЁЯЧУ => ЁЯЧУ, ржХрзНржпрж╛рж▓рзЗржирзНржбрж╛рж░, ржкрзНржпрж╛ржб, ржкрзЗржБржЪрж╛ржирзЛ
ЁЯУЗ => ЁЯУЗ, ржХрж╛рж░рзНржб, рж╕рзВржЪржХ, рж░рзЛрж▓рзЛржбрзЗржХрзНрж╕
ЁЯУИ => ЁЯУИ, ржЪрж╛рж░рзНржЯ, ржЧрзНрж░рж╛ржл, ржмрзГржжрзНржзрж┐, ржкрзНрж░ржмржгрждрж╛, ржЙрж░рзНржзрзНржмржорзБржЦрзА
ЁЯУЙ => ЁЯУЙ, ржЪрж╛рж░рзНржЯ, ржирж┐ржорзНржиржорзБржЦрзА, ржЧрзНрж░рж╛ржл, ржкрзНрж░ржмржгрждрж╛
ЁЯУК => ЁЯУК, ржмрж╛рж░, ржЪрж╛рж░рзНржЯ, ржЧрзНрж░рж╛ржл
ЁЯУЛ => ЁЯУЛ, ржХрзНрж▓рж┐ржкржмрзЛрж░рзНржб
ЁЯУМ => ЁЯУМ, ржкрж┐ржи
ЁЯУН => ЁЯУН, ржкрж┐ржи, ржкрзБрж╢ ржкрж┐ржи
ЁЯУО => ЁЯУО, ржкрзЗржкрж╛рж░ржХрзНрж▓рж┐ржк
ЁЯЦЗ => ЁЯЦЗ, рж▓рж┐ржВржХ, ржкрзЗржкрж╛рж░ ржХрзНрж▓рж┐ржк
ЁЯУП => ЁЯУП, рж░рзБрж▓рж╛рж░, рж╕рзЛржЬрж╛ ржкрзНрж░рж╛ржирзНржд
ЁЯУР => ЁЯУР, рж░рзБрж▓рж╛рж░, рж╕рзЗржЯ, рждрзНрж░рж┐ржнрзБржЬ
тЬВ => тЬВ, рж╕рж░ржЮрзНржЬрж╛ржо
ЁЯЧГ => ЁЯЧГ, ржмрж╛ржХрзНрж╕, ржХрж╛рж░рзНржб, ржлрж╛ржЗрж▓
ЁЯЧД => ЁЯЧД, ржХрзНржпрж╛ржмрж┐ржирзЗржЯ, ржлрж╛ржЗрж▓
ЁЯЧС => ЁЯЧС, ржмрж╛ржЬрзЗ ржХрж╛ржЧржЬ ржлрзЗрж▓рж╛рж░ ржЭрзБржБржбрж╝рж┐
ЁЯФТ => ЁЯФТ, ржмржирзНржз
ЁЯФУ => ЁЯФУ, рждрж╛рж▓рж╛, ржЦрзЛрж▓рж╛, рждрж╛рж▓рж╛ ржЦрзЛрж▓рж╛
ЁЯФП => ЁЯФП, ржХрж╛рж▓рж┐, рждрж╛рж▓рж╛, ржирж┐ржм, ржХрж▓ржо, ржЧрзЛржкржирзАржпрж╝рждрж╛
ЁЯФР => ЁЯФР, ржмржирзНржз, ржЪрж╛ржмрж┐, рждрж╛рж▓рж╛, ржирж┐рж░рж╛ржкржж
ЁЯФС => ЁЯФС, рждрж╛рж▓рж╛, ржкрж╛рж╕ржУржпрж╝рж╛рж░рзНржб
ЁЯЧЭ => ЁЯЧЭ, рж╕рзВрждрзНрж░, ржЪрж╛ржмрж┐, рждрж╛рж▓рж╛, ржкрзБрж░рж╛ржирзЛ
ЁЯФи => ЁЯФи, рж╕рж░ржЮрзНржЬрж╛ржо
тЫП => тЫП, ржЦржиржи, рж╕рж░ржЮрзНржЬрж╛ржо
тЪТ => тЪТ, рж╣рж╛рждрзБржбрж╝рж┐, ржЧрж╛ржЗрждрж┐, рж╕рж░ржЮрзНржЬрж╛ржо
ЁЯЫа => ЁЯЫа, рж╣рж╛рждрзБржбрж╝рж┐, рж╕рж░ржЮрзНржЬрж╛ржо, рж░рзЗржЮрзНржЪ
ЁЯФз => ЁЯФз, рж╕рж░ржЮрзНржЬрж╛ржо
ЁЯФй => ЁЯФй, ржмрзЛрж▓рзНржЯ, ржирж╛ржЯ, рж╕рж░ржЮрзНржЬрж╛ржо
тЪЩ => тЪЩ, рж╕рж░ржЮрзНржЬрж╛ржо
ЁЯЧЬ => ЁЯЧЬ, рж╕рж░ржЮрзНржЬрж╛ржо, ржнрж╛ржЗрж╕
тЪЧ => тЪЧ, рж░рж╕рж╛ржпрж╝ржи, рж╕рж░ржЮрзНржЬрж╛ржо
тЪЦ => тЪЦ, ржнрж╛рж░рж╕рж╛ржорзНржп, ржмрж┐ржЪрж╛рж░, рждрзБрж▓рж╛ рж░рж╛рж╢рж┐, рждрзБрж▓рж╛, рж╕рж░ржЮрзНржЬрж╛ржо, ржУржЬржи, рж░рж╛рж╢рж┐ржЪржХрзНрж░
ЁЯФЧ => ЁЯФЧ, рж▓рж┐ржВржХ
тЫУ => тЫУ, рж╢рзГржЩрзНржЦрж▓
ЁЯТЙ => ЁЯТЙ, ржбрж╛ржХрзНрждрж╛рж░, ржУрж╖рзБржз, рж╕рзВржБржЪ, рж╢ржЯ, ржЕрж╕рзБрж╕рзНрже, рж╕рж░ржЮрзНржЬрж╛ржо
ЁЯТК => ЁЯТК, ржбрж╛ржХрзНрждрж╛рж░, ржУрж╖рзБржз, ржЕрж╕рзБрж╕рзНрже
ЁЯЧб => ЁЯЧб, ржЕрж╕рзНрждрзНрж░
ЁЯФк => ЁЯФк, рж░ржирзНржзржи, рж╣рзЛржХрзЛ, ржЫрзБрж░рж┐, рж╕рж░ржЮрзНржЬрж╛ржо, ржЕрж╕рзНрждрзНрж░
тЪФ => тЪФ, ржЖржбрж╝рж╛ржЖржбрж╝рж┐ ржнрж╛ржмрзЗ ржерж╛ржХрж╛, рждрж▓рзЛржпрж╝рж╛рж░, ржЕрж╕рзНрждрзНрж░
ЁЯФл => ЁЯФл, ржмржирзНржжрзБржХ, рж░рж┐ржнрж▓ржмрж╛рж░, рж╕рж░ржЮрзНржЬрж╛ржо, ржЕрж╕рзНрждрзНрж░
ЁЯЫб => ЁЯЫб, ржЕрж╕рзНрждрзНрж░
ЁЯП╣ => ЁЯП╣, рждрзАрж░ржирзНржжрж╛ржЬ, рждрзАрж░, ржирзЛржпрж╝рж╛ржи, ржзржирзБ, рж╕рж░ржЮрзНржЬрж╛ржо, ржЕрж╕рзНрждрзНрж░, рж░рж╛рж╢рж┐ржЪржХрзНрж░
ЁЯПБ => ЁЯПБ, ржЫржХржХрж╛ржЯрж╛, рж░рзЗрж╕рж┐ржВ
ЁЯП│ => ЁЯП│, рждрж░ржЩрзНржЧрж╛ржпрж╝рж┐ржд
ЁЯП│тАНЁЯМИ => ЁЯП│тАНЁЯМИ, ржкрж╛рждрж╛ржХ, рж░рж╛ржоржзржирзБ
ЁЯП┤ => ЁЯП┤, рждрж░ржЩрзНржЧрж╛ржпрж╝рж┐ржд
ЁЯЪй => ЁЯЪй, ржкрзЛрж╕рзНржЯ
ЁЯЪм => ЁЯЪм, ржзрзБржорзНрж░ржкрж╛ржи
тЪ░ => тЪ░, ржорзГрждрзНржпрзБ
тЪ▒ => тЪ▒, ржорзГрждрзНржпрзБ, ржЕржирзНрждрзНржпрзЗрж╖рзНржЯрж┐ржХрзНрж░рж┐ржпрж╝рж╛, ржкрж╛рждрзНрж░
ЁЯЧ┐ => ЁЯЧ┐, ржорзБржЦ, ржорзЛржпрж╝рж╛ржЗ, ржорзВрж░рзНрждрж┐
ЁЯЫв => ЁЯЫв, ржбрзНрж░рж╛ржо, рждрзЗрж▓
ЁЯФо => ЁЯФо, ржмрж▓, ржХрзНрж░рж┐рж╕рзНржЯрж╛рж▓, рж░рзВржкржХржерж╛, ржХрж▓рзНржкржирж╛, рж╕рзМржнрж╛ржЧрзНржп, рж╕рж░ржЮрзНржЬрж╛ржо
ЁЯПз => ЁЯПз, ржПржЯрж┐ржПржо, рж╕рзНржмржпрж╝ржВржХрзНрж░рж┐ржпрж╝, ржмрзНржпрж╛ржВржХ, ржЯрзЗрж▓рж╛рж░
ЁЯЪо => ЁЯЪо, ржЬржЮрзНржЬрж╛рж▓, ржЬржЮрзНржЬрж╛рж▓ ржмрж╛ржХрзНрж╕
ЁЯЪ░ => ЁЯЪ░, ржкрж╛ржи ржХрж░рж╛, ржкрж╛ржирзАржпрж╝, ржЬрж▓
тЩ┐ => тЩ┐, ржкрзНрж░ржмрзЗрж╢
ЁЯЪ╣ => ЁЯЪ╣, рж╢рзМржЪрж╛ржЧрж╛рж░, ржкрзБрж░рзБрж╖, рж░рзЗрж╕рзНржЯрж░рзБржо
ЁЯЪ║ => ЁЯЪ║, рж╢рзМржЪрж╛ржЧрж╛рж░, рж░рзЗрж╕рзНржЯрж░рзБржо, ржирж╛рж░рзА
ЁЯЪ╗ => ЁЯЪ╗, рж╢рзМржЪрж╛ржЧрж╛рж░
ЁЯЪ╝ => ЁЯЪ╝, рж╢рж┐рж╢рзБ, ржЪрзЗржЮрзНржЬрж┐ржВ
ЁЯЪ╛ => ЁЯЪ╛, рж░рзЗрж╕рзНржЯрж░рзБржо, ржЬрж▓
ЁЯЫВ => ЁЯЫВ, ржирж┐ржпрж╝ржирзНрждрзНрж░ржг, ржкрж╛рж╕ржкрзЛрж░рзНржЯ
ЁЯЫГ => ЁЯЫГ, ржХрж╛рж╕рзНржЯржорж╕
ЁЯЫД => ЁЯЫД, ржмрзНржпрж╛ржЧрзЗржЬ, ржжрж╛ржмрж┐
ЁЯЫЕ => ЁЯЫЕ, ржмрзНржпрж╛ржЧрзЗржЬ, рж▓ржХрж╛рж░, рж▓рж╛ржЧрзЗржЬ
тЪа => тЪа, ржзрзВржоржкрж╛ржи
ЁЯЪ╕ => ЁЯЪ╕, рж╕ржирзНрждрж╛ржи, ржкрж╛рж░рж╛ржкрж╛рж░, ржкржержЪрж╛рж░рзА, ржЯрзНрж░рж╛ржлрж┐ржХ
тЫФ => тЫФ, ржкрзНрж░ржмрзЗрж╢, ржирж┐рж╖рж┐ржжрзНржз, ржирж╛, ржиржпрж╝, ржирж┐рж╖рж┐ржжрзНржз ржерж╛ржХрж╛, ржЯрзНрж░рж╛ржлрж┐ржХ
ЁЯЪл => ЁЯЪл, ржкрзНрж░ржмрзЗрж╢, ржирж╛, ржиржпрж╝
ЁЯЪ│ => ЁЯЪ│, ржмрж╛ржЗрж╕рж╛ржЗржХрзЗрж▓, ржмрж╛ржЗржХ, ржирж┐рж╖рж┐ржжрзНржз, ржирж╛, ржиржпрж╝, ржирж┐рж╖рж┐ржжрзНржз ржерж╛ржХрж╛, ржпрж╛ржиржмрж╛рж╣ржи
ЁЯЪн => ЁЯЪн, ржирж┐рж╖рж┐ржжрзНржз, ржирж╛, ржиржпрж╝, ржирж┐рж╖рж┐ржжрзНржз ржерж╛ржХрж╛, ржзрзВржоржкрж╛ржи
ЁЯЪп => ЁЯЪп, ржирж┐рж╖рж┐ржжрзНржз, ржЬржЮрзНржЬрж╛рж▓, ржирж╛, ржиржпрж╝, ржирж┐рж╖рж┐ржжрзНржз ржерж╛ржХрж╛
ЁЯЪ▒ => ЁЯЪ▒, ржкрж╛ржи ржХрж░рж╛, ржирж┐рж╖рж┐ржжрзНржз, ржирж╛, ржиржпрж╝, ржкрж╛ржирзАржпрж╝, ржирж┐рж╖рж┐ржжрзНржз ржерж╛ржХрж╛, ржЬрж▓
ЁЯЪ╖ => ЁЯЪ╖, ржирж┐рж╖рж┐ржжрзНржз, ржирж╛, ржиржпрж╝, ржкржержЪрж╛рж░рзА, ржирж┐рж╖рж┐ржжрзНржз ржерж╛ржХрж╛
тШв => тШв, рж░рзЗржбрж┐ржУржЕрзНржпрж╛ржХржЯрж┐ржн, ржЪрж┐рж╣рзНржи
тШг => тШг, ржмрж╛ржпрж╝рзЛрж╣рзНржпрж╛ржЬрж╛рж░рзНржб, ржЪрж┐рж╣рзНржи
тмЖ => тмЖ, рждрзАрж░, ржжрж┐ржЧржирж┐рж░рзНржгржпрж╝, ржжрж┐ржХ, ржЙрждрзНрждрж░
тЖЧ => тЖЧ, рждрзАрж░, ржжрж┐ржХ, ржЖржирзНрждржГ ржжрж┐ржЧржирж┐рж░рзНржгржпрж╝, ржЙрждрзНрждрж░-ржкрзВрж░рзНржм
тЮб => тЮб, рждрзАрж░, ржжрж┐ржЧржирж┐рж░рзНржгржпрж╝, ржжрж┐ржХ, ржкрзВрж░рзНржм
тЖШ => тЖШ, рждрзАрж░, ржжрж┐ржХ, ржЖржирзНрждржГ ржжрж┐ржЧржирж┐рж░рзНржгржпрж╝, ржжржХрзНрж╖рж┐ржг-ржкрзВрж░рзНржм
тмЗ => тмЗ, рждрзАрж░, ржжрж┐ржЧржирж┐рж░рзНржгржпрж╝, ржжрж┐ржХ, ржирж┐ржЪрзЗ, ржжржХрзНрж╖рж┐ржг
тЖЩ => тЖЩ, рждрзАрж░, ржжрж┐ржХ, ржЖржирзНрждржГ ржжрж┐ржЧржирж┐рж░рзНржгржпрж╝, ржжржХрзНрж╖рж┐ржг-ржкрж╢рзНржЪрж┐ржо
тмЕ => тмЕ, рждрзАрж░, ржжрж┐ржЧржирж┐рж░рзНржгржпрж╝, ржжрж┐ржХ, ржкрж╢рзНржЪрж┐ржо
тЖЦ => тЖЦ, рждрзАрж░, ржжрж┐ржХ, ржЖржирзНрждржГ ржжрж┐ржЧржирж┐рж░рзНржгржпрж╝, ржЙрждрзНрждрж░-ржкрж╢рзНржЪрж┐ржо
тЖХ => тЖХ, рждрзАрж░
тЖФ => тЖФ, рждрзАрж░
тЖй => тЖй, рждрзАрж░
тЖк => тЖк, рждрзАрж░
тд┤ => тд┤, рждрзАрж░
тд╡ => тд╡, рждрзАрж░, ржирж┐ржорзНржиржорзБржЦрзА
ЁЯФГ => ЁЯФГ, рждрзАрж░, ржШржбрж╝рж┐рж░ ржХрж╛ржБржЯрж╛рж░ ржжрж┐ржХрзЗ, ржкрзБржирж░рж╛ржпрж╝ рж▓рзЛржб
ЁЯФД => ЁЯФД, ржШржбрж╝рж┐рж░ ржХрж╛ржБржЯрж╛рж░ ржмрж┐ржкрж░рзАржд ржжрж┐ржХрзЗ, рждрзАрж░, ржШржбрж╝рж┐рж░ ржХрж╛ржБржЯрж╛рж░ ржмрж┐ржкрж░рзАржд ржжрж┐ржХрзЗ ржШрзЛрж░рж╛
ЁЯФЩ => ЁЯФЩ, рждрзАрж░, ржкрж┐ржЫржирзЗ
ЁЯФЪ => ЁЯФЪ, рждрзАрж░, рж╢рзЗрж╖
ЁЯФЫ => ЁЯФЫ, рждрзАрж░, ржЪрж┐рж╣рзНржи, ржЪрж╛рж▓рзБ
ЁЯФЬ => ЁЯФЬ, рждрзАрж░, рж╢рзАржШрзНрж░ржЗ
ЁЯФЭ => ЁЯФЭ, рждрзАрж░, рж╢рзАрж░рзНрж╖, ржЙрж░рзНржжрзНржзржорзБржЦрзА
ЁЯЫР => ЁЯЫР, ржзрж░рзНржо, ржкрзВржЬрж╛
тЪЫ => тЪЫ, ржирж╛рж╕рзНрждрж┐ржХ, ржкрж░ржорж╛ржгрзБ
ЁЯХЙ => ЁЯХЙ, рж╣рж┐ржирзНржжрзБ, ржзрж░рзНржо
тЬб => тЬб, ржбрзЗржнрж┐ржб, ржЗрж╣рзБржжрж┐, ржЗрж╣рзБржжрж┐ ржзрж░рзНржо, ржзрж░рзНржо, рждрж╛рж░рж╛
тШ╕ => тШ╕, ржмрзМржжрзНржз, ржзрж░рзНржо, ржЪрж╛ржХрж╛
тШп => тШп, ржзрж░рзНржо, рждрж╛ржУ, рждрж╛ржУржмрж╛ржжрзА, ржЗржпрж╝рж╛ржВ, ржЗржи
тЬЭ => тЬЭ, ржЦрзГрж╕рзНржЯрж╛ржи, ржХрзНрж░рж╕, ржзрж░рзНржо
тШж => тШж, ржЦрзГрж╕рзНржЯрж╛ржи, ржХрзНрж░рж╕, ржзрж░рзНржо
тШк => тШк, ржЗрж╕рж▓рж╛ржо, ржорзБрж╕рж▓рж┐ржо, ржзрж░рзНржо
тШо => тШо, рж╢рж╛ржирзНрждрж┐
ЁЯХО => ЁЯХО, ржжрзАржкрж╛ржзрж╛рж░, ржмрж╛рждрж┐ржжрж╛ржи, ржзрж░рзНржо
ЁЯФп => ЁЯФп, рж╕рзМржнрж╛ржЧрзНржп, рждрж╛рж░рж╛
тЩ╗ => тЩ╗, ржкрзБржирж░рзНржмрзНржпржмрж╣рж╛рж░
ЁЯУЫ => ЁЯУЫ, ржмрзНржпрж╛ржЬ, ржирж╛ржо
тЪЬ => тЪЬ, ржлрзНрж▓рж╛рж░-ржбрж┐-рж▓рж┐рж╕ (ржПржХржзрж░ржирзЗрж░ ржлрзБрж▓)
ЁЯФ░ => ЁЯФ░, рж╢рж┐ржХрзНрж╖рж╛ржиржмрж┐рж╕, рж╢рзЗржнрзНрж░ржи, рж╕ржмрзБржЬ, ржЬрж╛ржкрж╛ржирж┐, ржкрж╛рждрж╛, рж╕рж░ржЮрзНржЬрж╛ржо, рж╣рж▓рзБржж
ЁЯФ▒ => ЁЯФ▒, ржирзЛржЩрзНржЧрж░, ржкрзНрж░рждрзАржХ, ржЬрж╛рж╣рж╛ржЬ, рж╕рж░ржЮрзНржЬрж╛ржо, рждрзНрж░рж┐рж╢рзВрж▓
тнХ => тнХ, ржмрзГрждрзНржд, ржЗржВрж░рж╛ржЬрзА тАШржУтАЩ ржЪрж┐рж╣рзНржи
тЬЕ => тЬЕ, ржЯрж┐ржХ, ржЪрж┐рж╣рзНржи
тШС => тШС, ржмрзНржпрж╛рж▓ржЯ, ржмрж╛ржХрзНрж╕, ржЯрж┐ржХ
тЬФ => тЬФ, ржЯрж┐ржХ, ржЪрж┐рж╣рзНржи
тЬЦ => тЬЦ, ржмрж╛рждрж┐рж▓, ржЧрзБржг, ржЧрзБржи ржХрж░рж╛, ржПржХрзНрж╕
тЭМ => тЭМ, ржмрж╛рждрж┐рж▓, ржЪрж┐рж╣рзНржи, ржЧрзБржг, ржЧрзБржи ржХрж░рж╛, ржПржХрзНрж╕
тЭО => тЭО, ржЪрж┐рж╣рзНржи, ржмрж░рзНржЧрж╛ржХрж╛рж░
тЮХ => тЮХ, ржЧржгрж┐ржд, ржпрзЛржЧ
тЮЦ => тЮЦ, ржЧржгрж┐ржд, ржмрж┐ржпрж╝рзЛржЧ
тЮЧ => тЮЧ, ржмрж┐ржнрж╛ржЧ, ржЧржгрж┐ржд
тЮ░ => тЮ░, ржХрзБржирзНржбрж▓рзА ржкрж╛ржХрж╛ржирзЛ, рж▓рзБржк
тЮ┐ => тЮ┐, ржХрзБржирзНржбрж▓рзА ржкрж╛ржХрж╛ржирзЛ, ржжрзНржмрж┐ржЧрзБржг, рж▓рзБржк
уА╜ => уА╜, ржЪрж┐рж╣рзНржи, ржЕржВрж╢
тЬ│ => тЬ│, рждрж╛рж░ржХрж╛ржЪрж┐рж╣рзНржи
тЬ┤ => тЬ┤, рждрж╛рж░рж╛
тЭЗ => тЭЗ, ржжрзНржпрзБрждрж┐
ЁЯТ▒ => ЁЯТ▒, ржмрзНржпрж╛ржВржХ, ржорзБржжрзНрж░рж╛, ржмрж┐ржирж┐ржоржпрж╝, ржЯрж╛ржХрж╛
ЁЯТ▓ => ЁЯТ▓, ржорзБржжрзНрж░рж╛, ржбрж▓рж╛рж░, ржЯрж╛ржХрж╛
тА╝ => тА╝, ржмрзНржпрж╛ржВ ржмрзНржпрж╛ржВ, ржмрж┐рж╕рзНржоржпрж╝ржмрзЛржзржХ, ржЪрж┐рж╣рзНржи, ржпрждрж┐ржЪрж┐рж╣рзНржи
тБЙ => тБЙ, ржмрж┐рж╕рзНржоржпрж╝ржмрзЛржзржХ, ржПржХржЗрж╕рж╛ржерзЗ ржмрж┐рж╕рзНржоржпрж╝ржмрзЛржзржХ ржПржмржВ ржкрзНрж░рж╢рзНржиржмрзЛржзржХ, ржЪрж┐рж╣рзНржи, ржпрждрж┐ржЪрж┐рж╣рзНржи, ржкрзНрж░рж╢рзНржи
тЭУ => тЭУ, ржЪрж┐рж╣рзНржи, ржпрждрж┐ржЪрж┐рж╣рзНржи, ржкрзНрж░рж╢рзНржи
тЭФ => тЭФ, ржЪрж┐рж╣рзНржи, рж░рзВржкрж░рзЗржЦрж╛, ржпрждрж┐ржЪрж┐рж╣рзНржи, ржкрзНрж░рж╢рзНржи
тЭХ => тЭХ, ржмрж┐рж╕рзНржоржпрж╝ржмрзЛржзржХ, ржЪрж┐рж╣рзНржи, рж░рзВржкрж░рзЗржЦрж╛, ржпрждрж┐ржЪрж┐рж╣рзНржи
тЭЧ => тЭЧ, ржмрж┐рж╕рзНржоржпрж╝ржмрзЛржзржХ, ржЪрж┐рж╣рзНржи, ржпрждрж┐ржЪрж┐рж╣рзНржи
уА░ => уА░, ржбрзНржпрж╛рж╢, ржпрждрж┐ржЪрж┐рж╣рзНржи, рждрж░ржЩрзНржЧрж╛ржпрж╝рж┐ржд
┬й => ┬й, ржХржкрж┐рж░рж╛ржЗржЯ
┬о => ┬о, ржиржерж┐ржнрзБржХрзНржд
тДв => тДв, ржЪрж┐рж╣рзНржи, TM, ржЯрзНрж░рзЗржбржорж╛рж░рзНржХ
тЩИ => тЩИ, рж░рж╛рж╢рж┐ржЪржХрзНрж░
тЩЙ => тЩЙ, ржмрзБрж▓, рж░рж╛рж╢рж┐ржЪржХрзНрж░
тЩК => тЩК, ржорж┐ржерзБржирж░рж╛рж╢рж┐, рж░рж╛рж╢рж┐ржЪржХрзНрж░
тЩЛ => тЩЛ, ржХрж░рзНржХржЯрж░рж╛рж╢рж┐, рж░рж╛рж╢рж┐ржЪржХрзНрж░
тЩМ => тЩМ, рж░рж╛рж╢рж┐ржЪржХрзНрж░
тЩН => тЩН, ржХрзБржорж╛рж░рзА, рж░рж╛рж╢рж┐ржЪржХрзНрж░
тЩО => тЩО, ржнрж╛рж░рж╕рж╛ржорзНржп, ржмрж┐ржЪрж╛рж░, рж░рж╛рж╢рж┐ржЪржХрзНрж░
тЩП => тЩП, рж░рж╛рж╢рж┐ржЪржХрзНрж░
тЩР => тЩР, рж░рж╛рж╢рж┐ржЪржХрзНрж░
тЩС => тЩС, рж░рж╛рж╢рж┐ржЪржХрзНрж░
тЩТ => тЩТ, ржЬрж▓, рж░рж╛рж╢рж┐ржЪржХрзНрж░
тЩУ => тЩУ, рж░рж╛рж╢рж┐ржЪржХрзНрж░
тЫО => тЫО, ржмрж╛рж╣ржХ, рж╕рж╛ржк, рж░рж╛рж╢рж┐ржЪржХрзНрж░
ЁЯФА => ЁЯФА, рждрзАрж░, ржЖржбрж╝рж╛ржЖржбрж╝рж┐ ржнрж╛ржмрзЗ ржЕржжрж▓ржмржжрж▓ ржХрж░рж╛
ЁЯФБ => ЁЯФБ, рждрзАрж░, ржШржбрж╝рж┐рж░ ржХрж╛ржБржЯрж╛рж░ ржжрж┐ржХрзЗ, ржкрзБржирж░рж╛ржмрзГрждрзНрждрж┐
ЁЯФВ => ЁЯФВ, рждрзАрж░, ржШржбрж╝рж┐рж░ ржХрж╛ржБржЯрж╛рж░ ржжрж┐ржХрзЗ, ржПржХржмрж╛рж░
тЦ╢ => тЦ╢, рждрзАрж░, ржЪрж╛рж▓рж╛ржирзЛ, ржбрж╛ржиржжрж┐ржХ, рждрзНрж░рж┐ржнрзБржЬ
тПй => тПй, рждрзАрж░, ржжрзНржмрж┐ржЧрзБржг, ржжрзНрж░рзБржд, ржЕржЧрзНрж░ржмрж░рзНрждрзА
тПн => тПн, рждрзАрж░, ржкрж░рзЗрж░ ржжрзГрж╢рзНржп, ржкрж░ржмрж░рзНрждрзА ржЯрзНрж░рзНржпрж╛ржХ, рждрзНрж░рж┐ржнрзБржЬ
тПп => тПп, рждрзАрж░, ржмрж┐рж░рждрж┐, ржЦрзЗрж▓рж╛, ржбрж╛ржи, рждрзНрж░рж┐ржнрзБржЬ
тЧА => тЧА, рждрзАрж░, ржмрж╛ржо, ржмрж┐ржкрж░рзАржд, рждрзНрж░рж┐ржнрзБржЬ
тПк => тПк, рждрзАрж░, ржжрзНржмрж┐ржЧрзБржг, ржкрж┐ржЫржирзЗ ржлрзЗрж░рж╛
тПо => тПо, рждрзАрж░, ржкрзВрж░рзНржмржмрж░рзНрждрзА ржжрзГрж╢рзНржп, ржкрзВрж░рзНржмржмрж░рзНрждрзА ржЯрзНрж░рзНржпрж╛ржХ, рждрзНрж░рж┐ржнрзБржЬ
ЁЯФ╝ => ЁЯФ╝, рждрзАрж░, ржмрзЛрждрж╛ржо, рж▓рж╛рж▓
тПл => тПл, рждрзАрж░, ржжрзНржмрж┐ржЧрзБржг
ЁЯФ╜ => ЁЯФ╜, рждрзАрж░, ржмрзЛрждрж╛ржо, ржирж┐ржЪрзЗ, рж▓рж╛рж▓
тПм => тПм, рждрзАрж░, ржжрзНржмрж┐ржЧрзБржг, ржирж┐ржЪрзЗ
тП╕ => тП╕, ржмрж╛рж░, ржжрзНржмрж┐ржЧрзБржг, ржмрж┐рж░рждрж┐, ржЙрж▓рзНрж▓ржорзНржм
тП╣ => тП╣, ржмрж░рзНржЧрж╛ржХрж╛рж░, ржмржирзНржз
тП║ => тП║, ржмрзГрждрзНржд, рж░рзЗржХрж░рзНржб
тПП => тПП, ржорзЛржЫрж╛
ЁЯОж => ЁЯОж, ржХрзНржпрж╛ржорзЗрж░рж╛, ржлрж┐рж▓рзНржо, ржорзБржнрж┐
ЁЯФЕ => ЁЯФЕ, ржЙржЬрзНржЬрзНржмрж▓рждрж╛, ржЕрж╕рзНржкрж╖рзНржЯ, ржХржо
ЁЯФЖ => ЁЯФЖ, ржЙржЬрзНржЬрзНржмрж▓, ржЙржЬрзНржЬрзНржмрж▓рждрж╛
ЁЯУ╢ => ЁЯУ╢, ржЕрзНржпрж╛ржирзНржЯрзЗржирж╛, ржмрж╛рж░, рж╕рзЗрж▓, ржорзЛржмрж╛ржЗрж▓, ржлрзЛржи, рж╕рж┐ржЧржирзНржпрж╛рж▓, ржЯрзЗрж▓рж┐ржлрзЛржи
ЁЯУ╡ => ЁЯУ╡, рж╕рзЗрж▓, ржирж┐рж╖рж┐ржжрзНржз, ржорзЛржмрж╛ржЗрж▓, ржирж╛, ржиржпрж╝, ржлрзЛржи, ржирж┐рж╖рж┐ржжрзНржз ржерж╛ржХрж╛, ржЯрзЗрж▓рж┐ржлрзЛржи
ЁЯУ│ => ЁЯУ│, рж╕рзЗрж▓, ржорзЛржмрж╛ржЗрж▓, ржорзЛржб, ржлрзЛржи, ржЯрзЗрж▓рж┐ржлрзЛржи, ржХржорзНржкржи
ЁЯУ┤ => ЁЯУ┤, рж╕рзЗрж▓, ржорзЛржмрж╛ржЗрж▓, ржмржирзНржз, ржлрзЛржи, ржЯрзЗрж▓рж┐ржлрзЛржи
#тГг => #тГг, рж╣рзНржпрж╛рж╢, ржХрзАржХрзНржпрж╛ржк, ржкрж╛ржЙржирзНржб
*тГг => *тГг, рждрж╛рж░ржХрж╛ржЪрж┐рж╣рзНржи, ржХрзАржХрзНржпрж╛ржк, рждрж╛рж░рж╛
ЁЯФЯ => ЁЯФЯ, 10, ржХрзАржХрзНржпрж╛ржк, ржжрж╢
ЁЯТп => ЁЯТп, 100, ржкрзВрж░рзНржг, рж╢ржд, рж╕рзНржХрзЛрж░
ЁЯФЮ => ЁЯФЮ, 18, ржмржпрж╝рж╕ рж╕рзАржорж╛, ржЖржарж╛рж░рзЛ, ржирж┐рж╖рж┐ржжрзНржз, ржирж╛, ржиржпрж╝, ржирж┐рж╖рж┐ржжрзНржз ржерж╛ржХрж╛, ржЕржкрж░рж┐ржгржд
ЁЯФа => ЁЯФа, ржЗржиржкрзБржЯ, рж▓рж╛рждрж┐ржи, ржЕржХрзНрж╖рж░, ржмржбрж╝ рж╣рж╛рждрзЗрж░ ржЕржХрзНрж╖рж░
ЁЯФб => ЁЯФб, ржП ржмрж┐ рж╕рж┐ ржбрж┐, ржЗржиржкрзБржЯ, рж▓рж╛рждрж┐ржи, ржЕржХрзНрж╖рж░, ржЫрзЛржЯ рж╣рж╛рждрзЗрж░ ржЕржХрзНрж╖рж░
ЁЯФв => ЁЯФв, 1234, ржЗржиржкрзБржЯ, рж╕ржВржЦрзНржпрж╛
ЁЯФг => ЁЯФг, ржЗржиржкрзБржЯ
ЁЯФд => ЁЯФд, ржПржмрж┐рж╕рж┐, ржмрж░рзНржгржорж╛рж▓рж╛, ржЗржиржкрзБржЯ, рж▓рж╛рждрж┐ржи, ржЕржХрзНрж╖рж░
ЁЯЕ░ => ЁЯЕ░, ржП, рж░ржХрзНржд
ЁЯЖО => ЁЯЖО, ржПржмрж┐, рж░ржХрзНржд
ЁЯЕ▒ => ЁЯЕ▒, ржмрж┐, рж░ржХрзНржд
ЁЯЖС => ЁЯЖС, рж╕рж┐ржПрж▓
ЁЯЖТ => ЁЯЖТ, ржХрзБрж▓
ЁЯЖУ => ЁЯЖУ, ржмрж┐ржирж╛ржорзВрж▓рзНржпрзЗ
тД╣ => тД╣, i ржЪрж┐рж╣рзНржи, рждржерзНржп
ЁЯЖФ => ЁЯЖФ, ржЖржЗржбрж┐, ржкрж░рж┐ржЪржпрж╝
тУВ => тУВ, ржмрзГрждрзНржд, ржПржо
ЁЯЖХ => ЁЯЖХ, ржирждрзБржи
ЁЯЖЦ => ЁЯЖЦ, ржПржиржЬрж┐ ржЪрж┐рж╣рзНржи
ЁЯЕ╛ => ЁЯЕ╛, рж░ржХрзНржд, ржЗржВрж░рж╛ржЬрзА тАШржУтАЩ ржЪрж┐рж╣рзНржи
ЁЯЖЧ => ЁЯЖЧ, ржарж┐ржХ ржЖржЫрзЗ
ЁЯЕ┐ => ЁЯЕ┐, ржкрж╛рж░рзНржХрж┐ржВ
ЁЯЖШ => ЁЯЖШ, рж╕рж╛рж╣рж╛ржпрзНржп, ржПрж╕ржУржПрж╕
ЁЯЖЩ => ЁЯЖЩ, ржЙржкрж░рзЗтАШ рж╢рзАрж░рзНрж╖ржХ ржЪрж┐рж╣рзНржи
ЁЯЖЪ => ЁЯЖЪ, ржмржирж╛ржо
ЁЯИБ => ЁЯИБ, ржЬрж╛ржкрж╛ржирж┐
ЁЯИВ => ЁЯИВ, ржЬрж╛ржкрж╛ржирж┐
ЁЯИ╖ => ЁЯИ╖, ржЬрж╛ржкрж╛ржирж┐
ЁЯИ╢ => ЁЯИ╢, ржЬрж╛ржкрж╛ржирж┐
ЁЯИп => ЁЯИп, ржЬрж╛ржкрж╛ржирж┐
ЁЯЙР => ЁЯЙР, ржЬрж╛ржкрж╛ржирж┐
ЁЯИ╣ => ЁЯИ╣, ржЬрж╛ржкрж╛ржирж┐
ЁЯИЪ => ЁЯИЪ, ржЬрж╛ржкрж╛ржирж┐
ЁЯИ▓ => ЁЯИ▓, ржЬрж╛ржкрж╛ржирж┐
ЁЯЙС => ЁЯЙС, ржЪрзАржирж╛
ЁЯИ╕ => ЁЯИ╕, ржЪрзАржирж╛
ЁЯИ┤ => ЁЯИ┤, ржЪрзАржирж╛
ЁЯИ│ => ЁЯИ│, ржЪрзАржирж╛
уКЧ => уКЧ, ржЪрзАржирж╛, рж╕ржВржмрж░рзНржзржирж╛, ржЕржнрж┐ржиржирзНржжржи, ржирж┐рж╢рж╛ржи
уКЩ => уКЩ, ржЪрзАржирж╛, ржирж┐рж╢рж╛ржи, ржЧрзЛржкржи
ЁЯИ║ => ЁЯИ║, ржЪрзАржирж╛
ЁЯИ╡ => ЁЯИ╡, ржЪрзАржирж╛
тЦк => тЦк, ржЬрзНржпрж╛ржорж┐рждрж┐ржХ, ржмрж░рзНржЧрж╛ржХрж╛рж░
тЦл => тЦл, ржЬрзНржпрж╛ржорж┐рждрж┐ржХ, ржмрж░рзНржЧрж╛ржХрж╛рж░
тЧ╗ => тЧ╗, ржЬрзНржпрж╛ржорж┐рждрж┐ржХ, ржмрж░рзНржЧрж╛ржХрж╛рж░
тЧ╝ => тЧ╝, ржЬрзНржпрж╛ржорж┐рждрж┐ржХ, ржмрж░рзНржЧрж╛ржХрж╛рж░
тЧ╜ => тЧ╜, ржЬрзНржпрж╛ржорж┐рждрж┐ржХ, ржмрж░рзНржЧрж╛ржХрж╛рж░
тЧ╛ => тЧ╛, ржЬрзНржпрж╛ржорж┐рждрж┐ржХ, ржмрж░рзНржЧрж╛ржХрж╛рж░
тмЫ => тмЫ, ржЬрзНржпрж╛ржорж┐рждрж┐ржХ, ржмрж░рзНржЧрж╛ржХрж╛рж░
тмЬ => тмЬ, ржЬрзНржпрж╛ржорж┐рждрж┐ржХ, ржмрж░рзНржЧрж╛ржХрж╛рж░
ЁЯФ╢ => ЁЯФ╢, ржбрж╛ржпрж╝ржоржирзНржб, ржЬрзНржпрж╛ржорж┐рждрж┐ржХ, ржХржорж▓рж╛
ЁЯФ╖ => ЁЯФ╖, ржирзАрж▓, ржбрж╛ржпрж╝ржоржирзНржб, ржЬрзНржпрж╛ржорж┐рждрж┐ржХ
ЁЯФ╕ => ЁЯФ╕, ржбрж╛ржпрж╝ржоржирзНржб, ржЬрзНржпрж╛ржорж┐рждрж┐ржХ, ржХржорж▓рж╛
ЁЯФ╣ => ЁЯФ╣, ржирзАрж▓, ржбрж╛ржпрж╝ржоржирзНржб, ржЬрзНржпрж╛ржорж┐рждрж┐ржХ
ЁЯФ║ => ЁЯФ║, ржЬрзНржпрж╛ржорж┐рждрж┐ржХ, рж▓рж╛рж▓
ЁЯФ╗ => ЁЯФ╗, ржирж┐ржорзНржиржорзБржЦрзА, ржЬрзНржпрж╛ржорж┐рждрж┐ржХ, рж▓рж╛рж▓
ЁЯТа => ЁЯТа, ржХржорж┐ржХ, ржбрж╛ржпрж╝ржоржирзНржб, ржЬрзНржпрж╛ржорж┐рждрж┐ржХ, ржнрж┐рждрж░рзЗ
ЁЯФШ => ЁЯФШ, ржмрзЛрждрж╛ржо, ржЬрзНржпрж╛ржорж┐рждрж┐ржХ, рж░рзЗржбрж┐ржУ
ЁЯФ▓ => ЁЯФ▓, ржмрзЛрждрж╛ржо, ржЬрзНржпрж╛ржорж┐рждрж┐ржХ, ржмрж░рзНржЧрж╛ржХрж╛рж░
ЁЯФ│ => ЁЯФ│, ржмрзЛрждрж╛ржо, ржЬрзНржпрж╛ржорж┐рждрж┐ржХ, рж░рзВржкрж░рзЗржЦрж╛, ржмрж░рзНржЧрж╛ржХрж╛рж░
тЪк => тЪк, ржмрзГрждрзНржд, ржЬрзНржпрж╛ржорж┐рждрж┐ржХ
тЪл => тЪл, ржмрзГрждрзНржд, ржЬрзНржпрж╛ржорж┐рждрж┐ржХ
ЁЯФ┤ => ЁЯФ┤, ржмрзГрждрзНржд, ржЬрзНржпрж╛ржорж┐рждрж┐ржХ, рж▓рж╛рж▓
ЁЯФ╡ => ЁЯФ╡, ржирзАрж▓, ржмрзГрждрзНржд, ржЬрзНржпрж╛ржорж┐рждрж┐ржХ
ЁЯЫС => ЁЯЫС, ржЕрж╖рзНржЯржХрзЛржгрзА, ржЪрж┐рж╣рзНржи, ржерж╛ржорзБржи
ЁЯЫТ => ЁЯЫТ, рж╢ржкрж┐ржВ, ржХрж╛рж░рзНржЯ, ржЯрзНрж░рж▓рж┐, рж╢ржкрж┐ржВ
ЁЯЫ┤ => ЁЯЫ┤, рж╕рзНржХрзБржЯрж╛рж░, ржХрж┐ржХ
ЁЯЫ╡ => ЁЯЫ╡, ржоржЯрж░, рж╕рзНржХрзБржЯрж╛рж░
ЁЯЫ╢ => ЁЯЫ╢, ржбрзЛржЩрзНржЧрж╛, ржирзМржХрж╛
0тГг => 0тГг, ржХрзАржХрзНржпрж╛ржк, рж╢рзВржирзНржп
1тГг => 1тГг, 1, ржХрзАржХрзНржпрж╛ржк, ржПржХ
2тГг => 2тГг, 2, ржХрзАржХрзНржпрж╛ржк, ржжрзБржЗ
3тГг => 3тГг, 3, ржХрзАржХрзНржпрж╛ржк, рждрж┐ржи
4тГг => 4тГг, 4, ржЪрж╛рж░, ржХрзАржХрзНржпрж╛ржк
5тГг => 5тГг, 5, ржкрж╛ржБржЪ, ржХрзАржХрзНржпрж╛ржк
6тГг => 6тГг, 6, ржХрзАржХрзНржпрж╛ржк, ржЫржпрж╝
7тГг => 7тГг, 7, ржХрзАржХрзНржпрж╛ржк, рж╕рж╛ржд
8тГг => 8тГг, 8, ржЖржЯ, ржХрзАржХрзНржпрж╛ржк
9тГг => 9тГг, 9, ржХрзАржХрзНржпрж╛ржк, ржиржпрж╝
ЁЯЗжЁЯЗи => ЁЯЗжЁЯЗи, ржЕрзНржпрж╛рж╕рж╕рзЗржирж╢ржи ржЖржЗрж▓рзНржпрж╛ржирзНржб
ЁЯЗжЁЯЗй => ЁЯЗжЁЯЗй, ржЖржирзНржбрзЛрж░рж╛
ЁЯЗжЁЯЗк => ЁЯЗжЁЯЗк, рж╕ржВржпрзБржХрзНржд ржЖрж░ржм ржЖржорж┐рж░рж╛ржд
ЁЯЗжЁЯЗл => ЁЯЗжЁЯЗл, ржЖржлржЧрж╛ржирж┐рж╕рзНрждрж╛ржи
ЁЯЗжЁЯЗм => ЁЯЗжЁЯЗм, ржПржирзНржЯрж┐ржЧрзБржпрж╝рж╛ ржУ ржмрж╛рж░ржмрзБржбрж╛
ЁЯЗжЁЯЗо => ЁЯЗжЁЯЗо, ржПрзНржпрж╛ржЩрзНржЧрзБржЗрж▓рж╛
ЁЯЗжЁЯЗ▒ => ЁЯЗжЁЯЗ▒, ржЖрж▓ржмрзЗржирж┐ржпрж╝рж╛
ЁЯЗжЁЯЗ▓ => ЁЯЗжЁЯЗ▓, ржЖрж░рзНржорзЗржирж┐ржпрж╝рж╛
ЁЯЗжЁЯЗ┤ => ЁЯЗжЁЯЗ┤, ржЕрзНржпрж╛ржЩрзНржЧрзЛрж▓рж╛
ЁЯЗжЁЯЗ╢ => ЁЯЗжЁЯЗ╢, ржЕрзНржпрж╛ржирзНржЯрж╛рж░рзНржХржЯрж┐ржХрж╛
ЁЯЗжЁЯЗ╖ => ЁЯЗжЁЯЗ╖, ржЖрж░рзНржЬрзЗржирзНржЯрж┐ржирж╛
ЁЯЗжЁЯЗ╕ => ЁЯЗжЁЯЗ╕, ржЖржорзЗрж░рж┐ржХрж╛ржи рж╕рж╛ржорзЛржпрж╝рж╛
ЁЯЗжЁЯЗ╣ => ЁЯЗжЁЯЗ╣, ржЕрж╕рзНржЯрзНрж░рж┐ржпрж╝рж╛
ЁЯЗжЁЯЗ║ => ЁЯЗжЁЯЗ║, ржЕрж╕рзНржЯрзНрж░рзЗрж▓рж┐ржпрж╝рж╛
ЁЯЗжЁЯЗ╝ => ЁЯЗжЁЯЗ╝, ржЖрж░рзБржмрж╛
ЁЯЗжЁЯЗ╜ => ЁЯЗжЁЯЗ╜, ржЖрж▓рж╛ржирзНржб ржжрзНржмрзАржкржкрзБржЮрзНржЬ
ЁЯЗжЁЯЗ┐ => ЁЯЗжЁЯЗ┐, ржЖржЬрж╛рж░ржмрж╛ржЗржЬрж╛ржи
ЁЯЗзЁЯЗж => ЁЯЗзЁЯЗж, ржмрж╕ржирж┐ржпрж╝рж╛ ржУ рж╣рж╛рж░рзНржЬрзЗржЧрзЛржнрж┐ржирж╛
ЁЯЗзЁЯЗз => ЁЯЗзЁЯЗз, ржмрж╛рж░ржмрж╛ржжрзЛрж╕
ЁЯЗзЁЯЗй => ЁЯЗзЁЯЗй, ржмрж╛ржВрж▓рж╛ржжрзЗрж╢
ЁЯЗзЁЯЗк => ЁЯЗзЁЯЗк, ржмрзЗрж▓ржЬрж┐ржпрж╝рж╛ржо
ЁЯЗзЁЯЗл => ЁЯЗзЁЯЗл, ржмрзБрж░ржХрж┐ржирж╛ ржлрж╛рж╕рзЛ
ЁЯЗзЁЯЗм => ЁЯЗзЁЯЗм, ржмрзБрж▓ржЧрзЗрж░рж┐ржпрж╝рж╛
ЁЯЗзЁЯЗн => ЁЯЗзЁЯЗн, ржмрж╛рж╣рж░рж╛ржЗржи
ЁЯЗзЁЯЗо => ЁЯЗзЁЯЗо, ржмрзБрж░рзБржирзНржбрж┐
ЁЯЗзЁЯЗп => ЁЯЗзЁЯЗп, ржмрзЗржирж┐ржи
ЁЯЗзЁЯЗ▒ => ЁЯЗзЁЯЗ▒, рж╕рзЗржирзНржЯ ржмрж╛рж░ржерзЗрж▓рж┐ржорж┐
ЁЯЗзЁЯЗ▓ => ЁЯЗзЁЯЗ▓, ржмрж╛рж░ржорзБржбрж╛
ЁЯЗзЁЯЗ│ => ЁЯЗзЁЯЗ│, ржмрзНрж░рзБржирзЗржЗ
ЁЯЗзЁЯЗ┤ => ЁЯЗзЁЯЗ┤, ржмрж▓рж┐ржнрж┐ржпрж╝рж╛
ЁЯЗзЁЯЗ╢ => ЁЯЗзЁЯЗ╢, ржХрзНржпрж╛рж░рж┐ржмрж┐ржпрж╝рж╛ржи ржирзЗржжрж╛рж░рж▓рзНржпрж╛ржирзНржбрж╕
ЁЯЗзЁЯЗ╖ => ЁЯЗзЁЯЗ╖, ржмрзНрж░рж╛ржЬрж┐рж▓
ЁЯЗзЁЯЗ╕ => ЁЯЗзЁЯЗ╕, ржмрж╛рж╣рж╛ржорж╛ ржжрзНржмрзАржкржкрзБржЮрзНржЬ
ЁЯЗзЁЯЗ╣ => ЁЯЗзЁЯЗ╣, ржнрзБржЯрж╛ржи
ЁЯЗзЁЯЗ╗ => ЁЯЗзЁЯЗ╗, ржмрзЛржнрзЗржЯ ржжрзНржмрзАржк
ЁЯЗзЁЯЗ╝ => ЁЯЗзЁЯЗ╝, ржмрждрж╕рзЛржпрж╝рж╛ржирж╛
ЁЯЗзЁЯЗ╛ => ЁЯЗзЁЯЗ╛, ржмрзЗрж▓рж╛рж░рзБрж╢
ЁЯЗзЁЯЗ┐ => ЁЯЗзЁЯЗ┐, ржмрзЗрж▓рж┐ржЬ
ЁЯЗиЁЯЗж => ЁЯЗиЁЯЗж, ржХрж╛ржирж╛ржбрж╛
ЁЯЗиЁЯЗи => ЁЯЗиЁЯЗи, ржХрзЛржХрзЛрж╕ (ржХрж┐рж▓рж┐ржВ) ржжрзНржмрзАржкржкрзБржЮрзНржЬ
ЁЯЗиЁЯЗй => ЁЯЗиЁЯЗй, ржХржЩрзНржЧрзЛ-ржХрж┐ржирж╢рж╛рж╕рж╛
ЁЯЗиЁЯЗл => ЁЯЗиЁЯЗл, ржоржзрзНржп ржЖржлрзНрж░рж┐ржХрж╛рж░ ржкрзНрж░ржЬрж╛рждржирзНрждрзНрж░
ЁЯЗиЁЯЗм => ЁЯЗиЁЯЗм, ржХржЩрзНржЧрзЛ - ржмрзНрж░рж╛ржЬрж╛ржнрж┐рж▓
ЁЯЗиЁЯЗн => ЁЯЗиЁЯЗн, рж╕рзБржЗржЬрж╛рж░рж▓рзНржпрж╛ржирзНржб
ЁЯЗиЁЯЗо => ЁЯЗиЁЯЗо, ржЖржЗржнрж░рж┐ ржХрзЛрж╕рзНржЯ
ЁЯЗиЁЯЗ░ => ЁЯЗиЁЯЗ░, ржХрзБржХ ржжрзНржмрзАржкржкрзБржЮрзНржЬ
ЁЯЗиЁЯЗ▒ => ЁЯЗиЁЯЗ▒, ржЪрж┐рж▓рж┐
ЁЯЗиЁЯЗ▓ => ЁЯЗиЁЯЗ▓, ржХрзНржпрж╛ржорзЗрж░рзБржи
ЁЯЗиЁЯЗ│ => ЁЯЗиЁЯЗ│, ржЪрзАржи
ЁЯЗиЁЯЗ┤ => ЁЯЗиЁЯЗ┤, ржХрж▓ржорзНржмрж┐ржпрж╝рж╛
ЁЯЗиЁЯЗ╡ => ЁЯЗиЁЯЗ╡, ржХрзНрж▓рж┐ржкрж╛рж░ржЯржи ржЖржЗрж▓рзНржпрж╛ржирзНржб
ЁЯЗиЁЯЗ╖ => ЁЯЗиЁЯЗ╖, ржХрзЛрж╕рзНржЯрж╛рж░рж┐ржХрж╛
ЁЯЗиЁЯЗ║ => ЁЯЗиЁЯЗ║, ржХрж┐ржЙржмрж╛
ЁЯЗиЁЯЗ╗ => ЁЯЗиЁЯЗ╗, ржХрзЗржкржнрж╛рж░рзНржжрзЗ
ЁЯЗиЁЯЗ╝ => ЁЯЗиЁЯЗ╝, ржХрж┐ржЙрж░рж╛рж╕рж╛ржУ
ЁЯЗиЁЯЗ╜ => ЁЯЗиЁЯЗ╜, ржХрзНрж░рж┐рж╕ржорж╛рж╕ ржжрзНржмрзАржк
ЁЯЗиЁЯЗ╛ => ЁЯЗиЁЯЗ╛, рж╕рж╛ржЗржкрзНрж░рж╛рж╕
ЁЯЗиЁЯЗ┐ => ЁЯЗиЁЯЗ┐, ржЪрзЗржХ ржкрзНрж░ржЬрж╛рждржирзНрждрзНрж░
ЁЯЗйЁЯЗк => ЁЯЗйЁЯЗк, ржЬрж╛рж░рзНржорж╛ржирж┐
ЁЯЗйЁЯЗм => ЁЯЗйЁЯЗм, ржжрж┐ржпрж╝рзЗржЧрзЛ ржЧрж╛рж░рзНрж╕рж┐ржпрж╝рж╛
ЁЯЗйЁЯЗп => ЁЯЗйЁЯЗп, ржЬрж┐ржмрзБрждрж┐
ЁЯЗйЁЯЗ░ => ЁЯЗйЁЯЗ░, ржбрзЗржиржорж╛рж░рзНржХ
ЁЯЗйЁЯЗ▓ => ЁЯЗйЁЯЗ▓, ржбрзЛржорж┐ржирж┐ржХрж╛
ЁЯЗйЁЯЗ┤ => ЁЯЗйЁЯЗ┤, ржбрзЛржорзЗржирж┐ржХрж╛ржи ржкрзНрж░ржЬрж╛рждржирзНрждрзНрж░
ЁЯЗйЁЯЗ┐ => ЁЯЗйЁЯЗ┐, ржЖрж▓ржЬрзЗрж░рж┐ржпрж╝рж╛
ЁЯЗкЁЯЗж => ЁЯЗкЁЯЗж, ржХрзБржЙржЯрж╛ ржПржмржВ ржорзЗрж▓рж┐рж▓рж╛
ЁЯЗкЁЯЗи => ЁЯЗкЁЯЗи, ржЗржХрзБржпрж╝рзЗржбрж░
ЁЯЗкЁЯЗк => ЁЯЗкЁЯЗк, ржПрж╕рзНрждрзЛржирж┐ржпрж╝рж╛
ЁЯЗкЁЯЗм => ЁЯЗкЁЯЗм, ржорж┐рж╢рж░
ЁЯЗкЁЯЗн => ЁЯЗкЁЯЗн, ржкрж╢рзНржЪрж┐ржо рж╕рж╛рж╣рж╛рж░рж╛
ЁЯЗкЁЯЗ╖ => ЁЯЗкЁЯЗ╖, ржЗрж░рж┐рждрзНрж░рж┐ржпрж╝рж╛
ЁЯЗкЁЯЗ╕ => ЁЯЗкЁЯЗ╕, рж╕рзНржкрзЗржи
ЁЯЗкЁЯЗ╣ => ЁЯЗкЁЯЗ╣, ржЗржлрж┐ржУржкрж┐ржпрж╝рж╛
ЁЯЗкЁЯЗ║ => ЁЯЗкЁЯЗ║, ржЗржЙрж░рзЛржкрзАржпрж╝ ржЗржЙржирж┐ржпрж╝ржи
ЁЯЗлЁЯЗо => ЁЯЗлЁЯЗо, ржлрж┐ржирж▓рзНржпрж╛ржирзНржб
ЁЯЗлЁЯЗп => ЁЯЗлЁЯЗп, ржлрж┐ржЬрж┐
ЁЯЗлЁЯЗ░ => ЁЯЗлЁЯЗ░, ржлржХрж▓рзНржпрж╛ржирзНржб ржжрзНржмрзАржкржкрзБржЮрзНржЬ
ЁЯЗлЁЯЗ▓ => ЁЯЗлЁЯЗ▓, ржорж╛ржЗржХрзНрж░рзЛржирзЗрж╢рж┐ржпрж╝рж╛
ЁЯЗлЁЯЗ┤ => ЁЯЗлЁЯЗ┤, ржлрзНржпрж╛рж░ржУ ржжрзНржмрзАржкржкрзБржЮрзНржЬ
ЁЯЗлЁЯЗ╖ => ЁЯЗлЁЯЗ╖, ржлрзНрж░рж╛ржирзНрж╕
ЁЯЗмЁЯЗж => ЁЯЗмЁЯЗж, ржЧрзНржпрж╛ржмржи
ЁЯЗмЁЯЗз => ЁЯЗмЁЯЗз, ржпрзБржХрзНрждрж░рж╛ржЬрзНржп
ЁЯЗмЁЯЗй => ЁЯЗмЁЯЗй, ржЧрзНрж░рзЗржирж╛ржбрж╛
ЁЯЗмЁЯЗк => ЁЯЗмЁЯЗк, ржЬрж░рзНржЬрж┐ржпрж╝рж╛
ЁЯЗмЁЯЗл => ЁЯЗмЁЯЗл, ржлрж░рж╛рж╕рзА ржЧрж╛ржпрж╝рж╛ржирж╛
ЁЯЗмЁЯЗм => ЁЯЗмЁЯЗм, ржЧрзНрж░рж╛ржЮрзНржЬрж┐
ЁЯЗмЁЯЗн => ЁЯЗмЁЯЗн, ржШрж╛ржирж╛
ЁЯЗмЁЯЗо => ЁЯЗмЁЯЗо, ржЬрж┐ржмрзНрж░рж╛рж▓рзНржЯрж╛рж░
ЁЯЗмЁЯЗ▒ => ЁЯЗмЁЯЗ▒, ржЧрзНрж░рзАржирж▓рзНржпрж╛ржирзНржб
ЁЯЗмЁЯЗ▓ => ЁЯЗмЁЯЗ▓, ржЧрж╛ржорзНржмрж┐ржпрж╝рж╛
ЁЯЗмЁЯЗ│ => ЁЯЗмЁЯЗ│, ржЧрж┐ржирж┐
ЁЯЗмЁЯЗ╡ => ЁЯЗмЁЯЗ╡, ржЧрзБржпрж╝рж╛ржжрзЗрж▓рзМржк
ЁЯЗмЁЯЗ╢ => ЁЯЗмЁЯЗ╢, ржирж┐рж░ржХрзНрж╖рзАржпрж╝ ржЧрж┐ржирж┐
ЁЯЗмЁЯЗ╖ => ЁЯЗмЁЯЗ╖, ржЧрзНрж░рзАрж╕
ЁЯЗмЁЯЗ╕ => ЁЯЗмЁЯЗ╕, ржжржХрзНрж╖рж┐ржг ржЬрж░рзНржЬрж┐ржпрж╝рж╛ ржУ ржжржХрзНрж╖рж┐ржг рж╕рзНржпрж╛ржирзНржбржЙржЗржЪ ржжрзНржмрзАржкржкрзБржЮрзНржЬ
ЁЯЗмЁЯЗ╣ => ЁЯЗмЁЯЗ╣, ржЧрзБржпрж╝рж╛рждрзЗржорж╛рж▓рж╛
ЁЯЗмЁЯЗ║ => ЁЯЗмЁЯЗ║, ржЧрзБржпрж╝рж╛ржо
ЁЯЗмЁЯЗ╝ => ЁЯЗмЁЯЗ╝, ржЧрж┐ржирж┐-ржмрж┐рж╕рж╛ржЙ
ЁЯЗмЁЯЗ╛ => ЁЯЗмЁЯЗ╛, ржЧрж┐ржпрж╝рж╛ржирж╛
ЁЯЗнЁЯЗ░ => ЁЯЗнЁЯЗ░, рж╣ржВржХржВ ржПрж╕ржПржЖрж░ ржЪрзАржирж╛
ЁЯЗнЁЯЗ▓ => ЁЯЗнЁЯЗ▓, рж╣рж╛рж░рзНржб ржжрзНржмрзАржк ржПржмржВ ржорзНржпрж╛ржХржбрзЛржирж╛рж▓рзНржб ржжрзНржмрзАржкржкрзБржЮрзНржЬ
ЁЯЗнЁЯЗ│ => ЁЯЗнЁЯЗ│, рж╣ржгрзНржбрзБрж░рж╛рж╕
ЁЯЗнЁЯЗ╖ => ЁЯЗнЁЯЗ╖, ржХрзНрж░рзЛржпрж╝рзЗрж╢рж┐ржпрж╝рж╛
ЁЯЗнЁЯЗ╣ => ЁЯЗнЁЯЗ╣, рж╣рж╛ржЗрждрж┐
ЁЯЗнЁЯЗ║ => ЁЯЗнЁЯЗ║, рж╣рж╛ржЩрзНржЧрзЗрж░рж┐
ЁЯЗоЁЯЗи => ЁЯЗоЁЯЗи, ржХрзНржпрж╛ржирж╛рж░рж┐ ржжрзНржмрзАржкржкрзБржЮрзНржЬ
ЁЯЗоЁЯЗй => ЁЯЗоЁЯЗй, ржЗржирзНржжрзЛржирзЗрж╢рж┐ржпрж╝рж╛
ЁЯЗоЁЯЗк => ЁЯЗоЁЯЗк, ржЖржпрж╝рж╛рж░рж▓рзНржпрж╛ржирзНржб
ЁЯЗоЁЯЗ▒ => ЁЯЗоЁЯЗ▒, ржЗржЬрж░рж╛ржпрж╝рзЗрж▓
ЁЯЗоЁЯЗ▓ => ЁЯЗоЁЯЗ▓, ржЖржЗрж▓ ржЕржл ржорзНржпрж╛ржи
ЁЯЗоЁЯЗ│ => ЁЯЗоЁЯЗ│, ржнрж╛рж░ржд
ЁЯЗоЁЯЗ┤ => ЁЯЗоЁЯЗ┤, ржмрзНрж░рж┐ржЯрж┐рж╢ ржнрж╛рж░ржд ржорж╣рж╛рж╕рж╛ржЧрж░рзАржпрж╝ ржЕржЮрзНржЪрж▓
ЁЯЗоЁЯЗ╢ => ЁЯЗоЁЯЗ╢, ржЗрж░рж╛ржХ
ЁЯЗоЁЯЗ╖ => ЁЯЗоЁЯЗ╖, ржЗрж░рж╛ржи
ЁЯЗоЁЯЗ╕ => ЁЯЗоЁЯЗ╕, ржЖржЗрж╕рж▓рзНржпрж╛ржирзНржб
ЁЯЗоЁЯЗ╣ => ЁЯЗоЁЯЗ╣, ржЗрждрж╛рж▓рж┐
ЁЯЗпЁЯЗк => ЁЯЗпЁЯЗк, ржЬрж╛рж░рзНрж╕рж┐
ЁЯЗпЁЯЗ▓ => ЁЯЗпЁЯЗ▓, ржЬрж╛ржорж╛ржЗржХрж╛
ЁЯЗпЁЯЗ┤ => ЁЯЗпЁЯЗ┤, ржЬрж░рзНржбржи
ЁЯЗпЁЯЗ╡ => ЁЯЗпЁЯЗ╡, ржЬрж╛ржкрж╛ржи
ЁЯЗ░ЁЯЗк => ЁЯЗ░ЁЯЗк, ржХрзЗржирж┐ржпрж╝рж╛
ЁЯЗ░ЁЯЗм => ЁЯЗ░ЁЯЗм, ржХрж┐рж░ржЧрж┐ржЬрж┐рж╕рзНрждрж╛ржи
ЁЯЗ░ЁЯЗн => ЁЯЗ░ЁЯЗн, ржХржорзНржмрзЛржбрж┐ржпрж╝рж╛
ЁЯЗ░ЁЯЗо => ЁЯЗ░ЁЯЗо, ржХрж┐рж░рж┐ржмрж╛рждрж┐
ЁЯЗ░ЁЯЗ▓ => ЁЯЗ░ЁЯЗ▓, ржХржорзЛрж░рзЛрж╕
ЁЯЗ░ЁЯЗ│ => ЁЯЗ░ЁЯЗ│, рж╕рзЗржирзНржЯ ржХрж┐ржЯрж╕ ржУ ржирзЗржнрж┐рж╕
ЁЯЗ░ЁЯЗ╡ => ЁЯЗ░ЁЯЗ╡, ржЙрждрзНрждрж░ ржХрзЛрж░рж┐ржпрж╝рж╛
ЁЯЗ░ЁЯЗ╖ => ЁЯЗ░ЁЯЗ╖, ржжржХрзНрж╖рж┐ржг ржХрзЛрж░рж┐ржпрж╝рж╛
ЁЯЗ░ЁЯЗ╝ => ЁЯЗ░ЁЯЗ╝, ржХрзБржпрж╝рзЗржд
ЁЯЗ░ЁЯЗ╛ => ЁЯЗ░ЁЯЗ╛, ржХрзЗржорзНржпрж╛ржи ржжрзНржмрзАржкржкрзБржЮрзНржЬ
ЁЯЗ░ЁЯЗ┐ => ЁЯЗ░ЁЯЗ┐, ржХрж╛ржЬрж╛ржЦрж╕рзНрждрж╛ржи
ЁЯЗ▒ЁЯЗж => ЁЯЗ▒ЁЯЗж, рж▓рж╛ржУрж╕
ЁЯЗ▒ЁЯЗз => ЁЯЗ▒ЁЯЗз, рж▓рзЗржмрж╛ржиржи
ЁЯЗ▒ЁЯЗи => ЁЯЗ▒ЁЯЗи, рж╕рзЗржирзНржЯ рж▓рзБрж╕рж┐ржпрж╝рж╛
ЁЯЗ▒ЁЯЗо => ЁЯЗ▒ЁЯЗо, рж▓рж┐ржЪрзЗржирж╕рзНржЯрзЗржЗржи
ЁЯЗ▒ЁЯЗ░ => ЁЯЗ▒ЁЯЗ░, рж╢рзНрж░рзАрж▓ржЩрзНржХрж╛
ЁЯЗ▒ЁЯЗ╖ => ЁЯЗ▒ЁЯЗ╖, рж▓рж╛ржЗржмрзЗрж░рж┐ржпрж╝рж╛
ЁЯЗ▒ЁЯЗ╕ => ЁЯЗ▒ЁЯЗ╕, рж▓рзЗрж╕рзЛржерзЛ
ЁЯЗ▒ЁЯЗ╣ => ЁЯЗ▒ЁЯЗ╣, рж▓рж┐ржерзБржпрж╝рж╛ржирж┐ржпрж╝рж╛
ЁЯЗ▒ЁЯЗ║ => ЁЯЗ▒ЁЯЗ║, рж▓рж╛ржХрзНрж╕рзЗржоржмрж╛рж░рзНржЧ
ЁЯЗ▒ЁЯЗ╗ => ЁЯЗ▒ЁЯЗ╗, рж▓рж╛рждрзНржнрж┐ржпрж╝рж╛
ЁЯЗ▒ЁЯЗ╛ => ЁЯЗ▒ЁЯЗ╛, рж▓рж┐ржмрж┐ржпрж╝рж╛
ЁЯЗ▓ЁЯЗж => ЁЯЗ▓ЁЯЗж, ржорзЛрж░ржХрзНржХрзЛ
ЁЯЗ▓ЁЯЗи => ЁЯЗ▓ЁЯЗи, ржорзЛржирж╛ржХрзЛ
ЁЯЗ▓ЁЯЗй => ЁЯЗ▓ЁЯЗй, ржорзЛрж▓рзНржжрж╛ржнрж┐ржпрж╝рж╛
ЁЯЗ▓ЁЯЗк => ЁЯЗ▓ЁЯЗк, ржоржирзНржЯрж┐ржирж┐ржЧрзНрж░рзЛ
ЁЯЗ▓ЁЯЗл => ЁЯЗ▓ЁЯЗл, рж╕рзЗржирзНржЯ ржорж╛рж░рзНржЯрж┐ржи
ЁЯЗ▓ЁЯЗм => ЁЯЗ▓ЁЯЗм, ржорж╛ржжрж╛ржЧрж╛рж╕рзНржХрж╛рж░
ЁЯЗ▓ЁЯЗн => ЁЯЗ▓ЁЯЗн, ржорж╛рж░рзНрж╢рж╛рж▓ ржжрзНржмрзАржкржкрзБржЮрзНржЬ
ЁЯЗ▓ЁЯЗ░ => ЁЯЗ▓ЁЯЗ░, ржорзНржпрж╛рж╕рж╛ржбрзЛржирж┐ржпрж╝рж╛
ЁЯЗ▓ЁЯЗ▒ => ЁЯЗ▓ЁЯЗ▒, ржорж╛рж▓рж┐
ЁЯЗ▓ЁЯЗ▓ => ЁЯЗ▓ЁЯЗ▓, ржорж╛ржпрж╝рж╛ржиржорж╛рж░ (ржмрж╛рж░рзНржорж╛)
ЁЯЗ▓ЁЯЗ│ => ЁЯЗ▓ЁЯЗ│, ржоржЩрзНржЧрзЛрж▓рж┐ржпрж╝рж╛
ЁЯЗ▓ЁЯЗ┤ => ЁЯЗ▓ЁЯЗ┤, ржорзНржпрж╛ржХрж╛ржУ ржПрж╕ржПржЖрж░ ржЪрзАржирж╛
ЁЯЗ▓ЁЯЗ╡ => ЁЯЗ▓ЁЯЗ╡, ржЙрждрзНрждрж░рж╛ржЮрзНржЪрж▓рзАржпрж╝ ржорж╛рж░рж┐ржпрж╝рж╛ржирж╛ ржжрзНржмрзАржкржкрзБржЮрзНржЬ
ЁЯЗ▓ЁЯЗ╢ => ЁЯЗ▓ЁЯЗ╢, ржорж╛рж░рзНржЯрж┐ржирж┐ржХ
ЁЯЗ▓ЁЯЗ╖ => ЁЯЗ▓ЁЯЗ╖, ржорж░рж┐рждрж╛ржирж┐ржпрж╝рж╛
ЁЯЗ▓ЁЯЗ╕ => ЁЯЗ▓ЁЯЗ╕, ржоржирзНржЯрж╕рзЗрж░рж╛ржЯ
ЁЯЗ▓ЁЯЗ╣ => ЁЯЗ▓ЁЯЗ╣, ржорж╛рж▓рзНржЯрж╛
ЁЯЗ▓ЁЯЗ║ => ЁЯЗ▓ЁЯЗ║, ржорж░рж┐рж╢рж╛рж╕
ЁЯЗ▓ЁЯЗ╗ => ЁЯЗ▓ЁЯЗ╗, ржорж╛рж▓ржжрзНржмрзАржк
ЁЯЗ▓ЁЯЗ╝ => ЁЯЗ▓ЁЯЗ╝, ржорж╛рж▓рж╛ржЙржЗ
ЁЯЗ▓ЁЯЗ╜ => ЁЯЗ▓ЁЯЗ╜, ржорзЗржХрзНрж╕рж┐ржХрзЛ
ЁЯЗ▓ЁЯЗ╛ => ЁЯЗ▓ЁЯЗ╛, ржорж╛рж▓ржпрж╝рзЗрж╢рж┐ржпрж╝рж╛
ЁЯЗ▓ЁЯЗ┐ => ЁЯЗ▓ЁЯЗ┐, ржорзЛржЬрж╛ржорзНржмрж┐ржХ
ЁЯЗ│ЁЯЗж => ЁЯЗ│ЁЯЗж, ржирж╛ржорж┐ржмрж┐ржпрж╝рж╛
ЁЯЗ│ЁЯЗи => ЁЯЗ│ЁЯЗи, ржирж┐ржЙ ржХрзНржпрж╛рж▓рзЗржбрзЛржирж┐ржпрж╝рж╛
ЁЯЗ│ЁЯЗк => ЁЯЗ│ЁЯЗк, ржирж╛ржЗржЬрж╛рж░
ЁЯЗ│ЁЯЗл => ЁЯЗ│ЁЯЗл, ржирж┐рж░ржлрзЛржХ ржжрзНржмрзАржк
ЁЯЗ│ЁЯЗм => ЁЯЗ│ЁЯЗм, ржирж╛ржЗржЬрзЗрж░рж┐ржпрж╝рж╛
ЁЯЗ│ЁЯЗо => ЁЯЗ│ЁЯЗо, ржирж┐ржХрж╛рж░рж╛ржЧрзБржпрж╝рж╛
ЁЯЗ│ЁЯЗ▒ => ЁЯЗ│ЁЯЗ▒, ржирзЗржжрж╛рж░рж▓рзНржпрж╛ржирзНржбрж╕
ЁЯЗ│ЁЯЗ┤ => ЁЯЗ│ЁЯЗ┤, ржирж░ржУржпрж╝рзЗ
ЁЯЗ│ЁЯЗ╡ => ЁЯЗ│ЁЯЗ╡, ржирзЗржкрж╛рж▓
ЁЯЗ│ЁЯЗ╖ => ЁЯЗ│ЁЯЗ╖, ржирж╛ржЙрж░рзБ
ЁЯЗ│ЁЯЗ║ => ЁЯЗ│ЁЯЗ║, ржирж┐ржЙржпрж╝рзЗ
ЁЯЗ│ЁЯЗ┐ => ЁЯЗ│ЁЯЗ┐, ржирж┐ржЙржЬрж┐рж▓рзНржпрж╛ржирзНржб
ЁЯЗ┤ЁЯЗ▓ => ЁЯЗ┤ЁЯЗ▓, ржУржорж╛ржи
ЁЯЗ╡ЁЯЗж => ЁЯЗ╡ЁЯЗж, ржкрж╛ржирж╛ржорж╛
ЁЯЗ╡ЁЯЗк => ЁЯЗ╡ЁЯЗк, ржкрзЗрж░рзБ
ЁЯЗ╡ЁЯЗл => ЁЯЗ╡ЁЯЗл, ржлрж░рж╛рж╕рзА ржкрж▓рж┐ржирзЗрж╢рж┐ржпрж╝рж╛
ЁЯЗ╡ЁЯЗм => ЁЯЗ╡ЁЯЗм, ржкрж╛ржкрзБржпрж╝рж╛ ржирж┐ржЙ ржЧрж┐ржирж┐
ЁЯЗ╡ЁЯЗн => ЁЯЗ╡ЁЯЗн, ржлрж┐рж▓рж┐ржкрж╛ржЗржи
ЁЯЗ╡ЁЯЗ░ => ЁЯЗ╡ЁЯЗ░, ржкрж╛ржХрж┐рж╕рзНрждрж╛ржи
ЁЯЗ╡ЁЯЗ▒ => ЁЯЗ╡ЁЯЗ▒, ржкрзЛрж▓рзНржпрж╛ржирзНржб
ЁЯЗ╡ЁЯЗ▓ => ЁЯЗ╡ЁЯЗ▓, рж╕рзЗржирзНржЯ ржкрж┐ржпрж╝рзЗрж░ ржУ ржорж┐ржХрзБржпрж╝рзЗрж▓ржи
ЁЯЗ╡ЁЯЗ│ => ЁЯЗ╡ЁЯЗ│, ржкрж┐ржЯржХрзЗржпрж╝рж╛рж░рзНржи ржжрзНржмрзАржкржкрзБржЮрзНржЬ
ЁЯЗ╡ЁЯЗ╖ => ЁЯЗ╡ЁЯЗ╖, ржкрзБржпрж╝рзЗрж░рзНрждрзЛ рж░рж┐ржХрзЛ
ЁЯЗ╡ЁЯЗ╕ => ЁЯЗ╡ЁЯЗ╕, ржлрж┐рж▓рж┐рж╕рзНрждрж┐ржи ржЕржЮрзНржЪрж▓рж╕ржорзВрж╣
ЁЯЗ╡ЁЯЗ╣ => ЁЯЗ╡ЁЯЗ╣, ржкрж░рзНрждрзБржЧрж╛рж▓
ЁЯЗ╡ЁЯЗ╝ => ЁЯЗ╡ЁЯЗ╝, ржкрж╛рж▓рж╛ржЙ
ЁЯЗ╡ЁЯЗ╛ => ЁЯЗ╡ЁЯЗ╛, ржкрзНржпрж╛рж░рж╛ржЧрзБржпрж╝рзЗ
ЁЯЗ╢ЁЯЗж => ЁЯЗ╢ЁЯЗж, ржХрж╛рждрж╛рж░
ЁЯЗ╢ЁЯЗ┤ => ЁЯЗ╢ЁЯЗ┤, ржЖржЙржЯрж▓рж╛ржЗржирж┐ржВ ржУрж╕рж╛ржирж┐ржпрж╝рж╛
ЁЯЗ╖ЁЯЗк => ЁЯЗ╖ЁЯЗк, рж░рж┐ржЗржЙржирж┐ржпрж╝ржи
ЁЯЗ╖ЁЯЗ┤ => ЁЯЗ╖ЁЯЗ┤, рж░рзЛржорж╛ржирж┐ржпрж╝рж╛
ЁЯЗ╖ЁЯЗ╕ => ЁЯЗ╖ЁЯЗ╕, рж╕рж╛рж░рзНржмрж┐ржпрж╝рж╛
ЁЯЗ╖ЁЯЗ║ => ЁЯЗ╖ЁЯЗ║, рж░рж╛рж╢рж┐ржпрж╝рж╛
ЁЯЗ╖ЁЯЗ╝ => ЁЯЗ╖ЁЯЗ╝, рж░рзБржпрж╝рж╛ржирзНржбрж╛
ЁЯЗ╕ЁЯЗж => ЁЯЗ╕ЁЯЗж, рж╕рзМржжрж┐ ржЖрж░ржм
ЁЯЗ╕ЁЯЗз => ЁЯЗ╕ЁЯЗз, рж╕рж▓рзЛржоржи ржжрзНржмрзАржкржкрзБржЮрзНржЬ
ЁЯЗ╕ЁЯЗи => ЁЯЗ╕ЁЯЗи, рж╕рж┐рж╕рж┐рж▓рж┐
ЁЯЗ╕ЁЯЗй => ЁЯЗ╕ЁЯЗй, рж╕рзБржжрж╛ржи
ЁЯЗ╕ЁЯЗк => ЁЯЗ╕ЁЯЗк, рж╕рзБржЗржбрзЗржи
ЁЯЗ╕ЁЯЗм => ЁЯЗ╕ЁЯЗм, рж╕рж┐ржЩрзНржЧрж╛ржкрзБрж░
ЁЯЗ╕ЁЯЗн => ЁЯЗ╕ЁЯЗн, рж╕рзЗржирзНржЯ рж╣рзЗрж▓рзЗржирж╛
ЁЯЗ╕ЁЯЗо => ЁЯЗ╕ЁЯЗо, рж╕рзНрж▓рзЛржнрж╛ржирж┐ржпрж╝рж╛
ЁЯЗ╕ЁЯЗп => ЁЯЗ╕ЁЯЗп, рж╕рзНржмрж╛рж▓ржмрж╛рж░рзНржб ржУ ржЬрж╛ржи ржорзЗржпрж╝рзЗржи
ЁЯЗ╕ЁЯЗ░ => ЁЯЗ╕ЁЯЗ░, рж╕рзНрж▓рзЛржнрж╛ржХрж┐ржпрж╝рж╛
ЁЯЗ╕ЁЯЗ▒ => ЁЯЗ╕ЁЯЗ▒, рж╕рж┐ржпрж╝рзЗрж░рж╛рж▓рж┐ржУржи
ЁЯЗ╕ЁЯЗ▓ => ЁЯЗ╕ЁЯЗ▓, рж╕рж╛ржи ржорж╛рж░рж┐ржирзЛ
ЁЯЗ╕ЁЯЗ│ => ЁЯЗ╕ЁЯЗ│, рж╕рзЗржирзЗржЧрж╛рж▓
ЁЯЗ╕ЁЯЗ┤ => ЁЯЗ╕ЁЯЗ┤, рж╕рзЛржорж╛рж▓рж┐ржпрж╝рж╛
ЁЯЗ╕ЁЯЗ╖ => ЁЯЗ╕ЁЯЗ╖, рж╕рзБрж░рж┐ржирж╛ржо
ЁЯЗ╕ЁЯЗ╕ => ЁЯЗ╕ЁЯЗ╕, ржжржХрзНрж╖рж┐ржг рж╕рзБржжрж╛ржи
ЁЯЗ╕ЁЯЗ╣ => ЁЯЗ╕ЁЯЗ╣, рж╕рж╛ржУржЯрзЛржорж╛ ржУ ржкрзНрж░рж┐ржирзНрж╕рж┐ржкрж┐
ЁЯЗ╕ЁЯЗ╗ => ЁЯЗ╕ЁЯЗ╗, ржПрж▓ рж╕рж╛рж▓ржнрзЗржжрж░
ЁЯЗ╕ЁЯЗ╜ => ЁЯЗ╕ЁЯЗ╜, рж╕рж┐ржирзНржЯ ржорж╛рж░рзНржЯрзЗржи
ЁЯЗ╕ЁЯЗ╛ => ЁЯЗ╕ЁЯЗ╛, рж╕рж┐рж░рж┐ржпрж╝рж╛
ЁЯЗ╕ЁЯЗ┐ => ЁЯЗ╕ЁЯЗ┐, рж╕рзЛржпрж╝рж╛ржЬрж┐рж▓рзНржпрж╛ржирзНржб
ЁЯЗ╣ЁЯЗж => ЁЯЗ╣ЁЯЗж, ржЯрзНрж░рж┐рж╕рзНржЯрж╛ржи ржбрж╛ ржХрзБржирж╣рж╛
ЁЯЗ╣ЁЯЗи => ЁЯЗ╣ЁЯЗи, рждрзБрж░рзНржХрж╕ ржУ ржХрж╛ржЗржХрзЛрж╕ ржжрзНржмрзАржкржкрзБржЮрзНржЬ
ЁЯЗ╣ЁЯЗй => ЁЯЗ╣ЁЯЗй, ржЪрж╛ржж
ЁЯЗ╣ЁЯЗл => ЁЯЗ╣ЁЯЗл, ржлрж░рж╛рж╕рзА ржжржХрзНрж╖рж┐ржгрж╛ржЮрзНржЪрж▓
ЁЯЗ╣ЁЯЗм => ЁЯЗ╣ЁЯЗм, ржЯрзЛржЧрзЛ
ЁЯЗ╣ЁЯЗн => ЁЯЗ╣ЁЯЗн, ржерж╛ржЗрж▓рзНржпрж╛ржирзНржб
ЁЯЗ╣ЁЯЗп => ЁЯЗ╣ЁЯЗп, рждрж╛ржЬрж┐ржХрж╕рзНржерж╛ржи
ЁЯЗ╣ЁЯЗ░ => ЁЯЗ╣ЁЯЗ░, ржЯрзЛржХрзЗрж▓рж╛ржЙ
ЁЯЗ╣ЁЯЗ▒ => ЁЯЗ╣ЁЯЗ▒, рждрж┐ржорзБрж░-рж▓рзЗрж╕рзНрждрзЗ
ЁЯЗ╣ЁЯЗ▓ => ЁЯЗ╣ЁЯЗ▓, рждрзБрж░рзНржХржорзЗржирж┐рж╕рзНрждрж╛ржи
ЁЯЗ╣ЁЯЗ│ => ЁЯЗ╣ЁЯЗ│, рждрж┐ржЙржирж┐рж╕рж┐ржпрж╝рж╛
ЁЯЗ╣ЁЯЗ┤ => ЁЯЗ╣ЁЯЗ┤, ржЯрзЛржЩрзНржЧрж╛
ЁЯЗ╣ЁЯЗ╖ => ЁЯЗ╣ЁЯЗ╖, рждрзБрж░рж╕рзНржХ
ЁЯЗ╣ЁЯЗ╣ => ЁЯЗ╣ЁЯЗ╣, рждрзНрж░рж┐ржирж┐ржирж╛ржж ржУ ржЯрзЛржмрзНржпрж╛ржЧрзЛ
ЁЯЗ╣ЁЯЗ╗ => ЁЯЗ╣ЁЯЗ╗, ржЯрзБржнрж╛рж▓рзБ
ЁЯЗ╣ЁЯЗ╝ => ЁЯЗ╣ЁЯЗ╝, рждрж╛ржЗржУржпрж╝рж╛ржи
ЁЯЗ╣ЁЯЗ┐ => ЁЯЗ╣ЁЯЗ┐, рждрж╛ржЮрзНржЬрж╛ржирж┐ржпрж╝рж╛
ЁЯЗ║ЁЯЗж => ЁЯЗ║ЁЯЗж, ржЗржЙржХрзНрж░рзЗржи
ЁЯЗ║ЁЯЗм => ЁЯЗ║ЁЯЗм, ржЙржЧрж╛ржирзНржбрж╛
ЁЯЗ║ЁЯЗ▓ => ЁЯЗ║ЁЯЗ▓, ржпрзБржХрзНрждрж░рж╛рж╖рзНржЯрзНрж░рзЗрж░ ржкрж╛рж░рзНрж╢рзНржмржмрж░рзНрждрзА ржжрзНржмрзАржкржкрзБржЮрзНржЬ
ЁЯЗ║ЁЯЗ│ => ЁЯЗ║ЁЯЗ│, ржЬрж╛рждрж┐рж╕ржВржШ
ЁЯЗ║ЁЯЗ╕ => ЁЯЗ║ЁЯЗ╕, ржорж╛рж░рзНржХрж┐ржи ржпрзБржХрзНрждрж░рж╛рж╖рзНржЯрзНрж░
ЁЯЗ║ЁЯЗ╛ => ЁЯЗ║ЁЯЗ╛, ржЙрж░рзБржЧрзБржпрж╝рзЗ
ЁЯЗ║ЁЯЗ┐ => ЁЯЗ║ЁЯЗ┐, ржЙржЬржмрзЗржХрж┐рж╕рзНрждрж╛ржи
ЁЯЗ╗ЁЯЗж => ЁЯЗ╗ЁЯЗж, ржнрзНржпрж╛ржЯрж┐ржХрж╛ржи рж╕рж┐ржЯрж┐
ЁЯЗ╗ЁЯЗи => ЁЯЗ╗ЁЯЗи, рж╕рзЗржирзНржЯ ржнрж┐ржирж╕рзЗржирзНржЯ ржУ ржжрзНржпрж╛ ржЧрзНрж░рзЗржирж╛ржбрж┐ржирж╕
ЁЯЗ╗ЁЯЗк => ЁЯЗ╗ЁЯЗк, ржнрзЗржирзЗржЬрзБржпрж╝рзЗрж▓рж╛
ЁЯЗ╗ЁЯЗм => ЁЯЗ╗ЁЯЗм, ржмрзНрж░рж┐ржЯрж┐рж╢ ржнрж╛рж░рзНржЬрж┐ржи ржжрзНржмрзАржкржкрзБржЮрзНржЬ
ЁЯЗ╗ЁЯЗо => ЁЯЗ╗ЁЯЗо, ржорж╛рж░рзНржХрж┐ржи ржпрзБржХрзНрждрж░рж╛рж╖рзНржЯрзНрж░рзЗрж░ ржнрж╛рж░рзНржЬрж┐ржи ржжрзНржмрзАржкржкрзБржЮрзНржЬ
ЁЯЗ╗ЁЯЗ│ => ЁЯЗ╗ЁЯЗ│, ржнрж┐ржпрж╝рзЗрждржирж╛ржо
ЁЯЗ╗ЁЯЗ║ => ЁЯЗ╗ЁЯЗ║, ржнрж╛ржирзБржпрж╝рж╛ржЯрзБ
ЁЯЗ╝ЁЯЗл => ЁЯЗ╝ЁЯЗл, ржУржпрж╝рж╛рж▓рж┐рж╕ ржУ ржлрзБржЯрзБржирж╛
ЁЯЗ╝ЁЯЗ╕ => ЁЯЗ╝ЁЯЗ╕, рж╕рж╛ржорзЛржпрж╝рж╛
ЁЯЗ╜ЁЯЗ░ => ЁЯЗ╜ЁЯЗ░, ржХрж╕рзЛржнрзЛ
ЁЯЗ╛ЁЯЗк => ЁЯЗ╛ЁЯЗк, ржЗржпрж╝рзЗржорзЗржи
ЁЯЗ╛ЁЯЗ╣ => ЁЯЗ╛ЁЯЗ╣, ржорж╛ржпрж╝рзЛрждрзНрждрзЗ
ЁЯЗ┐ЁЯЗж => ЁЯЗ┐ЁЯЗж, ржжржХрзНрж╖рж┐ржг ржЖржлрзНрж░рж┐ржХрж╛
ЁЯЗ┐ЁЯЗ▓ => ЁЯЗ┐ЁЯЗ▓, ржЬрж╛ржорзНржмрж┐ржпрж╝рж╛
ЁЯЗ┐ЁЯЗ╝ => ЁЯЗ┐ЁЯЗ╝, ржЬрж┐ржорзНржмрж╛ржмрзЛржпрж╝рзЗ
ЁЯЗ┐ЁЯЗ┐ => ЁЯЗ┐ЁЯЗ┐, ржЕржЬрж╛ржирж╛ ржЕржЮрзНржЪрж▓