тЩА => тЩА, риЗри╕ридри░рйА, риФри░рид
тЩВ => тЩВ, рикрйБри░ри╕ри╝, римрй░рижри╛
тЪХ => тЪХ, риЪри┐риХри┐ридри╕ри╛ ри╕рй░риХрйЗрид, рижри╡ри╛риИ, риЕриори▓ри╛
ЁЯХ║ => ЁЯХ║, риири╛риЪ, риори░риж, ринрй░риЧрйЬри╛
ЁЯЦд => ЁЯЦд, риХри╛ри▓ри╛, рижри┐ри▓, римрйБри░ри╛риИ, ри╕ри╝рйИридри╛рии
ЁЯдЩ => ЁЯдЩ, риХри╛ри▓, ри╣рй▒рие, риЯрйИри▓рйАрилри╝рйЛрии
ЁЯдЪ => ЁЯдЪ, рикри┐риЫри▓ри╛ ри╣рй▒рие, рикрйБрй▒риари╛ рикрй░риЬри╛
ЁЯдЫ => ЁЯдЫ, риорйБрй▒риарйА, риЦрй▒римрйЗ рикри╛ри╕рйЗ
ЁЯдЬ => ЁЯдЬ, риорйБрй▒риарйА, ри╕рй▒риЬрйЗ рикри╛ри╕рйЗ
ЁЯдЭ => ЁЯдЭ, ри╣рй▒рие риори┐ри▓ри╛риЙригри╛, ри╕риориЭрйМридри╛, риорйАриЯри┐рй░риЧ, риори┐ри▓ри╛риЙригри╛, ри╣рй▒рие
ЁЯдЮ => ЁЯдЮ, риХри░ри╛ри╕, риЙриВриЧри▓рйА, ри╣рй▒рие, риХри┐ри╕риорид
ЁЯда => ЁЯда, риХри╛риУримрйМриП, риЪри┐ри╣ри░ри╛, риЯрйЛрикрйА
ЁЯдб => ЁЯдб, риЬрйЛриХри░, риЪри┐ри╣ри░ри╛
ЁЯдв => ЁЯдв, риЪри┐ри╣ри░ри╛, риЙри▓риЯрйА
ЁЯдг => ЁЯдг, рилри░ри╕ри╝, ри╣ри╛ри╕ри╛, ри▓рйЗриЯригри╛, риЪри┐ри╣ри░ри╛
ЁЯдд => ЁЯдд, ри▓ри╛ри░ риЯрикриХригри╛, риЪри┐ри╣ри░ри╛
ЁЯде => ЁЯде, риЪри┐ри╣ри░ри╛, риЭрйВриа
ЁЯдж => ЁЯдж, риЪри┐ри╣ри░ри╛, ри╣риерйЗри▓рйА, риЭрйБрй░риЬри▓ри╛ри╣риЯ
ЁЯджтАНтЩА => ЁЯджтАНтЩА, риЕри╡ри┐ри╕ри╝ри╡ри╛ри╕, риЭрйБрй░риЬри▓ри╛ри╣риЯ, риорй▒риерйЗ тАЩридрйЗ ри╣рй▒рие ри░рй▒риЦригри╛, риЗри╕ридри░рйА, риФри░рид
ЁЯджтАНтЩВ => ЁЯджтАНтЩВ, риЕри╡ри┐ри╕ри╝ри╡ри╛ри╕, риЭрйБрй░риЬри▓ри╛ри╣риЯ, риорй▒риерйЗ тАЩридрйЗ ри╣рй▒рие ри░рй▒риЦригри╛, рикрйБри░ри╕ри╝, римрй░рижри╛
ЁЯдз => ЁЯдз, риЪри┐ри╣ри░ри╛, риЫри┐рй▒риХ
ЁЯд░ => ЁЯд░, риЧри░ринри╡ридрйА, риФри░рид
ЁЯд│ => ЁЯд│, ри╕рйИри▓рилрйА, риХрйИриори░ри╛, рилри╝рйЛрии
ЁЯд┤ => ЁЯд┤, ри░ри╛риЬриХрйБриори╛ри░
ЁЯд╡ => ЁЯд╡, ри▓ри╛рйЬри╛, риори░риж, риХрйЛриЯ
ЁЯд╢ => ЁЯд╢, риХрйНри░ри┐ри╕риори┐ри╕, риори╛риВ
ЁЯд╖ => ЁЯд╖, риЙриЪриХри╛риЙригри╛, ри╕ри╝рй▒риХ, рикридри╛ риири╣рйАриВ, риорйЛриврйЗ риЪрйБрй▒риХригри╛
ЁЯд╖тАНтЩА => ЁЯд╖тАНтЩА, ри╕ри╝рй▒риХ, риЕриЧри┐риЖрииридри╛, риорйИриирйВрй░ риири╣рйАриВ рикридри╛, риЗри╕ридри░рйА, риФри░рид, риорйЛриврйЗ риЪрйБрй▒риХригри╛
ЁЯд╖тАНтЩВ => ЁЯд╖тАНтЩВ, ри╕ри╝рй▒риХ, риЕриЧри┐риЖрииридри╛, риорйИриирйВрй░ риири╣рйАриВ рикридри╛, рикрйБри░ри╕ри╝, римрй░рижри╛, риорйЛриврйЗ риЪрйБрй▒риХригри╛
ЁЯд╕ => ЁЯд╕, риЧрй▒рибрйЗ рижри╛ рикри╣рйАриЖ, риЬри┐риориири╛ри╕риЯри┐риХ, ри╡ри┐риЕриХридрйА, риЦрйЗриб
ЁЯд╕тАНтЩА => ЁЯд╕тАНтЩА, риХри▓ри╛римри╛риЬри╝рйА, риЬри┐риориири╛ри╕риЯри┐риХри╕, риЗри╕ридри░рйА, риФри░рид, ри╡ри┐риЕриХридрйА, риЦрйЗриб
ЁЯд╕тАНтЩВ => ЁЯд╕тАНтЩВ, риХри▓ри╛римри╛риЬри╝рйА, риЬри┐риориири╛ри╕риЯри┐риХри╕, рикрйБри░ри╕ри╝, римрй░рижри╛, ри╡ри┐риЕриХридрйА, риЦрйЗриб
ЁЯд╣ => ЁЯд╣, ри╣рй▒риерилрйЗри░рйА, римри╣рйБ-риХри╛ри░риЬ, ри╕рй░ридрйБри▓рии, ри╣рйБриири░
ЁЯд╣тАНтЩА => ЁЯд╣тАНтЩА, риХри░ридрй▒рим рижри┐риЦри╛риЙригри╛, риЗри╕ридри░рйА, риФри░рид, римри╣рйБ-риХри╛ри░риЬ
ЁЯд╣тАНтЩВ => ЁЯд╣тАНтЩВ, риХри░ридрй▒рим рижри┐риЦри╛риЙригри╛, рикрйБри░ри╕ри╝, римрй░рижри╛, римри╣рйБ-риХри╛ри░риЬ
ЁЯд║ => ЁЯд║, ридри▓ри╡ри╛ри░римри╛риЬри╝, ридри▓ри╡ри╛ри░, риЦри┐рибри╛ри░рйА
ЁЯд╝ => ЁЯд╝, рикри╣ри┐ри▓ри╡ри╛рии, риХрйБри╕ри╝ридрйА, риЦри┐рибри╛ри░рйА
ЁЯд╝тАНтЩА => ЁЯд╝тАНтЩА, риЗри╕ридри░рйА, риЗри╕ридри░рйА рикри╣ри┐ри▓ри╡ри╛рии, ри╡ри┐риЕриХридрйА, риЦрйЗриб, риХрйБри╕ри╝ридрйА ри▓рйЬриири╛
ЁЯд╝тАНтЩВ => ЁЯд╝тАНтЩВ, рикрйБри░ри╕ри╝, рикри╣ри┐ри▓ри╡ри╛рии, ри╡ри┐риЕриХридрйА, риЦрйЗриб, риХрйБри╕ри╝ридрйА ри▓рйЬриири╛
ЁЯд╜ => ЁЯд╜, рикрйЛри▓рйЛ, рикри╛ригрйА, ри╡ри┐риЕриХридрйА, риЦрйЗриб
ЁЯд╜тАНтЩА => ЁЯд╜тАНтЩА, риЗри╕ридри░рйА, риФри░рид, риЦрйЗриб, ри╡ри╛риЯри░ рикрйЛри▓рйЛ
ЁЯд╜тАНтЩВ => ЁЯд╜тАНтЩВ, рикрйБри░ри╕ри╝, римрй░рижри╛, риЦрйЗриб, ри╡ри╛риЯри░ рикрйЛри▓рйЛ
ЁЯд╛ => ЁЯд╛, ри╣рйИриВрибримри╛ри▓, риЧрйЗриВриж, риЦри┐рибри╛ри░рйА
ЁЯд╛тАНтЩА => ЁЯд╛тАНтЩА, ри╣рйИриВрибримри╛ри▓, риЗри╕ридри░рйА, риФри░рид, риЦрйЗриб
ЁЯд╛тАНтЩВ => ЁЯд╛тАНтЩВ, ри╣рйИриВрибримри╛ри▓, рикрйБри░ри╕ри╝, римрй░рижри╛, риЦрйЗриб
ЁЯеА => ЁЯеА, рилрйБрй▒ри▓, риорйБри░риЭри╛риЗриЖ
ЁЯеБ => ЁЯеБ, рибри░рй░рио, рибри░рй░риори╕риЯри┐рй▒риХ, ри╕рй░риЧрйАрид
ЁЯеВ => ЁЯеВ, риЯриХри░ри╛риЙригри╛, риЧри▓ри╛ри╕, рикрйАригри╛, риЬри╕ри╝рии
ЁЯеГ => ЁЯеГ, риЧри▓ри╛ри╕, римрйАриЕри░, ри╡ри┐ри╕риХрйА, ри╕ри╝ри░ри╛рим
ЁЯеД => ЁЯеД, риЪриориЪ, риорйЗриЬри╝ рижрйЗ римри░ридрии
ЁЯеЕ => ЁЯеЕ, риЯрйАриЪри╛, риирйИрй▒риЯ, риЦрйЗриб
ЁЯеЗ => ЁЯеЗ, рикри╣ри┐ри▓ри╛, риЧрйЛри▓риб, ридриориЧри╛
ЁЯеИ => ЁЯеИ, ридриориЧри╛, рижрйВриЬри╛, ри╕ри┐ри▓ри╡ри░
ЁЯеЙ => ЁЯеЙ, римри░рйМриВриЬ, ридриориЧри╛, ридрйАриЬри╛
ЁЯеК => ЁЯеК, риорйБрй▒риХрйЗримри╛риЬри╝рйА, рижри╕ридри╛риирйЗ, риЦрйЗриб
ЁЯеЛ => ЁЯеЛ, риЬрйВрибрйЛ, риХри░ри╛риЯрйЗ, ридри╛риИриХри╡ри╛риирибрйЛ, риори╛ри░ри╕ри╝ри▓ риЖри░риЯ, ри╡ри░рижрйА, риЦрйЗриб
ЁЯеР => ЁЯеР, риХри░рйЛриПри╕рйИрии, риХрйНри░рйИри╕рйИриВриЯ ри░рйЛри▓, рилри░рйИриВриЪ, риЦри╛ригри╛, ри░рйЛриЯрйА
ЁЯеС => ЁЯеС, риЕри╡рйЛриХрйИрибрйЛ, рилри▓ри╝, ринрйЛриЬрии
ЁЯеТ => ЁЯеТ, риЦрйАри░ри╛, риЕриЪри╛ри░, ри╕римриЬри╝рйА, ринрйЛриЬрии
ЁЯеУ => ЁЯеУ, римрйЗриХрии, риори╛ри╕, ринрйЛриЬрии
ЁЯеФ => ЁЯеФ, риЖри▓рйВ, ри╕римриЬри╝рйА, ринрйЛриЬрии
ЁЯеХ => ЁЯеХ, риЧри╛риЬри░, ри╕римриЬри╝рйА, ринрйЛриЬрии
ЁЯеЦ => ЁЯеЦ, ри░рйЛриЯрйА, рилри░рйИриВриЪ, ринрйЛриЬрии
ЁЯеЧ => ЁЯеЧ, ри╣ри░ри╛, ри╕ри▓ри╛риж, ринрйЛриЬрии
ЁЯеШ => ЁЯеШ, риХрйИри╕ри░рйЛри▓, рикрйБри▓ри╛риЕ, рикрйИрии, ри╣ри▓риХри╛, ринрйЛриЬрии
ЁЯеЩ => ЁЯеЩ, риХримри╛рим, рилри▓ри╛рилри▓, риЬри╛риЗри░рйЛ, ри░рйЛриЯрйА, ринри░ри╡ри╛риВ, ринрйЛриЬрии
ЁЯеЪ => ЁЯеЪ, риЕрй░рибри╛, ринрйЛриЬрии
ЁЯеЫ => ЁЯеЫ, риЧри▓ри╛ри╕, рижрйБрй▒риз, рикрйАриг-рикрижри╛ри░рие
ЁЯеЬ => ЁЯеЬ, риорйВрй░риЧрилри▓ри╝рйА, риЕриЦри░рйЛриЯ, риЦри╛ригри╛, ри╕римриЬри╝рйА
ЁЯеЭ => ЁЯеЭ, риХрйАри╡рйА, рилри▓ри╝, ринрйЛриЬрии
ЁЯеЮ => ЁЯеЮ, ри╣ри╛рй▒риЯриХрйЗриХ, риХри░рйИрик, рикрйИриириХрйЗриХ, ринрйЛриЬрии
ЁЯжЕ => ЁЯжЕ, римри╛риЬ, рикрй░риЫрйА
ЁЯжЖ => ЁЯжЖ, римрй▒ридриЦ, рикрй░риЫрйА
ЁЯжЗ => ЁЯжЗ, риЪриориЧри┐рй▒рижрйЬ, ринрйВрид, риЬри╛риири╡ри░
ЁЯжИ => ЁЯжИ, ри╕ри╝ри╛ри░риХ, риорй▒риЫрйА
ЁЯжЙ => ЁЯжЙ, риЙрй▒ри▓рйВ, римрйБрй▒ризрйАриори╛рии, рикрй░риЫрйА
ЁЯжК => ЁЯжК, риЪри┐ри╣ри░ри╛, ри▓рйВрй░римрйЬрйА, риЬри╛риири╡ри░
ЁЯжЛ => ЁЯжЛ, ридри┐ридри▓рйА, риХрйАрйЬри╛, ри╕рйБрй░рижри░
ЁЯжМ => ЁЯжМ, ри╣ри┐ри░рии, риЬри╛риири╡ри░
ЁЯжН => ЁЯжН, риЧрйЛри░рйАри▓ри╛, риЬри╛риири╡ри░
ЁЯжО => ЁЯжО, риХри┐ри░ри▓рйА, ри╕рй▒рик
ЁЯжП => ЁЯжП, риЧрйИриВрибри╛, риЬри╛риири╡ри░
ЁЯжР => ЁЯжР, риЭрйАриВриЧри╛, риЫрйЛриЯри╛, ри╕рй░риЦ, ринрйЛриЬрии
ЁЯжС => ЁЯжС, ри╕риХри╡ри┐рй▒риб, ри╕ри┐рй▒рикрйА, ринрйЛриЬрии
ЁЯША => ЁЯША, риорйБри╕риХри╛рии, риорйБри╕риХри░ри╛риЙригри╛, ри╕риори╛риИри▓рйА, риЪри┐ри╣ри░ри╛, ри╣рй▒ри╕ригри╛, ри▓рйЛри▓, ри╣рй▒ри╕ри╛риЙригрйЗ
ЁЯШБ => ЁЯШБ, риорйБри╕риХри╛рии, риорйБрйБри╕риХри░ри╛риЙриВрижрйАриЖриВ риЕрй▒риЦри╛риВ, риорйБри╕риХри░ри╛риЙригри╛, ри╕риори╛риИри▓рйА, риорйБри╕риХри░ри╛риЙриВрижрйАриЖриВ риЕрй▒риЦри╛риВ риири╛ри▓ ри╣рй▒ри╕рижри╛ риЪри┐ри╣ри░ри╛, риЪри┐ри╣ри░ри╛, ри╣рй▒ри╕ригри╛, ри▓рйЛри▓, ри╣ри╕ри╛риЙригрйЗ
ЁЯШВ => ЁЯШВ, риЦрйБри╕ри╝рйА рижрйЗ ри╣рй░риЭрйБ, риЦрйБри╕ри╝рйА, ри╣рй░риЭрйВ, риЪри┐ри╣ри░ри╛
ЁЯШГ => ЁЯШГ, риЦрйБрй▒ри▓рйНри╣рйЗ риорйБрй░ри╣ риири╛ри▓ ри╣ри╛ри╕ри╛, ри╣ри╕ригри╛, ри╕риори╛риИри▓рйА, риЦрйБрй▒ри▓рйНри╣рйЗ риорйБрй░ри╣ риири╛ри▓ ри╣ри╕рижри╛ риЪри┐ри╣ри░ри╛, ри╣ри╛ри╕ри╛, ри▓рйЛри▓, ри╣рй▒ри╕ри╛риЙригрйЗ
ЁЯШД => ЁЯШД, риЦрйБрй▒ри▓рйНри╣рйЗ риорйБрй░ри╣ риири╛ри▓ ри╣ри╛ри╕ри╛, ри╣рй▒ри╕ригри╛, ри╕риори╛риИри▓рйА, риЦрйБрй▒ри▓рйНри╣ри╛ риорйБрй░ри╣, ри╣ри╕рижрйАриЖриВ риЕрй▒риЦри╛риВ, ри╣ри╛ри╕ри╛, ри▓рйЛри▓, ри╣ри╕ри╛риЙригрйЗ
ЁЯШЕ => ЁЯШЕ, риарй░рибри╛ риорйБрйЬрйНри╣риХри╛ риорйБри╕риХри╛рии, риорйБри╕риХри╛рии рикри░ риарй░рибрйЗ риорйБрйЬрйНри╣риХрйЗ риири╛ри▓, риарй░рибри╛ риорйБрйЬрйНри╣риХри╛
ЁЯШЖ => ЁЯШЖ, риЦрйБрй▒ри▓рйНри╣рйЗ риорйБрй░ри╣ риири╛ри▓ ри╣ри╛ри╕ри╛, риЕрй▒риЦри╛риВ римрй░риж риири╛ри▓ риорйБри╕риХри╛рии, риЦрйБрй▒ри▓рйНри╣ри╛ риорйБрй░ри╣, римрй░риж риЕрй▒риЦри╛риВ, риЪри┐ри╣ри░ри╛
ЁЯШЙ => ЁЯШЙ, риЭрикриХригри╛ риЪри┐ри╣ри░ри╛, риЭрикриХригри╛, риЪри┐ри╣ри░ри╛, риориЯриХри╛риЙригри╛
ЁЯШК => ЁЯШК, риорйБри╕риХри╛рии, риорйБри╕риХри░ри╛риЙриВрижрйАриЖриВ риЕрй▒риЦри╛риВ, риорйБри╕риХри░ри╛риЙриВрижри╛ риЪри┐ри╣ри░ри╛ риЕридрйЗ риЕрй▒риЦри╛риВ, риорйБри╕риХри░ри╛риЙриВрижри╛ риЪри┐ри╣ри░ри╛, риЪри┐ри╣ри░ри╛
ЁЯШЛ => ЁЯШЛ, ри╕рйБриЖрижрйА риЪри┐ри╣ри░ри╛, ри╕рйБриЖрижрйА, ри╕рйБриЖрижрйА риЪрй░риЧри╛, риорйБри╕риХри░ри╛риЙриВрижри╛ риЪри┐ри╣ри░ри╛, ри╕рйБриЖрижрйА риЦри╛ригри╛, риЪри┐ри╣ри░ри╛
ЁЯШО => ЁЯШО, риЪриориХрижри╛ри░, риарй░рибри╛, риРриириХри╛риВ риири╛ри▓ риорйБри╕риХри░ри╛риЙриВрижри╛, риорйБри╕риХри░ри╛риЙриВрижри╛, ризрйБрй▒рик рижрйАриЖриВ риРриириХри╛риВ, риЪри┐ри╣ри░ри╛
ЁЯШН => ЁЯШН, риорйБри╕риХри░ри╛риЙриВрижри╛ риЪри┐ри╣ри░ри╛, рижри┐ри▓ ри╡ри░риЧрйАриЖриВ риЕрй▒риЦри╛риВ, рикри┐риЖри░, римри╣рйБрид рикри┐риЖри░, рижри┐ри▓, риЕрй▒риЦри╛риВ, риЪри┐ри╣ри░ри╛, риорйБри╕риХри╛рии
ЁЯШШ => ЁЯШШ, риЪрйБрй░рй░риорйА ри╕рйБрй▒риЯригри╛, риЪрйБрй░риорйАриЖриВ ри╕рйБрй▒риЯрижри╛ риЪри┐ри╣ри░ри╛, риЪри┐ри╣ри░ри╛
ЁЯШЧ => ЁЯШЧ, риЪрйБрй░рио риЪри┐ри╣ри░ри╛, риЪри┐ри╣ри░ри╛ риЪрйБрй░риоригри╛, риЪрйБрй░риорйА, риЪри┐ри╣ри░ри╛
ЁЯШЩ => ЁЯШЩ, риЪрйБрй░риорйА риЕридрйЗ риорйБри╕риХри░ри╛ри╣риЯ, риорйБри╕риХри░ри╛ри╣риЯ риири╛ри▓ риЪрйБрй░риорижри╛ риЪри┐ри╣ри░ри╛, риЪри┐ри╣ри░ри╛, риорйБри╕риХри░ри╛ри╣риЯ, риорйБри╕риХри░ри╛риЙриВрижрйАриЖриВ риЕрй▒риЦри╛риВ
ЁЯШЪ => ЁЯШЪ, риЪрйБрй░риоригри╛, риЕрй▒риЦри╛риВ римрй░риж риХри░риХрйЗ риЪрйБрй░риоригри╛, римрй░риж риЕрй▒риЦри╛риВ, риЪри┐ри╣ри░ри╛
тШ║ => тШ║, ри╕риори╛риЗри▓рйА, риЦри╛ри▓рйА ри╕риори╛риЗри▓рйА риЪри┐ри╣ри░ри╛, риЪри┐ри╣ри░ри╛
ЁЯЩВ => ЁЯЩВ, риЪри┐ри╣ри░ри╛, риорйБри╕риХри░ри╛ри╣риЯ, риорйБри╕риХри░ри╛риЙриВрижри╛ риЪри┐ри╣ри░ри╛
ЁЯдЧ => ЁЯдЧ, риЪри┐ри╣ри░ри╛, риЬрй▒рилрйА, риЬрй▒рилрйА рикри╛риЙригри╛, риЦрйБри╕ри╝ ри╣рйЛ риХрйЗ риЬрй▒рилрйА рикри╛риЙригри╛
ЁЯШЗ => ЁЯШЗ, рилри░ри┐ри╕ри╝ридри╛, риЪри┐ри╣ри░ри╛, рикри░рйАриЖриВ рижрйА риХри╣ри╛ригрйА, риХри▓рикриири╛, ри╣ри╛ри▓рйЛ, риори╛ри╕рйВрио риЪри┐ри╣ри░ри╛, риорйБри╕риХри╛рии
ЁЯдФ => ЁЯдФ, риЪри┐ри╣ри░ри╛, ри╕рйЛриЪригри╛, ри╕рйЛриЪрижри╛ риЪри┐ри╣ри░ри╛, ри╕рйЛриЪ ри╡ри┐рй▒риЪ рибрйБрй▒римригри╛
ЁЯШР => ЁЯШР, риорйБри░риЭри╛риЗриЖ риЪри┐ри╣ри░ри╛, риорйБри░риЭри╛риЗриЖ, риири┐ри░рикрй▒риЦ, риЪри┐ри╣ри░ри╛, риХрйЛриИ риЯри┐рй▒рикригрйА риири╣рйАриВ
ЁЯШС => ЁЯШС, римри┐риири╛риВ ри╣ри╛ри╡-ринри╛ри╡, римри┐риири╛риВ ри╣ри╛ри╡-ринри╛ри╡ риЪри┐ри╣ри░ри╛, риЪри┐ри╣ри░ри╛, риХрйЛриИ риЯри┐рй▒рикригрйА риири╣рйАриВ
ЁЯШ╢ => ЁЯШ╢, римри┐риири╛риВ риорйВрй░ри╣ риЪри┐ри╣ри░ри╛, риорйВрй░ри╣ риири╣рйАриВ, риЪри┐ри╣ри░ри╛
ЁЯЩД => ЁЯЩД, риЕрй▒риЦри╛риВ, риЪри┐ри╣ри░ри╛, риЕрй▒риЦри╛риВ риШрйБрй░риори╛риЙригри╛, риЕрй▒риХри┐риЖ риЪри┐ри╣ри░ри╛, риори╛ригри╣ри╛риирйА
ЁЯШП => ЁЯШП, риорйБрйВрйВри░риЦридри╛, риЪри▓ри╛риХ риЪри┐ри╣ри░ри╛, риЪри▓ри╛риХрйА, риЪри▓ри╛риХрйА ринри░рйА риорйБри╕риХри╛рии
ЁЯШг => ЁЯШг, риЙрибри╛ рижри┐риУ, риорйИриВ риЙрибри╛ рижри┐рй▒ридри╛ риЪри┐ри╣ри░ри╛, ри╕рйБри░рй▒риЦри┐риЕри╛ риЪри┐ри╣ри░ри╛, ри╕рйБри░рй▒риЦри┐риЕрид, риЪри┐ри╣ри░ри╛
ЁЯШе => ЁЯШе, риУ ри╣рйЛ, риири┐ри░ри╛ри╕ри╝ рикри░ ри░ри╛ри╣рид, ри░ри╛ри╣рид, риЙрижри╛ри╕, риЪри┐ри╣ри░ри╛
ЁЯШо => ЁЯШо, риЦрйБрй▒ри▓ри┐риЖ риорйВрй░ри╣ риЪри┐ри╣ри░ри╛, риЦрйБрй▒ри▓ри╛ риорйВрй░ри╣, риорйВрй░ри╣, риЪри┐ри╣ри░ри╛
ЁЯдР => ЁЯдР, риЪри┐ри╣ри░ри╛, риорйВрй░ри╣, риЬри╝ри┐рй▒рикри░, риЧрйБрикрид ри░рй▒риЦригри╛, ринрйЗриж ри░рй▒риЦригри╛, риЧрй▒ри▓ ри▓рйБриХри╛риЙригри╛
ЁЯШп => ЁЯШп, ри╕ри╛риВрид риЪри┐ри╣ри░ри╛, ри╣рйИри░ри╛рии, риЪри┐ри╣ри░ри╛
ЁЯШк => ЁЯШк, риирйАриВрижри░ри╛, риЪри┐ри╣ри░ри╛
ЁЯШл => ЁЯШл, риерй▒риХри┐риЖ, риерй▒рй▒риХри┐риЖ риЪри┐ри╣ри░ри╛, риЪри┐ри╣ри░ри╛
ЁЯШ┤ => ЁЯШ┤, ри╕рйМригри╛, риЪри┐ри╣ри░ри╛
ЁЯШМ => ЁЯШМ, ри░ри╛ри╣рид риЪри┐ри╣ри░ри╛, ри░ри╛ри╣рид, риЪри┐ри╣ри░ри╛
ЁЯдУ => ЁЯдУ, риЪри┐ри╣ри░ри╛, римрйЗри╡риХрйВрил, риорйВри░риЦридри╛, риЧри╝рйИри░-ри╕риори╛риЬриХ рикри░ риЕриХри▓риорй░риж
ЁЯШЫ => ЁЯШЫ, риЬрйАрин риири┐риХри▓рйА, римри╛ри╣ри░ риири┐риХри▓рйА риЬрйАрин, риЪри┐ри╣ри░ри╛
ЁЯШЬ => ЁЯШЬ, риЬрйАрин риири┐риХри▓рйА, ридри╛рйЬ ри░ри┐ри╣ри╛, риЭрикриХрйА риири╛ри▓ риЬрйАрин риири┐риХри▓рйА, риЭрикриХригри╛, риЪрйБриЯриХри▓ри╛, риЪри┐ри╣ри░ри╛
ЁЯШЭ => ЁЯШЭ, риЧрй░рижри╛, риЕрй▒риЦри╛риВ римрй░риж риири╛ри▓ риЬрйАрин риири┐риХри▓рйА, ринри┐риЖриириХ, риЬрйАрин римри╛ри╣ри░ риири┐риХри▓рйА, риЕрй▒риЦри╛риВ римрй░риж, риЪри┐ри╣ри░ри╛
тШ╣ => тШ╣, риЪри┐ри╣ри░ри╛, риорй▒риерйЗ ри╡рй▒риЯ рикри╛риЙригри╛, риЙрижри╛ри╕ ри╣рйЛригри╛, риЙрижри╛ри╕ риЪри┐ри╣ри░ри╛
ЁЯЩБ => ЁЯЩБ, риЪри┐ри╣ри░ри╛, риорй▒риерйЗ ри╡рй▒риЯ рикри╛риЙригри╛, риЙрижри╛ри╕ ри╣рйЛригри╛, риЙрижри╛ри╕ риЪри┐ри╣ри░ри╛
ЁЯШТ => ЁЯШТ, риири╛-риЦрйБри╕ри╝, риири╛-риЦрйБри╕ри╝ риЪри┐ри╣ри░ри╛, риЪри┐ри╣ри░ри╛
ЁЯШУ => ЁЯШУ, рибри░ри┐риЖ ри╣рйЛриЗриЖ, рибри░ри┐риЖ ри╣рйЛриЗриЖ риЪри┐ри╣ри░ри╛, риЪри┐ри╣ри░ри╛
ЁЯШФ => ЁЯШФ, ри╡ри┐риЪри╛ри░ри╕ри╝рйАри▓, риЪри┐ри╣ри░ри╛
ЁЯШХ => ЁЯШХ, риЙри▓риЭриг риЪри┐ри╣ри░ри╛, риЙри▓риЭриг, риЪри┐ри╣ри░ри╛
ЁЯШЦ => ЁЯШЦ, ри╕ри╝ри░риори╕ри╛ри░ риЪри┐ри╣ри░ри╛, ри╕ри╝ри░риори╕ри╛ри░, риЪри┐ри╣ри░ри╛
ЁЯЩГ => ЁЯЩГ, риЪри┐ри╣ри░ри╛, римрйЗри╣рйВрижриЧрйА, риорйВри░риЦридри╛, римрйЗри╕риориЭ риЪри┐ри╣ри░ри╛
ЁЯШ╖ => ЁЯШ╖, риириХри╛рим риири╛ри▓ риЪри┐ри╣ри░ри╛, риарй░рибри╛, риорйМри╕рио риЕризрйАрии, риорйИрибрйАриХри▓ риириХри╛рим, риЪри┐ри╣ри░ри╛
ЁЯдТ => ЁЯдТ, риЪри┐ри╣ри░ри╛, римри┐риори╛ри░, риери░риори╛риорйАриЯри░, ри░рйЛриЧрйА, ри░рйЛриЧрйА риЪри┐ри╣ри░ри╛
ЁЯдХ => ЁЯдХ, рикрй▒риЯрйА, риЪри┐ри╣ри░ри╛, риЬри╝риЦриорйА, риЬри╝риЦриорйА риЪри┐ри╣ри░ри╛, рилрй▒риЯрйЬ риЪри┐ри╣ри░ри╛, ри╕рй▒риЯ ри▓рй▒риЧригри╛
ЁЯдС => ЁЯдС, риЪри┐ри╣ри░ри╛, рикрйИри╕ри╛, ризрй░рии, риорйВрй░ри╣, ризрй░рии рижрйА риЗрй▒риЫри╛
ЁЯШ▓ => ЁЯШ▓, ри╣рйИри░ри╛рии риЪри┐ри╣ри░ри╛, ри╣рйИри░ри╛риирйА, рикрйВри░рйА ридри░рйНри╣ри╛риВ ри╣рйИри░ри╛рии, ри╣рйИри░ри╛рии, риЪри┐ри╣ри░ри╛
ЁЯШЮ => ЁЯШЮ, риири┐ри░ри╛ри╕ри╝, риири┐ри░ри╛ри╕ри╝ри╛, риЪри┐ри╣ри░ри╛
ЁЯШЯ => ЁЯШЯ, риЪри┐рй░ридрид, риЪри┐рй░ридрид риЪри┐ри╣ри░ри╛, риЪри┐ри╣ри░ри╛
ЁЯШд => ЁЯШд, риЬри┐рй▒рид ри▓риИ, риорйИриВ риЗри╣ риЬри┐рй▒рид ри▓ри┐риЖ риЪри┐ри╣ри░ри╛, риорйИриВ риЬри┐рй▒ридри┐риЖ, риЬри┐рй▒рид, риЪри┐ри╣ри░ри╛
ЁЯШв => ЁЯШв, ри░рйЛригри╛, риЙрижри╛ри╕, ри╣рй░риЭрйВ, риЪри┐ри╣ри░ри╛
ЁЯШн => ЁЯШн, риЙрй▒риЪрйА риЙрй▒риЪрйА ри░рйЛригри╛, ри╣рй░риЭрйВ, ри░рйЛригри╛, риЪри┐ри╣ри░ри╛
ЁЯШж => ЁЯШж, риири░ри╛ри╛риЬри╝ риЪри┐ри╣ри░ри╛, риЦрйБрй▒ри▓рйЗ риорйВрй░ри╣ риири╛ри▓ риири░ри╛риЬри╝ риЪри┐ри╣ри░ри╛, риири░ри╛риЬри╝ ри╣рйЛригри╛, риЦрйБрй▒ри▓ри┐риЖ риорйВрй░ри╣, риЪри┐ри╣ри░ри╛
ЁЯШз => ЁЯШз, рижрйБрй▒риЦрйА, рижрйБрй▒риЦ ри╣рйЛ ри░ри┐ри╣ри╛, риЪри┐ри╣ри░ри╛
ЁЯШи => ЁЯШи, рибри░ри╛ри╡ригри╛, рибри░ри╛ри╡ригри╛ риЪри┐ри╣ри░ри╛, риЪри┐ри╣ри░ри╛, рибри░, рибри░ри┐риЖ
ЁЯШй => ЁЯШй, риерй▒риХри┐риЖ, риерй▒риХри┐риЖ риЪри┐ри╣ри░ри╛, риЪри┐ри╣ри░ри╛
ЁЯШм => ЁЯШм, римрижри╕рйВри░рид, римрижри╕рйВри░рид риЪри┐ри╣ри░ри╛, риЪри┐ри╣ри░ри╛
ЁЯШ░ => ЁЯШ░, риХри╛ри╣ри▓ри╛ риЪри┐ри╣ри░ри╛, риарй░рибрйЗ рикри╕рйАрйЗриирйЗ риири╛ри▓ риирйАри▓ри╛ риЪри┐ри╣ри░ри╛, риорйВрй░ри╣ риЦрйБрй▒ри▓ри┐риЖ, риарй░рибри╛ рикри╕рйАриири╛, риЪри┐ри╣ри░ри╛, риирйАри▓ри╛, риарй░рибри╛
ЁЯШ▒ => ЁЯШ▒, рибри░ри┐риЖ риЪри┐ри╣ри░ри╛, рибри░ риири╛ри▓ риЪрйАриХригри╛, рибри░ риири╛ри▓ риЪрйАриХ ри░ри┐ри╣ри╛ риЪри┐ри╣ри░ри╛, рибри░, рибри░ри┐риЖ, рибри░ри╛риЙригри╛, риЪри┐ри╣ри░ри╛, риЪрйАриХ
ЁЯШ│ => ЁЯШ│, ринриЦри┐риЖ, риЙри▓риЭриг ри╡ри┐рй▒риЪ, римрйЗриЪри╛ри░ри╛, риЪри┐ри╣ри░ри╛
ЁЯШ╡ => ЁЯШ╡, риЪрй▒риХри░, риЪри┐ри╣ри░ри╛
ЁЯШб => ЁЯШб, риири░ри╛риЬри╝риЧрйА, риЧрйБрй▒ри╕ри╛, рикри╛риЧри▓, ри▓ри╛ри▓ риири░ри╛риЬри╝риЧрйА риЪри┐ри╣ри░ри╛, ри▓ри╛ри▓ риЪри┐ри╣ри░ри╛, риЪри┐ри╣ри░ри╛
ЁЯШа => ЁЯШа, риЧрйБрй▒ри╕рйЗ, рикри╛риЧри▓, риЧрйБрй▒ри╕ри╛ риЪри┐ри╣ри░ри╛, риЪри┐ри╣ри░ри╛
ЁЯШИ => ЁЯШИ, ри╕ри┐рй░риЧри╛риВ риири╛ри▓ риорйБри╕риХри╛рии, риорйБри╕риХри╛рии, ри╕ри┐рй░риЧри╛риВ, риЪри┐ри╣ри░ри╛
ЁЯС┐ => ЁЯС┐, риЫрйЛриЯри╛ ри╕ри╝ридри╛рии, ри╕ри╝ридри╛рии, риЪри┐ри╣ри░ри╛
ЁЯС╣ => ЁЯС╣, ри░ри╛риЦри╕ри╝, рикри░рйА риХри╣ри╛ригрйА, риЬри╛рикри╛риирйА ри░ри╛риЦри╕ри╝, риЪри┐ри╣ри░ри╛
ЁЯС║ => ЁЯС║, ринрйВрид, рижрйИриВрид, рикри░рйА риХри╣ри╛ригрйА, риЬри╛рикри╛риирйА ринрйВрид, риЪри┐ри╣ри░ри╛
ЁЯТА => ЁЯТА, рикри░рйА риХри╣ри╛ригрйА, ри╕ри░рйАри░, риЪри┐ри╣ри░ри╛
тШа => тШа, ри╕ри░рйАри░, риЦри╝ридри░ри╛, риорйМрид, риЪри┐ри╣ри░ри╛, рижрйИриВрид, риЦрйЛрикрйЬрйА, риЦри╝ридри░рйЗ ридрйЛриВ ри╕ри╛ри╡ризри╛рии риХри░риири╛
ЁЯС╗ => ЁЯС╗, рикри░рйА риХри╣ри╛ригрйА, риЪри┐ри╣ри░ри╛, рижрйИриВрид
ЁЯС╜ => ЁЯС╜, риПри▓ри┐риЕрии, римри╛ри╣ри░рйА рижрйБриирйАриЖриВ рипрйВ риПрил риУ, рикри░рйА риХри╣ри╛ригрйА, риЪри┐ри╣ри░ри╛, римри╛ри╣ри░рйА
ЁЯС╛ => ЁЯС╛, риПри▓ри┐риЕрии ринрйВрид, ринрйВрид, рипрйВ риПрил риУ, рикри░рйА риХри╣ри╛ригрйА, риЪри┐ри╣ри░ри╛, риЬрйАри╡
ЁЯдЦ => ЁЯдЦ, риЪри┐ри╣ри░ри╛, рижрйИриВрид, ри░ри╛риЦри╕ри╝, ри░рйЛримрйЛриЯ риЪри┐ри╣ри░ри╛
ЁЯТй => ЁЯТй, риЧрй░рижриЧрйА, риЧрйЛри╣ри╛, риврйЗри░
ЁЯШ║ => ЁЯШ║, риорйБрйБри╕риХри░ри╛риЙриВрижрйА римри┐рй▒ри▓рйА риЪри┐ри╣ри░ри╛, риорйБри╕риХри░ри╛риЙриВрижрйА римри┐рй▒ри▓рйА риЪри┐ри╣ри░ри╛ риири╛ри▓ риЦрйБрй▒ри▓ри┐риЖ риорйВрй░ри╣, римри┐рй▒ри▓рйА, риЪри┐ри╣ри░ри╛, риЦрйБрй▒ри▓рйНри╣ри┐риЖ
ЁЯШ╕ => ЁЯШ╕, риорйБри╕риХри░ри╛риЙриВрижрйА римри┐рй▒ри▓рйА риЪри┐ри╣ри░ри╛, риорйБри╕риХри░ри╛риЙригри╛, ри╡рй▒рибрйА риорйБри╕риХри╛рии римри┐рй▒ри▓рйА риЕридрйЗ ри╣рй▒ри╕рижрйАриЖриВ риЕрй▒риЦри╛риВ, римри┐рй▒ри▓рйА риЪри┐ри╣ри░ри╛, риЪри┐ри╣ри░ри╛
ЁЯШ╣ => ЁЯШ╣, риЦрйБри╕ри╝рйА рижрйЗ ри╣рй░риЭрйВ, риЦрйБри╕ри╝рйА рижрйЗ ри╣рй░риЭрйВриЖриВ риири╛ри▓ римри┐рй▒ри▓рйА риЪри┐ри╣ри░ри╛, римри┐рй▒ри▓рйА, риЪри┐ри╣ри░ри╛, риЦрйБри╕ри╝рйА
ЁЯШ╗ => ЁЯШ╗, риорйБрйБри╕риХри░ри╛риЙриВрижрйА римри┐рй▒ри▓рйА риЪри┐ри╣ри░ри╛, рижри┐ри▓ ри╡ри░риЧрйАриЖриВ риЕрй▒риЦри╛риВ риири╛ри▓ риорйБри╕риХри░ри╛риЙриВрижрйА римри┐рй▒ри▓рйА, рикри┐риЖри░ ри╡ри┐рй▒риЪ, рижри┐ри▓, риЕрй▒риЦри╛риВ, римри┐рй▒ри▓рйА риЪри┐ри╣ри░ри╛, римри┐рй▒ри▓рйА, риЪри┐ри╣ри░ри╛
ЁЯШ╝ => ЁЯШ╝, риорйБри╕риХри░ри╛риЙриВриВрижрйА римри┐рй▒ри▓рйА риЪри┐ри╣ри░ри╛, риори╝рй░рижринри╛риЧрйА риорйБри╕риХри░ри╛ри╣риЯ, римри┐рй▒ри▓рйА риЪри┐ри╣ри░ри╛, римри┐рй▒ри▓рйА, риЪри┐ри╣ри░ри╛
ЁЯШ╜ => ЁЯШ╜, риЪрйБрй░риорижрйА римри┐рй▒ри▓рйА, риЕрй▒риЦри╛риВ римрй░риж, риЪрйБрй░риоригри╛, риЪрйБрй░риорйА, риЕрй▒риЦри╛риВ, римрй░риж, римри┐рй▒ри▓рйА, риЪри┐ри╣ри░ри╛
ЁЯЩА => ЁЯЩА, риерй▒риХри┐риЖ ри╣рйЛриЗриЖ риЪри┐ри╣ри░ри╛, ри╣ри╛риП риУриП ри░рй▒римри╛, риЕри╕ри▓ ри╣рйИри░ри╛рии, римри┐рй▒ри▓рйА, риЪри┐ри╣ри░ри╛
ЁЯШ┐ => ЁЯШ┐, ри░рйЛриВрижрйА римри┐рй▒ри▓рйА риЪри┐ри╣ри░ри╛, ри╣ри╛риП риУриП ри░рй▒римри╛, ри░рйЛригри╛, римри┐рй▒ри▓рйА риЪри┐ри╣ри░ри╛, римри┐рй▒ри▓рйА, риЪри┐ри╣ри░ри╛
ЁЯШ╛ => ЁЯШ╛, риири░ри╛риЬри╝ римри┐рй▒ри▓рйА риЪри┐ри╣ри░ри╛, риири░ри╛риЬри╝, римри┐рй▒ри▓рйА риЪри┐ри╣ри░ри╛, римри┐рй▒ри▓рйА, риЪри┐ри╣ри░ри╛
ЁЯЩИ => ЁЯЩИ, римрйБри░ри╛ риири╛ ри╡рйЗриЦрйЛ римри╛риВрижри░, римри╛риВрижри░
ЁЯЩЙ => ЁЯЩЙ, римрйБри░ри╛ риири╛ ри╕рйБригрйЛ римри╛риВрижри░, римри╛риВрижри░
ЁЯЩК => ЁЯЩК, римрйБрйБри░ри╛ риири╛ римрйЛри▓рйЛ, римрйБри░ри╛ риири╛ римрйЛри▓рйЛ римри╛риВрижри░, римри╛риВрижри░
ЁЯСж => ЁЯСж, ри▓рйЛриХ
ЁЯСз => ЁЯСз, ри▓рйЛриХ, риХрй░риири┐риЖ, ри░ри╛ри╕ри╝рйА риЪрй▒риХри░
ЁЯСи => ЁЯСи, римрй░рижри╛, ри▓рйЛриХ
ЁЯСитАНтЪХ => ЁЯСитАНтЪХ, рибри╛риХриЯри░, ри╕ри┐ри╣рид-ри╕рй░ринри╛ри▓, рикрйБри░ри╕ри╝, римрй░рижри╛, риири░ри╕, риЪри┐риХри┐ридри╕риХ
ЁЯСитАНЁЯОУ => ЁЯСитАНЁЯОУ, риЧри░рйИриЬрйВриПриЯ, рикрйБри░ри╕ри╝, римрй░рижри╛, ри╡ри┐рижри┐риЖри░риерйА
ЁЯСитАНЁЯМ╛ => ЁЯСитАНЁЯМ╛, риХри┐ри╕ри╛рии, риори╛ри▓рйА, рикрйБри░ри╕ри╝, римрй░рижри╛
ЁЯСитАНЁЯН│ => ЁЯСитАНЁЯН│, ри╕ри╝рйИрй▒рил, ри░ри╕рйЛриИриЖ, рикрйБри░ри╕ри╝, римрй░рижри╛
ЁЯСитАНЁЯПл => ЁЯСитАНЁЯПл, ри╕ри┐рй▒риЦри┐риЕриХ, рикрйБри░ри╕ри╝, римрй░рижри╛, рикрйНри░рйЛрилрйИри╕ри░, риЕризри┐риЖрикриХ
ЁЯСитАНЁЯПн => ЁЯСитАНЁЯПн, риЕри╕рйИриВримри▓рйА, рилрйИриХриЯри░рйА, риЙрижрипрйЛриЧри┐риХ, рикрйБри░ри╕ри╝, римрй░рижри╛, риХри╛риори╛
ЁЯСитАНЁЯОи => ЁЯСитАНЁЯОи, риХри▓ри╛риХри╛ри░, рикрйБри░ри╕ри╝, римрй░рижри╛
ЁЯСитАНЁЯЪТ => ЁЯСитАНЁЯЪТ, рилри╛риЗри░рилри╛риИриЯри░, рилри╛риЗри░риЯри░рй▒риХ, рикрйБри░ри╕ри╝, римрй░рижри╛
ЁЯСитАНтЬИ => ЁЯСитАНтЬИ, рикрйБри░ри╕ри╝, римрй░рижри╛, рикри╛риЗри▓риЯ, ри╣ри╡ри╛риИ риЬри╣ри╛риЬри╝
ЁЯСитАНЁЯЪА => ЁЯСитАНЁЯЪА, рикрйБри░ри╕ри╝ рикрйБри▓ри╛рйЬ рипри╛ридри░рйА, рикрйБри░ри╕ри╝, римрй░рижри╛, ри░ри╛риХриЯ, рикрйБри▓ри╛рйЬ
ЁЯСитАНЁЯОд => ЁЯСитАНЁЯОд, риЕрижри╛риХри╛ри░, риори╕риЦри░ри╛, рикрйБри░ри╕ри╝, римрй░рижри╛, риЧри╛риЗриХ, ри╕риЯри╛ри░
ЁЯСитАНЁЯТ╗ => ЁЯСитАНЁЯТ╗, риХрйЛрибри░, ри╡ри┐риХри╛ри╕риХри╛ри░, риХри╛ривриХри╛ри░, рикрйБри░ри╕ри╝, римрй░рижри╛, ри╕ри╛рилриЯри╡рйЗриЕри░, ридриХриири╛ри▓рйЛриЬри┐ри╕риЯ
ЁЯСитАНЁЯФм => ЁЯСитАНЁЯФм, риЬрйАри╡-ри╡ри┐риЧри┐риЖриирйА, риХрйИриори┐ри╕риЯ, риЗрй░риЬрйАриирйАриЕри░, рикрйБри░ри╕ри╝, римрй░рижри╛, ри╣ри┐ри╕ри╛римрижри╛рии, ринрйМридри┐риХ ри╡ри┐риЧри┐риЖриирйА
ЁЯСитАНЁЯТ╝ => ЁЯСитАНЁЯТ╝, риЖри░риХрйАриЯрйИриХриЯ, риХри╛ри░рйЛримри╛ри░, рикрйБри░ри╕ри╝, римрй░рижри╛, риорйИриирйЗриЬри░, рижрилридри░
ЁЯСитАНЁЯФз => ЁЯСитАНЁЯФз, риЗри▓рйИриХриЯрйНри░ри┐ри╕ри╝рии, рикрйБри░ри╕ри╝, римрй░рижри╛, риориХрйИриири┐риХ, рикри▓рй░римри░
ЁЯСитАНтЪЦ => ЁЯСитАНтЪЦ, риЬри╕риЯри┐ри╕, рикрйБри░ри╕ри╝, римрй░рижри╛
ЁЯСй => ЁЯСй, риЬри╝риири╛риирйА, ри▓рйЛриХ
ЁЯСйтАНтЪХ => ЁЯСйтАНтЪХ, рибри╛риХриЯри░, риЗри╕ридри░рйА, ри╕ри┐ри╣рид-ри╕рй░ринри╛ри▓, риири░ри╕, риЪри┐риХри┐ридри╕риХ, риФри░рид
ЁЯСйтАНЁЯОУ => ЁЯСйтАНЁЯОУ, риЗри╕ридри░рйА, риЧри░рйИриЬрйВриПриЯ, ри╡ри┐рижри┐риЖри░риериг, риФри░рид
ЁЯСйтАНЁЯМ╛ => ЁЯСйтАНЁЯМ╛, риЗри╕ридри░рйА риХри┐ри╕ри╛рии, риЗри╕ридри░рйА, риори╛ри▓риг, риФри░рид
ЁЯСйтАНЁЯН│ => ЁЯСйтАНЁЯН│, ри╕ри╝рйИрй▒рил, риЗри╕ридри░рйА ри░ри╕рйЛриИриЖ, риЗри╕ридри░рйА, риФри░рид
ЁЯСйтАНЁЯПл => ЁЯСйтАНЁЯПл, риЗри╕ридри░рйА, ри╕ри┐рй▒риЦри┐риЕриХ, рикрйНри░рйЛрилрйИри╕ри░, риЕризри┐риЖрикриХри╛, риФри░рид
ЁЯСйтАНЁЯПн => ЁЯСйтАНЁЯПн, риЕри╕рйИриВримри▓рйА, рилрйИриХриЯри░рйА, риЗри╕ридри░рйА, риФри░рид, ри╡ри░риХри░
ЁЯСйтАНЁЯОи => ЁЯСйтАНЁЯОи, риЗри╕ридри░рйА риХри▓ри╛риХри╛ри░, риФри░рид, риЗри╕ридри░рйА
ЁЯСйтАНЁЯЪТ => ЁЯСйтАНЁЯЪТ, риЗри╕ридри░рйА рилри╛риЗри░рилри╛риИриЯри░, рилри╛риЗри░риЯри░рй▒риХ, риЗри╕ридри░рйА, риФри░рид
ЁЯСйтАНтЬИ => ЁЯСйтАНтЬИ, риЗри╕ридри░рйА, риФри░рид, риЗри╕ридри░рйАрикри╛риЗри▓риЯ, ри╣ри╡ри╛риИ риЬри╣ри╛риЬри╝
ЁЯСйтАНЁЯЪА => ЁЯСйтАНЁЯЪА, риФри░рид рикрйБри▓ри╛рйЬ рипри╛ридри░рйА, риЗри╕ридри░рйА, риФри░рид, ри░ри╛риХриЯ, рикрйБри▓ри╛рйЬ
ЁЯСйтАНЁЯОд => ЁЯСйтАНЁЯОд, риЕрижри╛риХри╛ри░ри╛, риЗри╕ридри░рйА, риФри░рид, риЧри╛риЗриХри╛
ЁЯСйтАНЁЯТ╗ => ЁЯСйтАНЁЯТ╗, риХрйЛрибри░, ри╡ри┐риХри╛ри╕риХри╛ри░, риХри╛ривриХри╛ри░, риЗри╕ридри░рйА, риФри░рид, ри╕ри╛рилриЯри╡рйЗриЕри░, ридриХриири╛ри▓рйЛриЬри┐ри╕риЯ
ЁЯСйтАНЁЯФм => ЁЯСйтАНЁЯФм, риЬрйАри╡-ри╡ри┐риЧри┐риЖриирйА, риХрйИриори┐ри╕риЯ, риЗрй░риЬрйАриирйАриЕри░, риЗри╕ридри░рйА, риФри░рид, ри╣ри┐ри╕ри╛римрижри╛рии, ринрйМридри┐риХ ри╡ри┐риЧри┐риЖриирйА
ЁЯСйтАНЁЯТ╝ => ЁЯСйтАНЁЯТ╝, риЖри░риХрйАриЯрйИриХриЯ, риХри╛ри░рйЛримри╛ри░, риЗри╕ридри░рйА, риорйИриирйЗриЬри░, рижрилридри░, риФри░рид
ЁЯСйтАНЁЯФз => ЁЯСйтАНЁЯФз, риЗри▓рйИриХриЯрйНри░ри┐ри╕ри╝рии, риЗри╕ридри░рйА, риЗри╕ридри░рйА риориХрйИриири┐риХ, рикри▓рй░римри░, риФри░рид
ЁЯСйтАНтЪЦ => ЁЯСйтАНтЪЦ, риЗри╕ридри░рйА, риЬрй▒риЬ ри╕ри╛ри╣ри┐римри╛, риФри░рид
ЁЯС┤ => ЁЯС┤, ри╡рй▒рибрйА риЙриори░ рижри╛ римрй░рижри╛, римрй░рижри╛, ри╡рй▒рибри╛, ри▓рйЛриХ, римриЬри╝рйБри░риЧ
ЁЯС╡ => ЁЯС╡, ри╡рй▒рибрйА риЙриори░ рижрйА риЬри╝риири╛риирйА, риЬри╝риири╛риирйА, ри╡рй▒рибрйА, ри▓рйЛриХ, римриЬри╝рйБри░риЧ
ЁЯС╢ => ЁЯС╢, римри╛ри▓
ЁЯС▒ => ЁЯС▒, ри╕рйБриири┐ри╣ри░рйА ри╡ри╛ри▓
ЁЯС▒тАНтЩА => ЁЯС▒тАНтЩА, риХрй▒риХрйЗ ри╡ри╛ри▓ри╛риВ ри╡ри╛ри▓рйА риЗри╕ридри░рйА, риЗри╕ридри░рйА, риФри░рид
ЁЯС▒тАНтЩВ => ЁЯС▒тАНтЩВ, риХрй▒риХрйЗ ри╡ри╛ри▓ри╛риВ ри╡ри╛ри▓ри╛ рикрйБри░ри╕ри╝, рикрйБри░ри╕ри╝, римрй░рижри╛
ЁЯСо => ЁЯСо, рикрйБри▓ри┐ри╕, риЕрилри╕ри░, ри▓рйЛриХ
ЁЯСотАНтЩА => ЁЯСотАНтЩА, рикрйБри▓ри┐ри╕ри╡ри╛ри▓рйА, риЗри╕ридри░рйА, риФри░рид, риЕрилри╕ри░, рикрйБри▓ри┐ри╕
ЁЯСотАНтЩВ => ЁЯСотАНтЩВ, рикрйБри▓ри┐ри╕ри╡ри╛ри▓ри╛, рикрйБри░ри╕ри╝, римрй░рижри╛, риЕрилри╕ри░, рикрйБри▓ри┐ри╕
ЁЯС▓ => ЁЯС▓, римрй░рижри╛, риЧрйБриЖ рикри┐ риори╛риУ риири╛ри▓ римрй░рижри╛, риЧрйБриЖ рикри┐ риори╛риУ, ри▓рйЛриХ
ЁЯС│ => ЁЯС│, римрй░рижри╛, рижри╕ридри╛ри░ риири╛ри▓ римрй░рижри╛, рижри╕ридри╛ри░, ри▓рйЛриХ
ЁЯС│тАНтЩА => ЁЯС│тАНтЩА, риЗри╕ридри░рйА, риФри░рид, рикриЧрйЬрйА, рикрй▒риЧ
ЁЯС│тАНтЩВ => ЁЯС│тАНтЩВ, рикрйБри░ри╕ри╝, римрй░рижри╛, рикриЧрйЬрйА, рикрй▒риЧ
ЁЯС╖ => ЁЯС╖, риЙри╕ри╛ри░рйА риориЬри╝рижрйВри░, риЙри╕ри╛ри░рйА, риориЬри╝рижрйВри░, ри▓рйЛриХ
ЁЯС╖тАНтЩА => ЁЯС╖тАНтЩА, риЙри╕ри╛ри░рйА, риЗри╕ридри░рйА, риФри░рид, риЗри╕ридри░рйА ри╡ри░риХри░
ЁЯС╖тАНтЩВ => ЁЯС╖тАНтЩВ, риЙри╕ри╛ри░рйА, рикрйБри░ри╕ри╝, римрй░рижри╛, ри╡ри░риХри░
тЫС => тЫС, ри╕ри╣ри╛риЗридри╛, риХрйНри░ри╛ри╕, риорйИрибрйАриХри▓ ри╕ри╣ри╛риЗридри╛, риЯрйЛрикрйА, ри╣рйИри▓риорйЗриЯ, риЯрйЛрик
ЁЯС╕ => ЁЯС╕, рикри░рйА риХри╣ри╛ригрйА, ри▓рйЛриХ
ЁЯТВ => ЁЯТВ, риЪрйМриХрйАрижри╛ри░ римрй░рижри╛, риЪрйМриХрйАрижри╛ри░, ри▓рйЛриХ
ЁЯТВтАНтЩА => ЁЯТВтАНтЩА, риЗри╕ридри░рйА риЧри╛ри░риб, риЗри╕ридри░рйА, риФри░рид
ЁЯТВтАНтЩВ => ЁЯТВтАНтЩВ, риЧри╛ри░риб, рикрйБри░ри╕ри╝, римрй░рижри╛
ЁЯХ╡ => ЁЯХ╡, риЬри╛ри╕рйВри╕рйА, риЬри╛ри╕рйВри╕, риЬри╛ри╕рйВри╕рйА риЪри┐ри╣ри░ри╛
ЁЯХ╡тАНтЩА => ЁЯХ╡тАНтЩА, риЬри╕рйВри╕, риЗри╕ридри░рйА, риФри░рид
ЁЯХ╡тАНтЩВ => ЁЯХ╡тАНтЩВ, риЬри╕рйВри╕, рикрйБри░ри╕ри╝, римрй░рижри╛
ЁЯОЕ => ЁЯОЕ, ри╕рйИриВриЯри╛, рикри┐ридри╛ риХрйНри░ри┐ри╕риори╕, риХрйНри░ри┐ри╕риори╕, риЬри╕ри╝рии
ЁЯС╝ => ЁЯС╝, рижрйЗри╡рижрйВрид, рикри░рйА риХри╣ри╛ригрйА, риЪри┐ри╣ри░ри╛
ЁЯСп => ЁЯСп, риЦри░риЧрйЛри╕ри╝ риХрйБрйЬрйА, риЦри░риЧрйЛри╕ри╝ рижрйЗ риХрй░рии, риХрйБрйЬрйА, риЬри╝риири╛риирйА, ри▓рйЛриХ, рибри╛риВри╕ри░
ЁЯСптАНтЩА => ЁЯСптАНтЩА, риЦри░риЧрйЛри╕ри╝рйАриЖ риХрй░рии, рибри╛риВри╕ри░, риЗри╕ридри░рйА, риФри░рид, риЬри╕ри╝рии риориири╛риЙригри╛
ЁЯСптАНтЩВ => ЁЯСптАНтЩВ, риЦри░риЧрйЛри╕ри╝рйАриЖ риХрй░рии, рибри╛риВри╕ри░, рикрйБри░ри╕ри╝, римрй░рижри╛, риЬри╕ри╝рии риориири╛риЙригри╛
ЁЯТЖ => ЁЯТЖ, риЪри┐ри╣ри░рйЗ рижрйА риори╛ри▓ри╕ри╝, риори╛ри▓ри╕ри╝, ри╕рйИри▓рйВрии, риори╕ри╛риЬри╝
ЁЯТЖтАНтЩА => ЁЯТЖтАНтЩА, риЪри┐ри╣ри░ри╛, риЗри╕ридри░рйА, риФри░рид, риори╛ри▓ри╕ри╝
ЁЯТЖтАНтЩВ => ЁЯТЖтАНтЩВ, риЪри┐ри╣ри░ри╛, рикрйБри░ри╕ри╝, римрй░рижри╛, риори╛ри▓ри╕ри╝
ЁЯТЗ => ЁЯТЗ, римри╛ри▓ риХриЯри╛риЙригри╛, римри┐риЙриЯрйА рикри╛ри░ри▓ри░, ри╕рйБрй░рижри░ридри╛, рикри╛ри░ри▓ри░
ЁЯТЗтАНтЩА => ЁЯТЗтАНтЩА, ри╡ри╛ри▓ риХриЯри╡ри╛риЙригри╛, риЗри╕ридри░рйА, риФри░рид
ЁЯТЗтАНтЩВ => ЁЯТЗтАНтЩВ, ри╡ри╛ри▓ риХриЯри╡ри╛риЙригри╛, рикрйБри░ри╕ри╝, римрй░рижри╛
ЁЯС░ => ЁЯС░, ри▓ри╛рйЬрйА, риШрйБрй░риб, ри╡ри┐риЖри╣, ри▓рйЛриХ
ЁЯЩН => ЁЯЩН, риири░ри╛риЬри╝риЧрйА, риири░ри╛риЬри╝ ри╡ри┐риЕриХридрйА, ри╡ри┐риЕриХридрйА, ри╕рй░риХрйЗрид
ЁЯЩНтАНтЩА => ЁЯЩНтАНтЩА, ридри┐риЙрйЬрйА риЪрйЬрйНри╣ри╛риЙригри╛, риЗри╕ри╝ри╛ри░ри╛, риЗри╕ридри░рйА, риФри░рид
ЁЯЩНтАНтЩВ => ЁЯЩНтАНтЩВ, ридри┐риЙрйЬрйА риЪрйЬрйНри╣ри╛риЙригри╛, риЗри╕ри╝ри╛ри░ри╛, рикрйБри░ри╕ри╝, римрй░рижри╛
ЁЯЩО => ЁЯЩО, риири░ри╛риЬри╝ри╝риЧрйА, ри╡ри┐риЕриХридрйА риири░ри╛риЬри╝ ри╣рйЛ ри░ри┐ри╣ри╛, ри╡ри┐риЕриХридрйА, ри╕рй░риХрйЗрид
ЁЯЩОтАНтЩА => ЁЯЩОтАНтЩА, риЗри╕ри╝ри╛ри░ри╛, риЗри╕ридри░рйА, риФри░рид, римрйБрй▒ри▓рйНри╣ риХрй▒ривригри╛
ЁЯЩОтАНтЩВ => ЁЯЩОтАНтЩВ, риЗри╕ри╝ри╛ри░ри╛, рикрйБри░ри╕ри╝, римрй░рижри╛, римрйБрй▒ри▓рйНри╣ риХрй▒ривригри╛
ЁЯЩЕ => ЁЯЩЕ, риЪрй░риЧри╛ риири╣рйАриВ ри╕рй░риХрйЗрид, риЪрй░риЧри╛ риири╣рйАриВ, риири╣рйАриВ, риориирйНри╣ри╛ри╣рйА, ри╕рй░риХрйЗрид, риЪри┐ри╣ри░ри╛
ЁЯЩЕтАНтЩА => ЁЯЩЕтАНтЩА, риФри░рид, риориири╛ри╣рйАриЖ, риЗри╕ри╝ри╛ри░ри╛, ри╣рй▒рие, риЗри╕ридри░рйА, риири╣рйАриВ, риарйАриХ риири╣рйАриВ, рикрйНри░ридрйАримрй░ризри┐рид
ЁЯЩЕтАНтЩВ => ЁЯЩЕтАНтЩВ, риориири╛ри╣рйАриЖ, риЗри╕ри╝ри╛ри░ри╛, ри╣рй▒рие, рикрйБри░ри╕ри╝, римрй░рижри╛, риири╣рйАриВ, риарйАриХ риири╣рйАриВ, рикрйНри░ридрйАримрй░ризри┐рид
ЁЯЩЖ => ЁЯЩЖ, OK ри╕рй░риХрйЗрид, ри╕рй▒рин ри╡ризрйАриЖ, ри╕рй░риХрйЗрид, риЪри┐ри╣ри░ри╛
ЁЯЩЖтАНтЩА => ЁЯЩЖтАНтЩА, риФри░рид, риЗри╕ри╝ри╛ри░ри╛, ри╣рй▒рие, риЗри╕ридри░рйА, риарйАриХ
ЁЯЩЖтАНтЩВ => ЁЯЩЖтАНтЩВ, риЗри╕ри╝ри╛ри░ри╛, ри╣рй▒рие, рикрйБри░ри╕ри╝, римрй░рижри╛, риарйАриХ
ЁЯТБ => ЁЯТБ, риЬри╛ригриХри╛ри░рйА рибрйИри╕риХ, риорижриж, риЬри╛ригриХри╛ри░рйА, ри▓рйЛриХ, ри╣рй▒рие
ЁЯТБтАНтЩА => ЁЯТБтАНтЩА, риЗри╕ридри░рйА, риФри░рид, ри╕ри╕рйА, риЖри╕риори╛рии ри╡рй▒ри▓ ри╣риерйЗри▓рйА
ЁЯТБтАНтЩВ => ЁЯТБтАНтЩВ, рикрйБри░ри╕ри╝, римрй░рижри╛, ри╕ри╕рйА, риЖри╕риори╛рии ри╡рй▒ри▓ ри╣риерйЗри▓рйА
ЁЯЩЛ => ЁЯЩЛ, риЦрйБри╕ри╝ ри╡ри┐риЕриХридрйА, ри╣рй▒рие риЪрйБрй▒риХ ри░ри┐ри╣ри╛, ри╡ри┐риЕриХридрйА ри░рй▒рие риЪрйБрй▒риХ ри░ри┐ри╣ри╛, риЦрйБри╕ри╝, ри╡ри┐риЕриХридрйА, ри╕рй░риХрйЗрид
ЁЯЩЛтАНтЩА => ЁЯЩЛтАНтЩА, риФри░рид, риЗри╕ри╝ри╛ри░ри╛, риЗри╕ридри░рйА, ри╣рй▒рие риЙриари╛риЙригри╛
ЁЯЩЛтАНтЩВ => ЁЯЩЛтАНтЩВ, риЗри╕ри╝ри╛ри░ри╛, рикрйБри░ри╕ри╝, римрй░рижри╛, ри╣рй▒рие риЙриари╛риЙригри╛
ЁЯЩЗ => ЁЯЩЗ, риорйИриирйВрй░ риори╛рил риХри░рйЛ, римри╣рйБрид риЭрйБриХри╛риЕ, риорйБриЖрилрйА, риЭрйБрй▒риХригри╛, ри╕рй░риХрйЗрид, ри╡ри┐риЕриХридрйА
ЁЯЩЗтАНтЩА => ЁЯЩЗтАНтЩА, риори╛рилрйА, ри╕ри┐ри░ риЭрйБриХри╛риЙригри╛, риЕри╣ри┐ри╕ри╛рии, риЗри╕ри╝ри╛ри░ри╛, риЗри╕ридри░рйА, риФри░рид, риЕрилри╕рйЛри╕
ЁЯЩЗтАНтЩВ => ЁЯЩЗтАНтЩВ, риори╛рилрйА, ри╕ри┐ри░ риЭрйБриХри╛риЙригри╛, риЕри╣ри┐ри╕ри╛рии, риЗри╕ри╝ри╛ри░ри╛, рикрйБри░ри╕ри╝, римрй░рижри╛, риЕрилри╕рйЛри╕
ЁЯЩМ => ЁЯЩМ, риЦрйБрйБри╕ри╝рйА, риЬри╕ри╝рии ри╡ри┐рй▒риЪ рижрйЛри╡рйЗ ри╣рй▒рие риЙрй▒ридрйЗ риЪрйБрй▒риХ ри░ри┐ри╣, рижрйЛри╡рйЗ ри╣рй▒рие, риЬри╕ри╝рии
ЁЯЩП => ЁЯЩП, риЕри░рижри╛ри╕, риЕри░рижри╛ри╕ риХри░риири╛, ри╣рй▒рие, ри╕рй░риХрйЗрид
ЁЯЧг => ЁЯЧг, риЪри┐ри╣ри░ри╛, ри╕ри┐ри░, рикри░риЫри╛ри╡ри╛риВ, римрйЛри▓ригри╛, римрйЛри▓рижри╛ риЪри┐ри╣ри░ри╛
ЁЯСд => ЁЯСд, риЫри╛ридрйА, римригридри░, ри▓рйЛриХ
ЁЯСе => ЁЯСе, риЫри╛ридрйА, римригридри░, ри▓рйЛриХ
ЁЯЪ╢ => ЁЯЪ╢, рикрйИрижри▓
ЁЯЪ╢тАНтЩА => ЁЯЪ╢тАНтЩА, риЪрй▒ри▓ригри╛, риЗри╕ридри░рйА, риФри░рид, рикрйИрижри▓ ри╕рйИри░
ЁЯЪ╢тАНтЩВ => ЁЯЪ╢тАНтЩВ, риЪрй▒ри▓ригри╛, рикрйБри░ри╕ри╝, римрй░рижри╛, рикрйИрижри▓ ри╕рйИри░
ЁЯПГ => ЁЯПГ, рижрйМрйЬри╛риХ, рижрйМрйЬриири╛, риорйИри░ри╛риерии, риЦрйЗриб
ЁЯПГтАНтЩА => ЁЯПГтАНтЩА, риЗри╕ридри░рйА, риФри░рид, риорйИри░ри╛риерии, рижрйМрйЬриири╛, рижрйМрйЬ
ЁЯПГтАНтЩВ => ЁЯПГтАНтЩВ, рикрйБри░ри╕ри╝, римрй░рижри╛, риорйИри░ри╛риерии, рижрйМрйЬриири╛, рижрйМрйЬ
ЁЯТГ => ЁЯТГ, риири╛риЪ, ри▓рйЛриХ
ЁЯХ┤ => ЁЯХ┤, риХри╛ри░рйЛримри╛ри░, риЖрижриорйА, ри╕рйВриЯ, риХри╛ри░рйЛримри╛ри░рйА, ри╡рикри╛ри░риХ ри╕рйВриЯ
ЁЯТП => ЁЯТП, риЪрйБрй░риорйА ри▓рйИригри╛, ри▓рйЛриХ, рикри┐риЖри░
ЁЯТС => ЁЯТС, риЬрйЛрйЬри╛, рижри┐ри▓ риири╛ри▓ риЬрйЛрйЬри╛, рижри┐ри▓, ри▓рйЛриХ, рикри┐риЖри░
ЁЯСк => ЁЯСк, рикри┐риУ, риори╛риВ, римрй▒риЪри╛, ри▓рйЛриХ
ЁЯСл => ЁЯСл, римрй░рижри╛ риЕридрйЗ риЬри╝риири╛риирйА, риЬрйЛрйЬри╛, ри╣рй▒рие рилрйЬрйЗ ри╣рйЛриП римрй░рижри╛ риЕридрйЗ риЬри╝риири╛риирйА, римрй░рижри╛, риЬри╝риири╛риирйА, ри╣рй▒рие рилрйЬрйЗ ри╣рйЛриП, ри▓рйЛриХ, риори░риж риЕридрйЗ риФри░рид
ЁЯСм => ЁЯСм, рижрйЛ римрй░рижрйЗ, риЬрйЛрйЬри╛, ри╣рй▒рие рилрйЬрйЗ ри╣рйЛриП рижрйЛ римрй░рижрйЗ, римрй░рижри╛, ри╣рй▒рие рилрйЬрйЗ ри╣рйЛриП, ри▓рйЛриХ, риори░риж
ЁЯСн => ЁЯСн, рижрйЛ риЬри╝риири╛риирйАриЖриВ, риЬрйЛрйЬри╛, ри╣рй▒рие рилрйЬрйЗ ри╣рйЛриП рижрйЛ риЬри╝риири╛риирйАриЖриВ, риЬри╝риири╛риирйАриЖриВ, ри╣рй▒рие рилрйЬрйЗ ри╣рйЛриП, ри▓рйЛриХ, риори░риж
ЁЯП╗ => ЁЯП╗, риЗриорйЛриЬрйА ри╕рйЛризриХ, рилри┐риЯриЬрикрйИриЯри░ри┐риХ, риЪриорйЬрйА рижри╛ ри░рй░риЧ, риЯрйЛрии
ЁЯП╝ => ЁЯП╝, риЗриорйЛриЬрйА ри╕рйЛризриХ, рилри┐риЯриЬрикрйИриЯри░ри┐риХ, риЪриорйЬрйА рижри╛ ри░рй░риЧ, риЯрйЛрии
ЁЯП╜ => ЁЯП╜, риЗриорйЛриЬрйА ри╕рйЛризриХ, рилри┐риЯриЬрикрйИриЯри░ри┐риХ, риЪриорйЬрйА рижри╛ ри░рй░риЧ, риЯрйЛрии
ЁЯП╛ => ЁЯП╛, риЗриорйЛриЬрйА ри╕рйЛризриХ, рилри┐риЯриЬрикрйИриЯри░ри┐риХ, риЪриорйЬрйА рижри╛ ри░рй░риЧ, риЯрйЛрии
ЁЯП┐ => ЁЯП┐, риЗриорйЛриЬрйА ри╕рйЛризриХ, рилри┐риЯриЬрикрйИриЯри░ри┐риХ, риЪриорйЬрйА рижри╛ ри░рй░риЧ, риЯрйЛрии
ЁЯТк => ЁЯТк, ри▓риЪрйАри▓рйА риори╛ри╕рикрйЗри╕ри╝рйА, риори╛ри╕рикрйЗри╕ри╝рйА, риориЬри╝римрйВрид, ри▓риЪрйАри▓рйА, риХри╛риори┐риХ
ЁЯСИ => ЁЯСИ, риЦрй▒римрйА риЙриВриЧри▓, риЦрй▒римрйЗ риЗри╕ри╝ри╛ри░ри╛ риЙриВриЧри▓, риЗрй░рибрйИриХри╕ риЙриВриЧри▓, ри╣рй▒рие рикри┐риЫри▓ри╛ рикри╛ри╕ри╛, риЙриВриЧри▓
ЁЯСЙ => ЁЯСЙ, риЗрй░рибрйИриХри╕ риЙриВриЧри▓, ри╕рйВриЪрйА, ри╕ри░рйАри░, ри╣рй▒рие рижри╛ рикри┐риЫри▓ри╛ рикри╛ри╕ри╛
тШЭ => тШЭ, риЙриВриЧри▓, риЗрй░рибрйИриХри╕ риЙриВриЧри▓, риорйИриВ рикри╣ри┐ри▓рйЗ риирй░римри░ тАШридрйЗ ри╣ри╛риВ, риорйИриВ риЬри┐рй▒ридри┐риЖ
ЁЯСЖ => ЁЯСЖ, риЗрй░рибрйИриХри╕ риЙриВриЧри▓, риЙрй▒рикри░ риЗри╕ри╝ри╛ри░ри╛ риЙриВриЧри▓, ри╣рй▒рие рикри┐риЫри▓ри╛ рикри╛ри╕ри╛, риЙриВриЧри▓
ЁЯЦХ => ЁЯЦХ, риЙрй▒рикри░ риЙриВриЧри▓, риЙрй▒рикри░ риЗри╕ри╝ри╛ри░ри╛ риЙриВриЧри▓, ри╣рй▒рие рижри╛ рикри┐риЫри▓ри╛ рикри╛ри╕ри╛, риЙриВриЧри▓
ЁЯСЗ => ЁЯСЗ, риерй▒ри▓рйЗ риЙриВриЧри▓, риерй▒ри▓рйЗ риЗри╕ри╝ри╛ри░ри╛ риЙриВриЧри▓, риЗрй░рибрйИриХри╕ риЙриВриЧри▓, ри╣рй▒рие рикри┐риЫри▓ри╛ рикри╛ри╕ри╛, риЙриВриЧри▓
тЬМ => тЬМ, риХрйИриВриЪрйА, риЬри┐рй▒рид ри╣рй▒рие, риЬри┐рй▒рид, ри╣ри╛риВ
ЁЯЦЦ => ЁЯЦЦ, риЙриВриЧри▓, ри╡ри▓риХрии ри╕ри▓рйВриЯ, ри╕рй░риХрйЗрид риврй░риЧ, ри╕ри▓рйВриЯ риХри░рии рижри╛ риЗрй▒риХ риврй░риЧ
ЁЯдШ => ЁЯдШ, риЙриВриЧри▓, ри╕ри┐рй░риЧ, риЬри┐рй▒рид
ЁЯЦР => ЁЯЦР, риЙриВриЧри▓, ри╣рй▒рие, ри╣рй▒рие ри╡ри┐риЦри╛риЙригри╛
тЬК => тЬК, риЪриЯри╛рии, риЙрй▒риарйА риорйБрй▒риарйА
тЬЛ => тЬЛ, риХри╛риЧриЬри╝, риЙрй▒риари┐риЖ ри╣рй▒рие
ЁЯСК => ЁЯСК, римрй░риж риорйБрй▒риарйА, риорйБрй▒риарйА, ри╣рй▒рие
ЁЯСМ => ЁЯСМ, OKриири┐ри╕ри╝ри╛рии, OK ри╣рй▒рие рижри╛ риири┐ри╕ри╝ри╛рии, OK, ри╣рй▒рие, риири┐ри╕ри╝ри╛рии
ЁЯСН => ЁЯСН, риЕрй░риЧрйВриари╛ риЙрй▒рикри░, риЕрй░риЧрйВриари╛, риЙрй▒рикри░, ри╣рй▒рие, риири┐ри╕ри╝ри╛рии
ЁЯСО => ЁЯСО, риЕрй░риЧрйВрйВриари╛ риерй▒ри▓рйЗ, риЕрй░риЧрйВриарйЗ, риерй▒ри▓рйЗ, ри╣рй▒рие, риири┐ри╕ри╝ри╛рии
ЁЯСЛ => ЁЯСЛ, ри╣рй▒рие ри▓ри╣ри┐ри░ри╛риЙригри╛, ри╣рй▒рие, ри▓ри╣ри┐ри░ри╛риЙригри╛
ЁЯСП => ЁЯСП, ри╣рй▒рие ридри╛рйЬрйА, ри╣рй▒рие, ридри╛рйЬрйА, риири┐ри╕ри╝ри╛рии
ЁЯСР => ЁЯСР, риЦрйБрй▒ри▓рйНри╣рйЗ ри╣рй▒рие рижри╛ риири┐ри╕ри╝ри╛рии, ри╣рй▒рие, риЦрйБрй▒ри▓рйНри╣ри╛, риири┐ри╕ри╝ри╛рии
тЬН => тЬН, ри╣рй▒рие, ри▓ри┐риЦригри╛, ри▓ри┐риЦри╛ри╡риЯ, ри▓ри┐риЦриг ри╡ри╛ри▓ри╛ ри╣рй▒рие
ЁЯТЕ => ЁЯТЕ, риири╣рйБрй░ рижрйА рижрйЗриЦринри╛ри▓, риорйИриирйАриХри┐риУри░, риири╣рйБрй░ рикри╛ри▓ри╕ри╝, ри╕ри╝ри┐рй░риЧри╛ри░ ри╕риори╛рии
ЁЯСВ => ЁЯСВ, ри╕ри░рйАри░
ЁЯСГ => ЁЯСГ, риЪри┐ри╣ри░ри╛, ри╕ри░рйАри░
ЁЯСг => ЁЯСг, рикрйИрйЬри╛риВ, риири┐ри╕ри╝ри╛рии, ри╕ри░рйАри░
ЁЯСА => ЁЯСА, риЪри┐ри╣ри░ри╛
ЁЯСБ => ЁЯСБ, риириЬри╝ри░
ЁЯСБтАНЁЯЧи => ЁЯСБтАНЁЯЧи, риЕрй▒риЦ, ри╕рикрйАриЪ римримри▓, риЧри╡ри╛ри╣
ЁЯСЕ => ЁЯСЕ, риЪри┐ри╣ри░ри╛, ри╕ри░рйАри░
ЁЯСД => ЁЯСД, риорйБрй░ри╣, римрйБрй▒ри▓рйНри╣, риЪри┐ри╣ри░ри╛
ЁЯТЛ => ЁЯТЛ, римрйБрй▒ри▓рйНри╣, риЪрйБрй░риорйА, рикри┐риЖри░
ЁЯТШ => ЁЯТШ, рижри┐ри▓ риЕридрйЗ ридрйАри░, рижри┐ри▓, ридрйАри░, рикри┐риЖри░, риЬриЬри╝римри╛рид
тЭд => тЭд, рижри┐ри▓, рикри┐риЖри░
ЁЯТУ => ЁЯТУ, ризрйЬриХрижри╛, ризрйЬриХригри╛, рижри┐ри▓, рикри┐риЖри░, риЬриЬри╝римри╛рид
ЁЯТФ => ЁЯТФ, рижри┐ри▓ ридрйЛрйЬриири╛, риЯрйБрй▒риЯри┐риЖ ри╣рйЛриЗриЖ рижри┐ри▓, риЯрйБрй▒риЯригри╛, рижри┐ри▓ риЯрйБриЯри┐риЖ ри╣рйЛриЗриЖ, риЬриЬри╝римри╛рид
ЁЯТХ => ЁЯТХ, рикрйНри░рйЗриорйА, рикри┐риЖри░, риЬриЬри╝римри╛рид
ЁЯТЦ => ЁЯТЦ, риЙридри╕ри╝ри╛ри╣ри┐рид, риЪриориХрижри╛, рикри┐риЖри░, риЬриЬри╝римри╛рид
ЁЯТЧ => ЁЯТЧ, ри╡ризрижри╛ рижри┐ри▓, римрйЗриЪрйИрии, риЙридри╕ри╝ри╛ри╣ри┐рид, рижри┐ри▓, рикри┐риЖри░, риЬриЬри╝римри╛рид
ЁЯТЩ => ЁЯТЩ, риирйАри▓ри╛, рижри┐ри▓, риЬриЬри╝римри╛рид
ЁЯТЪ => ЁЯТЪ, ри╣ри░ри╛, рижри┐ри▓, риЬриЬри╝римри╛рид
ЁЯТЫ => ЁЯТЫ, рикрйАри▓ри╛, рижри┐ри▓, риЬриЬри╝римри╛рид
ЁЯТЬ => ЁЯТЬ, риЬри╛риориирйА, рижри┐ри▓, риЬриЬри╝римри╛рид
ЁЯТЭ => ЁЯТЭ, рижри┐ри▓, ри░ри┐римрии, ри╡рйИри▓рйЗриириЯри╛риИрии, риЬриЬри╝римри╛рид
ЁЯТЮ => ЁЯТЮ, рижри┐ри▓, риШрйБрй░риорижри╛, ри╕рйЛри╣ригри╛, рикри┐риЖри░, ри╕ридри┐риХри╛ри░рипрйЛриЧ, риЬриЬри╝римри╛рид
ЁЯТЯ => ЁЯТЯ, рижри┐ри▓
тЭг => тЭг, ри╣рйИри░ри╛риирйАри╡ри╛риЪриХ риЪри┐рй░риирйНри╣, рижри┐ри▓, риЪри┐рй░риирйНри╣, ри╡ри┐ри░ри╛рио риЪри┐рй░риирйНри╣
ЁЯТМ => ЁЯТМ, рикри┐риЖри░ рижри╛ риЦрй▒рид, рижри┐ри▓ риири╛ри▓ риЪри┐рй▒риарйА, риЦрй▒рид, рижри┐ри▓, рикри┐риЖри░
ЁЯТд => ЁЯТд, ри╕рйБри╕рид, Zzz, ри╕рйМригри╛, риХри╛риори┐риХ, риЬриЬри╝римри╛рид
ЁЯТв => ЁЯТв, риЧрйБрй▒ри╕ри╛, риЧрйБрй▒ри╕рйЗ рижри╛ риири┐ри╕ри╝ри╛рии, риЧрйБрй▒ри╕рйЗ, риХри╛риори┐риХ, риЬриЬри╝римри╛рид
ЁЯТг => ЁЯТг, риХри╛риори┐риХ, риЬриЬри╝римри╛рид
ЁЯТе => ЁЯТе, риЯрй▒риХри░, риЯрй▒риХри░ рижрйА риири┐ри╕ри╝ри╛рии, риХри╛риори┐риХ, риЬриЬри╝римри╛рид
ЁЯТж => ЁЯТж, риорйБрйЬрйНри╣риХри╛ риЫри┐рйЬриХригри╛, риорйБрйЬрйНри╣риХри╛, рикри╕рйАриири╛, риХри╛риори┐риХ, риЬриЬри╝римри╛рид
ЁЯТи => ЁЯТи, риЪри▓рижри╛ рибрйИри╕ри╝, ринрй▒риЬригри╛, риЪрй▒ри▓ригри╛, риХри╛риори┐риХ, риЬриЬри╝римри╛рид
ЁЯТл => ЁЯТл, риЪрй▒риХри░, ридри╛ри░рйЗ рижрйЗриЦригри╛, ридри╛ри░рйЗ, риХри╛риори┐риХ, риЬриЬри╝римри╛рид
ЁЯТм => ЁЯТм, ринри╛ри╕ри╝риг риЧрйБримри╛ри░ри╛, ринри╛ри╕ри╝риг римрйБри▓римрйБри▓ри╛, риЧрй▒ри▓-римри╛рид римрйБри▓римрйБри▓ри╛, риЧрйБримри╛ри░ри╛, римрйБри▓римрйБри▓ри╛, риЧрй▒ри▓-римри╛рид, риХри╛риори┐риХ
ЁЯЧи => ЁЯЧи, ри╡ри╛ри░ридри╛ри▓ри╛рик, римрйЛри▓рйА, ри╡ри┐риЪри╛ри░-риЪри░риЪри╛
ЁЯЧп => ЁЯЧп, риЧрйБрй▒ри╕ри╛ ри╣рйЛригри╛, риЧрйБримри╛ри░ри╛, римримри▓, рикри╛риЧри▓
ЁЯТн => ЁЯТн, ри╡ри┐риЪри╛ри░ риЧрйБримри╛ри░ри╛, ри╡ри┐риЪри╛ри░ римрйБри▓римрйБри▓ри╛, ри╡ри┐риЪри╛ри░, римрйБри▓римрйБри▓ри╛, риХри╛риори┐риХ
ЁЯХ│ => ЁЯХ│, риорйЛри░рйА
ЁЯСУ => ЁЯСУ, риРриириХ, ри▓ри┐римри╛ри╕
ЁЯХ╢ => ЁЯХ╢, риХри╛ри▓ри╛, риЕрй▒риЦ, риРриириХри╛риВ
ЁЯСФ => ЁЯСФ, ри▓ри┐римри╛ри╕
ЁЯСХ => ЁЯСХ, риХриорйАриЬри╝, ри▓ри┐римри╛ри╕
ЁЯСЦ => ЁЯСЦ, рикриЬри╛риори╛, риЬрйАрии, рикрйИриВриЯ, ри▓ри┐римри╛ри╕
ЁЯСЧ => ЁЯСЧ, рикри╣ри┐ри░ри╛ри╡ри╛, риЗрй▒риХ
ЁЯСШ => ЁЯСШ, рикри╣ри┐ри░ри╛ри╡ри╛, ри▓ри┐римри╛ри╕
ЁЯСЩ => ЁЯСЩ, римри╛риери┐рй░риЧ ри╕рйВриЯ, ри▓ри┐римри╛ри╕
ЁЯСЪ => ЁЯСЪ, риХрй▒рикрйЬрйЗ, ри▓ри┐римри╛ри╕
ЁЯСЫ => ЁЯСЫ, рикри░ри╕, ри╕ри┐рй▒риХрйЗ ри▓риИ рикри░ри╕, ри╕ри┐рй▒риХри╛, ри▓ри┐римри╛ри╕
ЁЯСЬ => ЁЯСЬ, ри╣рй▒рие римрйИриЧ, римрйИриЧ, ри▓ри┐римри╛ри╕
ЁЯСЭ => ЁЯСЭ, риерйИри▓рйА, римрйИриЧ, ри▓ри┐римри╛ри╕
ЁЯЫН => ЁЯЫН, римрйИриЧ, ри╣рйЛриЯри▓, риЦри░рйАрижрижри╛ри░рйА
ЁЯОТ => ЁЯОТ, римрйИриЧ, ри╕риХрйВри▓
ЁЯСЮ => ЁЯСЮ, риЖрижриорйА ри▓риИ римрйВриЯ, римрйВриЯ, ри▓ри┐римри╛ри╕
ЁЯСЯ => ЁЯСЯ, риЕриери▓рйИриЯри┐риХ римрйВриЯ, ри╕риирйАриХри░ римрйВриЯ, ри▓ри┐римри╛ри╕
ЁЯСа => ЁЯСа, риЙрй▒риЪ-риЕрй▒рибрйА, римрйВриЯ, ри▓ри┐римри╛ри╕, риФри░рид
ЁЯСб => ЁЯСб, риФри░рид ри▓риИ ри╕рйИриВрибри▓, ри╕рйИриВрибри▓, риФри░рид, ри▓ри┐римри╛ри╕
ЁЯСв => ЁЯСв, риФри░ридри╛риВ ри▓риИ римрйВриЯ, римрйВриЯ, риФри░рид, ри▓ри┐римри╛ри╕
ЁЯСС => ЁЯСС, ри░ри╛риЬ, ри▓ри┐римри╛ри╕, ри░ри╛ригрйА
ЁЯСТ => ЁЯСТ, риФри░ридри╛риВ рижрйА риЯрйЛрикрйА, риЯрйЛрикрйА, ри▓ри┐римри╛ри╕, риФри░рид
ЁЯОй => ЁЯОй, риЯрйЛрикрйА, риХрй▒рикрйЬрйЗ, риЯрйЛрик, риЯрйЛрикри╣рйИриЯ
ЁЯОУ => ЁЯОУ, риЧрйНри░рйИриЬрйВриПри╕ри╝рии риХрйИрик, риХрйИрик, риЧрйНри░рйИриЬрйВриПри╕ри╝рии, риЬри╕ри╝рии, риЯрйЛрикрйА
ЁЯУ┐ => ЁЯУ┐, риорйЛридрйА, риХрй▒рикрйЬрйЗ, риори╛ри▓ри╛, рикрйНри░ри╛ри░риериири╛, риЕри░рижри╛ри╕, ризри░рио
ЁЯТД => ЁЯТД, ри╕рйБри░риЦрйА, ри╕ри╝ри┐рй░риЧри╛ри░, ри╕ри╝ри┐рй░риЧри╛ри░ ри╕риори╛рии
ЁЯТН => ЁЯТН, рикри┐риЖри░
ЁЯТО => ЁЯТО, ри╣рйАри░ри╛, ри╣рйАри░ри╛ рикрй▒риери░, ри╣рйАри░, рикри┐риЖри░
ЁЯР╡ => ЁЯР╡, римри╛риВрижри░, риЪри┐ри╣ри░ри╛, риЬри╛риири╡ри░
ЁЯРТ => ЁЯРТ, римри╛риВрижри░, риЬри╛риири╡ри░
ЁЯР╢ => ЁЯР╢, риХрйБрй▒ридри╛, риЪри┐ри╣ри░ри╛, риЬри╛риири╡ри░
ЁЯРХ => ЁЯРХ, риЧрйБри▓ри░, риЬри╛риири╡ри░
ЁЯРй => ЁЯРй, рикрйВрибри▓, риХрйБрй▒ридри╛, риЬри╛риири╡ри░
ЁЯР║ => ЁЯР║, римриШри┐риЖрйЬ, риЪри┐ри╣ри░ри╛, риЬри╛риири╡ри░
ЁЯР▒ => ЁЯР▒, римри┐рй▒ри▓рйА, риЪри┐ри╣ри░ри╛, риЬри╛риири╡ри░
ЁЯРИ => ЁЯРИ, риЬри╛риири╡ри░
ЁЯжБ => ЁЯжБ, риЪри┐ри╣ри░ри╛, ри╕ри┐рй░риЧ, ри╕ри╝рйЗри░, ри░ри╛ри╕ри╝рйА риЪрй▒риХри░
ЁЯРп => ЁЯРп, риЪрйАридри╛, риЬри╛риири╡ри░
ЁЯРЕ => ЁЯРЕ, риЬри╛риири╡ри░
ЁЯРЖ => ЁЯРЖ, ридрйЗриВрижрйБриЖ, риЬри╛риири╡ри░
ЁЯР┤ => ЁЯР┤, риШрйЛрйЬри╛, риЪри┐ри╣ри░ри╛, риЬри╛риири╡ри░
ЁЯРО => ЁЯРО, риШрйЛрйЬри╛, риЬри╛риири╡ри░, ри░рйЗри╕ри┐рй░риЧ, риШрйБрйЬрижрйМрйЬ ри╡ри╛ри▓ри╛ риШрйЛрйЬри╛
ЁЯжД => ЁЯжД, риЪри┐ри╣ри░ри╛, рипрйВриирйАриХрйЛри░рии
ЁЯРо => ЁЯРо, риЧри╛риВ, риЪри┐ри╣ри░ри╛, риЬри╛риири╡ри░
ЁЯРВ => ЁЯРВ, риЬри╛риири╡ри░
ЁЯРГ => ЁЯРГ, рикри╛ригрйА ри╡ри╛ри▓рйА риорй▒риЭ, рикри╛ригрйА, риЬри╛риири╡ри░
ЁЯРД => ЁЯРД, риЬри╛риири╡ри░
ЁЯР╖ => ЁЯР╖, ри╕рйВри░, риЪри┐ри╣ри░ри╛, риЬри╛риири╡ри░
ЁЯРЦ => ЁЯРЦ, риЬри╛риири╡ри░
ЁЯРЧ => ЁЯРЧ, ри╕рйВри░, риЬри╛риири╡ри░
ЁЯР╜ => ЁЯР╜, риирй▒риХ, ри╕рйВри░, риЪри┐ри╣ри░ри╛, риЬри╛риири╡ри░
ЁЯРП => ЁЯРП, ри░ри╛рио, риЬри╛риири╡ри░, риорйЗриЦ, ри░ри╛ри╕ри╝рйА риЪрй▒риХри░
ЁЯРС => ЁЯРС, ринрйЗриб, риЬри╛риири╡ри░
ЁЯРР => ЁЯРР, риЬри╛риири╡ри░, риорй▒риХри░, ри░ри╛ри╕ри╝рйА риЪрй▒риХри░
ЁЯРк => ЁЯРк, риЗрй▒риХ риХрйБрй▒римри╛ ри╡ри╛ри▓ри╛ риКрй▒риа, риХрйБрй▒рим, риЙрй▒риа, риЬри╛риири╡ри░
ЁЯРл => ЁЯРл, рижрйЛ риХрйБрй▒рим ри╡ри╛ри▓ри╛ риЙрй▒риа, риЙрй▒риа, риЬри╛риири╡ри░, риХрйБрй▒рим
ЁЯРШ => ЁЯРШ, риЬри╛риири╡ри░
ЁЯРн => ЁЯРн, риЪрйВри╣ри╛, риЪри┐ри╣ри░ри╛, риЬри╛риири╡ри░
ЁЯРБ => ЁЯРБ, риЪрйВри╣ри╛, риЬри╛риири╡ри░
ЁЯРА => ЁЯРА, риЪрйВри╣ри╛, риЬри╛риири╡ри░
ЁЯР╣ => ЁЯР╣, риЪрйВри╣рйЗ рижри╛ риЪри┐ри╣ри░ри╛, риЪрйВри╣ри╛, риЪри┐ри╣ри░ри╛, риЬри╛риири╡ри░
ЁЯР░ => ЁЯР░, риЪри┐ри╣ри░ри╛, риЬри╛риири╡ри░
ЁЯРЗ => ЁЯРЗ, риЦри░риЧрйЛри╕ри╝, риЬри╛риири╡ри░
ЁЯР┐ => ЁЯР┐, риЙрй▒ридри░рйА риЕриори░рйАриХри╛ рижрйА риХри╛риЯрйЛ, риХри╛риЯрйЛ
ЁЯР╗ => ЁЯР╗, ринри╛ри▓рйВ, риЪри┐ри╣ри░ри╛, риЬри╛риири╡ри░
ЁЯРи => ЁЯРи, ринри╛ри▓рйВ, риЬри╛риири╡ри░
ЁЯР╝ => ЁЯР╝, рикри╛риВрибри╛, риЪри┐ри╣ри░ри╛, риЬри╛риири╡ри░
ЁЯР╛ => ЁЯР╛, рикри╣рйБрй░риЪри╛, рикри╣рйБрй░риЪрйЗ рижрйА риЫри╛рик, риЫри╛рик, риЬри╛риири╡ри░, рикрйНри░ри┐рй░риЯ, рикрйИри░
ЁЯжГ => ЁЯжГ, риЬри╛риири╡ри░
ЁЯРФ => ЁЯРФ, риЬри╛риири╡ри░
ЁЯРУ => ЁЯРУ, риЬри╛риири╡ри░
ЁЯРг => ЁЯРг, риЕри╛риВрибрйЗ ри╡ри┐рй▒риЪрйЛриВ риири┐риХри▓рижри╛ риЪрйВриЪри╛, риЪрйВриЪри╛, риЕри╛риВрибрйЗ ри╡ри┐рй▒риЪрйЛриВ риири┐риХри▓риири╛, римрй▒риЪри╛, риорйАриЯ, риЬри╛риири╡ри░
ЁЯРд => ЁЯРд, риЪрйВриЪри╛, римрй▒риЪри╛, риорйАриЯ, риЬри╛риири╡ри░
ЁЯРе => ЁЯРе, риЪрйВриЪри╛, ридрйБри╣ри╛рибрйЗ ри╡рй▒ри▓ рижрйЗриЦрижри╛ риЪрйВриЪри╛, римрй▒риЪри╛, риорйАриЯ, риЬри╛риири╡ри░
ЁЯРж => ЁЯРж, риЬри╛риири╡ри░
ЁЯРз => ЁЯРз, риЬри╛риири╡ри░
ЁЯХК => ЁЯХК, рикрй░риЫрйА, риЙрй▒рибригри╛, риЕриории
ЁЯР╕ => ЁЯР╕, рибрй▒рибрйВ, риЪри┐ри╣ри░ри╛, риЬри╛риири╡ри░
ЁЯРК => ЁЯРК, риЬри╛риири╡ри░
ЁЯРв => ЁЯРв, риЬри╛риири╡ри░
ЁЯРН => ЁЯРН, риЬри╛риири╡ри░
ЁЯР▓ => ЁЯР▓, рибрйНри░рйИриЧрии, риЪри┐ри╣ри░ри╛, риЬри╛риири╡ри░
ЁЯРЙ => ЁЯРЙ, риЬри╛риири╡ри░
ЁЯР│ => ЁЯР│, ри╕рикри╛риЙриЯри┐рй░риЧ ри╡рйЗри▓рйНри╣, ри╕рикри╛риЙриЯри┐рй░риЧ, ри╡рйЗри▓рйНри╣, риЬри╛риири╡ри░
ЁЯРЛ => ЁЯРЛ, риЬри╛риири╡ри░
ЁЯРм => ЁЯРм, риЬри╛риири╡ри░
ЁЯРЯ => ЁЯРЯ, риЬри╛риири╡ри░
ЁЯРа => ЁЯРа, риорй▒риЫрйА, риЬри╛риири╡ри░
ЁЯРб => ЁЯРб, римри▓рйЛрилри┐ри╕ри╝, риорй▒риЫрйА, риЬри╛риири╡ри░
ЁЯРЩ => ЁЯРЩ, риЬри╛риири╡ри░
ЁЯРЪ => ЁЯРЪ, риШрйЛриЧри╛, риЬри╛риири╡ри░
ЁЯжА => ЁЯжА, риХри░риХ, ри░ри╛ри╕ри╝рйА риЪрй▒риХри░
ЁЯРМ => ЁЯРМ, риЬри╛риири╡ри░
ЁЯРЫ => ЁЯРЫ, риЦриЯриори▓, риХрй░риириЦриЬрйВри░ри╛, риЬри╛риири╡ри░
ЁЯРЬ => ЁЯРЬ, риЬри╛риири╡ри░
ЁЯРЭ => ЁЯРЭ, риорй▒риЦрйА, риЬри╛риири╡ри░
ЁЯРЮ => ЁЯРЮ, риори╛рижри╛ риЦриЯриори▓, риори╛рижри╛, риЬри╛риири╡ри░
ЁЯХ╖ => ЁЯХ╖, риХрйАрйЬри╛, риХри┐ри░рио
ЁЯХ╕ => ЁЯХ╕, риорй▒риХрйЬрйА, риЬри╛ри▓ри╛
ЁЯжВ => ЁЯжВ, ри╕риХри╛ри░рикрйАриУ, ри╕риХри╛ри░рикрйАриЕри╕, ри░ри╛ри╕ри╝рйА риЪрй▒риХри░
ЁЯТР => ЁЯТР, рилрйБрй▒ри▓, рикри┐риЖри░
ЁЯМ╕ => ЁЯМ╕, риЪрйИри░рйА, рилрйБрй▒ри▓ рижрйЗриЦригри╛, рилрйБрй▒ри▓
ЁЯТо => ЁЯТо, рилрйБрй▒ри▓ риорйЛри╣ри░, ри╡ризрйАриЖ риорйЛри╣ри░, рилрйБрй▒ри▓, риорйЛри╣ри░
ЁЯП╡ => ЁЯП╡, римрйВриЯри╛
ЁЯМ╣ => ЁЯМ╣, рилрйБрй▒ри▓
ЁЯМ║ => ЁЯМ║, риЧрйБрйБрйЬри╣ри▓, рилрйБрй▒ри▓
ЁЯМ╗ => ЁЯМ╗, рилрйБрй▒ри▓
ЁЯМ╝ => ЁЯМ╝, рилрйБрй▒ри▓
ЁЯМ╖ => ЁЯМ╖, рилрйБрй▒ри▓
тШШ => тШШ, римрйВриЯри╛, ридри┐рй░рии рикрй▒ридри┐риЖриВ ри╡ри╛ри▓рйА риШри╛ри╣
ЁЯМ▒ => ЁЯМ▒, риЬри╡ри╛рии, римрйВриЯри╛
ЁЯМ▓ => ЁЯМ▓, ри╕рижри╛римри╣ри╛ри░ ри░рйБрй▒риЦ, ри░рйБрй▒риЦ
ЁЯМ│ => ЁЯМ│, риЭри╛рйЬ рижрйЗ ри░рйБрй▒риЦ, риЭри╛рйЬ, ри░рйБрй▒риЦ
ЁЯМ┤ => ЁЯМ┤, рикри╛рио рижрйЗ ри░рйБрй▒риЦ, рикри╛рио, ри░рйБрй▒риЦ
ЁЯМ╡ => ЁЯМ╡, римрйВриЯри╛
ЁЯМ╛ => ЁЯМ╛, риЪрйМри▓ рижри╛ ри╕ри┐рй▒риЯри╛, риЪрйМри▓, ри╕ри┐рй▒риЯри╛
ЁЯМ┐ => ЁЯМ┐, рикрй▒ридри╛
ЁЯНА => ЁЯНА, риЪри╛ри░ рикрй▒ридри╛ ри▓рйМриВриЧ, риЪри╛ри░, рикрй▒ридри╛, ри▓рйМриВриЧ, ри╕рйБринри╛риЧри╛, римрйВриЯри╛
ЁЯНБ => ЁЯНБ, рикрй▒ридри╛ рибри┐рй▒риЧригри╛, рикрй▒ридри╛, римрйВриЯри╛
ЁЯНВ => ЁЯНВ, рикрй▒ридрйЗ риЭрйЬриири╛, рикрй▒ридрйЗ рибри┐рй▒риЧригри╛, риЭрйЬриири╛, рибри┐риЧригри╛, рикрй▒ридри╛, рикрй▒ридрйЗ, римрйВриЯри╛
ЁЯНГ => ЁЯНГ, ри╣ри╡ри╛ ри╡ри┐рй▒риЪ рикрй▒ридри╛, ри╣ри╡ри╛ ри╡риЧригри╛, рикрй▒ридри╛, ри╣ри╡ри╛, ри╡риЧригри╛, римрйВриЯри╛
ЁЯНЗ => ЁЯНЗ, рилри▓, римрйВриЯри╛
ЁЯНИ => ЁЯНИ, рилри▓, римрйВриЯри╛
ЁЯНЙ => ЁЯНЙ, рилри▓, римрйВриЯри╛
ЁЯНК => ЁЯНК, ри╕рй░ридри░ри╛, рилри▓, римрйВриЯри╛
ЁЯНЛ => ЁЯНЛ, рилри▓, римрйВриЯри╛
ЁЯНМ => ЁЯНМ, рилри▓, римрйВриЯри╛
ЁЯНН => ЁЯНН, рилри▓, римрйВриЯри╛
ЁЯНО => ЁЯНО, ри╕рйЗрим, ри▓ри╛ри▓, рилри▓, римрйВриЯри╛
ЁЯНП => ЁЯНП, ри╕рйЗрим, ри╣ри░ри╛, рилри▓, римрйВриЯри╛
ЁЯНР => ЁЯНР, риири╛ри╕ри╝рикри╛ридрйА, рилри▓, римрйВриЯри╛
ЁЯНС => ЁЯНС, рилри▓, римрйВриЯри╛
ЁЯНТ => ЁЯНТ, рилри▓, римрйВриЯри╛
ЁЯНУ => ЁЯНУ, римрйЗри░рйА, рилри▓, римрйВриЯри╛
ЁЯНЕ => ЁЯНЕ, ри╕римриЬри╝рйА
ЁЯНЖ => ЁЯНЖ, римрйИриВриЧриг рижри╛ римрйВриЯри╛, ри╕римриЬри╝рйА
ЁЯМ╜ => ЁЯМ╜, ри╕ри┐рй▒риЯри╛, римрйВриЯри╛
ЁЯМ╢ => ЁЯМ╢, ридри┐рй▒риЦрйА, риори┐ри░риЪ, римрйВриЯри╛
ЁЯНД => ЁЯНД, римрйВриЯри╛
ЁЯМ░ => ЁЯМ░, римрйВриЯри╛
ЁЯНЮ => ЁЯНЮ, ри░рйЛриЯрйА, риири╛рии, ри╣рйЛриЯри▓
ЁЯзА => ЁЯзА, рикриирйАри░
ЁЯНЦ => ЁЯНЦ, риорйАриЯ, ри╣рйЛриЯри▓
ЁЯНЧ => ЁЯНЧ, риорйБри░риЧрйЗ рижрйА ри▓рй▒рид, рикрйЛри▓риЯри░рйА, ри▓рй▒рид, ри╣рйЛриЯри▓
ЁЯНФ => ЁЯНФ, римри░риЧри░, ри╣рйЛриЯри▓
ЁЯНЯ => ЁЯНЯ, ридрйЬриХри╛, рилрйНри░рйИриВриЪ ридрйЬриХри╛, ри╣рйЛриЯри▓
ЁЯНХ => ЁЯНХ, рикрйАриЬри╝ри╛ риЯрйБриХрйЬри╛, риЯрйБриХрйЬри╛, ри╣рйЛриЯри▓
ЁЯМн => ЁЯМн, риЬри╛риири╡ри░ри╛риВ рижри╛ риорйАриЯ, риорйАриЯ
ЁЯМо => ЁЯМо, риорйИриХри╕рйАриХрии риЦри╛ригри╛
ЁЯМп => ЁЯМп, риорйИриХри╕рйАриХрии риЦри╛ригри╛
ЁЯН┐ => ЁЯН┐, рилрйБрй▒ри▓рйЗ, риорй▒риХрйА рижрйЗ рижри╛ригрйЗ
ЁЯН▓ => ЁЯН▓, ри╕риЯрйАриЙ, римри░ридрии ринрйЛриЬрии, ри╣рйЛриЯри▓
ЁЯН▒ => ЁЯН▒, римрйЗриВриЯрйЛ, римри╛риХри╕, ри╣рйЛриЯри▓
ЁЯНШ => ЁЯНШ, риЪрйМри▓
ЁЯНЩ => ЁЯНЩ, риЪрйМри▓, ри╣рйЛриЯри▓
ЁЯНЪ => ЁЯНЪ, римригрйЗ ри╣рйЛриП риЪрйМри▓, риЪрйМри▓, ри╣рйЛриЯри▓
ЁЯНЫ => ЁЯНЫ, риХрйЬрйНри╣рйА, риЪрйМри▓, ри╣рйЛриЯри▓
ЁЯНЬ => ЁЯНЬ, риирйВрибри▓риЬри╝, риирйВрибри▓риЬри╝ рижри╛ римри╛риЯри╛, риирйВрибри▓, рикриХри╛риЙригри╛, римри╛риЯри╛, ри╣рйЛриЯри▓
ЁЯНЭ => ЁЯНЭ, рикри╛ри╕ридри╛, ри╣рйЛриЯри▓
ЁЯНа => ЁЯНа, ринрйБриири┐риЖ риЖри▓рйВ, ри╕ри╝риХри░риЧрй░рижрйА, ринрйБриири┐риЖ риори┐рй▒риари╛ риЖри▓рйВ, риори┐рй▒риари╛, ринрйБриири┐риЖ, ри╣рйЛриЯри▓
ЁЯНв => ЁЯНв, ри╕риорйБрй░рижри░рйА ринрйЛриЬрии рибрй░рибрйА ридрйЗ, ри╕риорйБрй░рижри░рйА ринрйЛриЬрии, рибрй░рибрйА, ри╣рйЛриЯри▓
ЁЯНг => ЁЯНг, ри╣рйЛриЯри▓
ЁЯНд => ЁЯНд, ри╕ри╝ри░ри┐рй░рик, риЯрйИриорикрйБри░ри╛
ЁЯНе => ЁЯНе, риорй▒риЫрйА риХрйЗриХ, риЧрйЛри▓ риорй▒риЫрйА риХрйЗриХ, риорй▒риЫрйА, рикрйЗри╕риЯри░рйА
ЁЯНб => ЁЯНб, риориари┐риЖриИ, риЬри╛рикри╛риирйА, ри╕риХрйВриЕри░, рибрй░рибрйА, риори┐рй▒риари╛
ЁЯНж => ЁЯНж, риЖриЗри╕ риХри░рйАрио, риири░рио, риХрйНри░рйАрио, ри╣рйЛриЯри▓, риори┐рй▒риари╛, риориари┐риЖриИ
ЁЯНз => ЁЯНз, рибри┐риЬри╝ри╛риИриирижри╛ри░ риЖриЗри╕, риЖриЗри╕, риориари┐риЖриИ
ЁЯНи => ЁЯНи, риЖриЗри╕риХрйНри░рйАрио, риЖриЗри╕, риХрйНри░рйАрио, риориари┐риЖриИ
ЁЯНй => ЁЯНй, риориари┐риЖриИ, риори┐рй▒риари╛
ЁЯНк => ЁЯНк, ри╣рйЛриЯри▓, риориари┐риЖриИ
ЁЯОВ => ЁЯОВ, риЬриирио рижри┐рии риХрйЗриХ, риЬриирио рижри┐рии, риХрйЗриХ, риЬри╕ри╝рии, рикрйЗри╕риЯри░рйА
ЁЯН░ => ЁЯН░, риЫрйЛриЯри╛ риХрйЗриХ, риХрй▒риЯри┐риЖ риХрйЗриХ, риХрйЗриХ, ри╣рйЛриЯри▓
ЁЯНл => ЁЯНл, риЪри╛риХри▓рйЗриЯ, римри╛ри░, ри╣рйЛриЯри▓
ЁЯНм => ЁЯНм, ри╕ри╡рйАриЯ, риори┐рй▒риари╛
ЁЯНн => ЁЯНн, ри▓рйЛри▓рйАрикрйЛрик, риЯрйМрилрйА, риори┐рй▒риари╛
ЁЯНо => ЁЯНо, рикрйБрибри┐рй░риЧ, ри╣рйЛриЯри▓
ЁЯНп => ЁЯНп, ри╕ри╝ри╣ри┐риж римри░ридрии, ри╕ри╝ри╣ри┐риж, римри░ридрии, ри╣рйЛриЯри▓
ЁЯН╝ => ЁЯН╝, рижрйБрй▒риз, римрйЛридри▓, рикрйАригри╛
тШХ => тШХ, риХри╛рилрйА, риЪри╛ри╣
ЁЯН╡ => ЁЯН╡, риЪри╛ри╣ рикри┐риЖри▓ри╛, риЪри╛ри╣ рижри╛ рикри┐риЖри▓ри╛, риЪри╛ри╣, рикрйАригри╛
ЁЯН╢ => ЁЯН╢, ри╕рйЗриХ римрйЛридри▓ риЕридрйЗ рикри┐риЖри▓ри╛, рикри┐риЖри▓ри╛, римрйЛридри▓, рикрйАригри╛, ри╣рйЛриЯри▓, римри╛ри░
ЁЯН╛ => ЁЯН╛, римри╛ри░, риЬри╕ри╝рии тАШридрйЗ риЦрйБрй▒ри▓рйНри╣рижрйА ри╣рйЛриИ римрйЛридри▓
ЁЯН╖ => ЁЯН╖, ри╡ри╛риИрии, ри╡ри╛риИрии рижри╛ риЧри▓ри╛ри╕, ри╡ри╛риИрии риЧри▓ри╛ри╕, риЧри▓ри╛ри╕, рикрйАригри╛, ри╣рйЛриЯри▓, римри╛ри░
ЁЯН╕ => ЁЯН╕, риХрйЛриХриЯрйЗри▓, риХрйЛриХриЯрйЗри▓ риЧри▓ри╛ри╕, ри╣рйЛриЯри▓, римри╛ри░
ЁЯН╣ => ЁЯН╣, ри╕рижри╛римри╣ри╛ри░, рикрйАригри╛, ри╣рйЛриЯри▓, римри╛ри░
ЁЯН║ => ЁЯН║, римрйАриЕри░, римрйАриЕри░ рикри┐риЖри▓ри╛, рикри┐риЖри▓ри╛, ри╣рйЛриЯри▓, римри╛ри░
ЁЯН╗ => ЁЯН╗, римрйАриЕри░ рикри┐риЖри▓рйЗ, римрйАриЕри░, рикри┐риЖри▓рйЗ, рикри┐риЖри▓ри╛, ри╣рйЛриЯри▓, римри╛ри░, риЯриХри░ри╛риЙригри╛
ЁЯН╜ => ЁЯН╜, риЦри╛ригри╛ римригри╛риЙригри╛, риХри╛риВриЯри╛, риЫрйБри░рйА, риЪри╛риХрйВ, рикри▓рйЗриЯ, рибри┐риири░, риЦри╛ригри╛
ЁЯН┤ => ЁЯН┤, риХри╛риВриЯри╛ риЕридрйЗ риЪри╛риХрйВ, риХри╛риВриЯри╛, риЪри╛риХрйВ, ри╣рйЛриЯри▓
ЁЯН│ => ЁЯН│, ридри▓риг ри▓риИ римри░ридрии, риЦри╛ригри╛ рикриХри╛риЙригри╛, ри╣рйЛриЯри▓
ЁЯП║ => ЁЯП║, риХрйБрй░рин, риЦри╛ригри╛ римригри╛риЙригри╛, рикрйАригри╛, риЬрй▒риЧ, риФриЬри╝ри╝ри╛ри░, ри╣риери┐риЖри░, ри░ри╛ри╕ри╝рйА риЪрй▒риХри░, ри╕рйБри░ри╛ри╣рйА
ЁЯМН => ЁЯМН, ри╕рй░ри╕ри╛ри░, ризри░ридрйА, рипрйВри░рйЛрик, риЕриври░рйАриХри╛
ЁЯМО => ЁЯМО, ри╕рй░ри╕ри╛ри░, ризри░ридрйА, риЕриори░рйАриХри╛
ЁЯМП => ЁЯМП, ри╕рй░ри╕ри╛ри░, ризри░ридрйА, риПри╕ри╝рйАриЖ, риЖри╕риЯри░рйЗри▓рйАриЖ
ЁЯМР => ЁЯМР, ри╕рй░ри╕ри╛ри░, риорйИри░рйАрибрйАриЕрии, ризри░ридрйА, риЧри▓рйЛрим
ЁЯЧ║ => ЁЯЧ║, риириХри╕ри╝ри╛, ри╕рй░ри╕ри╛ри░
ЁЯПФ => ЁЯПФ, риарй░риб, рикри╣ри╛рйЬ, римри░рил, риЪрйЛриЯрйА
тЫ░ => тЫ░, рикри░римрид
ЁЯМЛ => ЁЯМЛ, риЬри╡ри╛ри▓ри╛риорйБриЦрйА рилрй▒риЯригри╛, рикри╣ри╛рйЬ, риорйМри╕рио
ЁЯЧ╗ => ЁЯЧ╗, Mt. Fuji, рикри╣ри╛рйЬрйА
ЁЯПХ => ЁЯПХ, риХрйИриВрик ри▓риЧри╛риЙригри╛, риХрйИриВрик, ридрй░римрйВ
ЁЯПЦ => ЁЯПЦ, ри╕риорйБрй░рижри░рйА риХри┐риири╛ри░ри╛, риЫрй▒ридри░рйА, римрйАриЪ
ЁЯПЬ => ЁЯПЬ, риори╛ри░рйВриери▓
ЁЯПЭ => ЁЯПЭ, риори╛ри░рйВриери▓, риЯри╛рикрйВ, ри╕риорйБрй░рижри░рйА риЯри╛рикрйВ
ЁЯПЮ => ЁЯПЮ, рикри╛ри░риХ, римриЧрйАриЪри╛, риирйИри╕ри╝риири▓
ЁЯПЯ => ЁЯПЯ, ри╕риЯрйЗрибрйАриЕрио
ЁЯПЫ => ЁЯПЫ, риЗриори╛ри░рид, рикрйБри░ри╛ригрйА
ЁЯПЧ => ЁЯПЧ, риЗриори╛ри░рид, риири┐ри░риори╛риг
ЁЯПШ => ЁЯПШ, риЗриори╛ри░рид, риШри░, ринри╡рии, ри░ри┐ри╣ри╛риЗри╕ри╝
ЁЯПЩ => ЁЯПЩ, ри╕ри╝ри╣ри┐ри░рйА риЗриори╛ри░ридри╛риВ, ри╕ри╝ри╣ри┐ри░, риЙрй▒риЪрйАриЖриВ
ЁЯПЪ => ЁЯПЪ, риЗриори╛ри░рид, риШри░, риЦри╛ри▓рйА риШри░, риЦри╕ридри╛ ри╣ри╛ри▓рид
ЁЯПа => ЁЯПа, риШри░, риЗриори╛ри░рид
ЁЯПб => ЁЯПб, риШри░, римриЧрйАриЪрйЗ риири╛ри▓ риШри░, римриЧрйАриЪри╛, риЗриори╛ри░рид
тЫк => тЫк, риХрйНри░ри╛ри╕, риЗриори╛ри░рид
ЁЯХЛ => ЁЯХЛ, риЗри╕ри▓ри╛рио, риорйБри╕ри▓риори╛рии, ризри░рио
ЁЯХМ => ЁЯХМ, риЗри╕ри▓ри╛рио, риорйБри╕ри▓риори╛рии, ризри░рио
ЁЯХН => ЁЯХН, рипри╣рйВрижрйА, рипри╣рйВрижрйА рикрйНри░ри░ри╛риериири╛ риШри░, риорй░рижри┐ри░
тЫй => тЫй, ризри░рио, ри╕ри┐рй░риЯрйЛ, риорй░рижри┐ри░
ЁЯПв => ЁЯПв, рижрилри╝ридри░ рижрйА риЗриори╛ри░рид, рижрилри╝ридри░, риЗриори╛ри░рид
ЁЯПг => ЁЯПг, рибри╛риХ риШри░, риЬри╛рикри╛риирйА рибри╛риХ риШри░, риЬри╛рикри╛риирйА, рибри╛риХ, риЗриори╛ри░рид
ЁЯПд => ЁЯПд, рибри╛риХ риШри░, рипрйВри░рикрйАриЕрии рибри╛риХ риШри░, рипрйВри░рикрйАриЕрии, рибри╛риХ, риЗриори╛ри░рид
ЁЯПе => ЁЯПе, ри╣ри╕рикридри╛ри▓, риЗриори╛ри░рид, рибри╛риХриЯри░
ЁЯПж => ЁЯПж, риЗриори╛ри░рид
ЁЯПи => ЁЯПи, риЗриори╛ри░рид
ЁЯПй => ЁЯПй, рикри┐риЖри░, ри╣рйЛриЯри▓, риЗриори╛ри░рид
ЁЯПк => ЁЯПк, ри╕ри╣рйВри▓рид ринрй░рибри╛ри░, ри╕ри╣рйВри▓рид, ринрй░рибри╛ри░, риЗриори╛ри░рид
ЁЯПл => ЁЯПл, ри╕риХрйВри▓ риЗриори╛ри░рид, риЗриори╛ри░рид
ЁЯПм => ЁЯПм, ри╡ри┐ринри╛риЧ ринрй░рибри╛ри░, ри╡ри┐ринри╛риЧ, ринрй░рибри╛ри░
ЁЯПн => ЁЯПн, риЗриори╛ри░рид
ЁЯПп => ЁЯПп, риЬри╛рикри╛риирйА ринри╡рии, риХри┐ри▓рйНри╣ри╛, риЗриори╛ри░рид
ЁЯП░ => ЁЯП░, рипрйВри░рикрйАриЕрии ринри╡рии, ринри╡рии, риЗриори╛ри░рид
ЁЯТТ => ЁЯТТ, ри╡ри┐риЖри╣ риХри░рии ри▓риИ риЪрйИрикри▓, риЪрйИрикри▓, рикри┐риЖри░
ЁЯЧ╝ => ЁЯЧ╝, риЯрйЛриХрйАриУ, риЯри╛ри╡ри░
ЁЯЧ╜ => ЁЯЧ╜, ри╕риЯрйИриЪрйВ риЖрилри╝ ри▓ри┐римри░риЯрйА, римрйБрй▒рид, риЖриЬри╝ри╛рижрйА
ЁЯЧ╛ => ЁЯЧ╛, риириХри╕ри╝ри╛, риЬри╛рикри╛рии
тЫ▓ => тЫ▓, риЭри░риири╛
тЫ║ => тЫ║, риХрйИриВрикри┐рй░риЧ
ЁЯМБ => ЁЯМБ, ризрйБрй░риж, риорйМри╕рио
ЁЯМГ => ЁЯМГ, ридри╛ри░рйЗ, ри░ри╛рид, риорйМри╕рио
ЁЯМД => ЁЯМД, ри╕ри╡рйЗри░, ри╕ри╡рйЗри░рйЗ ри╕рйВри░риЬ, рикри╣ри╛рйЬри╛риВ рижрйА ри╕ри╡рйЗри░, рикри╣ри╛рйЬ, риорйМри╕рио
ЁЯМЕ => ЁЯМЕ, ри╕ри╡рйЗри░, ри╕рйВри░риЬ, риорйМри╕рио
ЁЯМЖ => ЁЯМЖ, ри╕ри╝ри╣ри┐ри░ рижрйА ри╕ри╝ри╛рио, ри╕ри╝ри╣ри┐ри░, риЗриори╛ри░рид, ри╕ри╝ри╛рио рижри╛ риириЬри╝ри╛ри░ри╛
ЁЯМЗ => ЁЯМЗ, риЗриори╛ри░ридри╛риВ ридрйЗ ри╕ри╝ри╛рио, риЗриори╛ри░рид, риорйМри╕рио
ЁЯМЙ => ЁЯМЙ, ри░ри╛рид рикрйБрй▒ри▓, рикрйБрй▒ри▓ ридрйЗ ри░ри╛рид, ри░ри╛рид, риорйМри╕рио
тЩи => тЩи, риЧри░рио, ринри╛рилри╝
ЁЯММ => ЁЯММ, рикрйБри▓ри╛рйЬ, риорйМри╕рио
ЁЯОа => ЁЯОа, риЭрйВри▓ри╛, риЭрйВри▓ри╛ риШрйЛрйЬри╛, риШрйЛрйЬри╛, риориирйЛри░рй░риЬрии
ЁЯОб => ЁЯОб, рилрйЗри░рйАри╕, риЪрй▒риХри░, риориирйЛри░рй░риЬрии рикри╛ри░риХ, риориирйЛри░рй░риЬрии
ЁЯОв => ЁЯОв, ри░рйЛри▓ри░, риХрй░риври╛, риориирйЛри░рй░риЬрии рикри╛ри░риХ, риориирйЛри░рй░риЬрии
ЁЯТИ => ЁЯТИ, риири╛риИ рижрйА рижрйБриХри╛рии, риири╛риИ, рикрйЛри▓, ри╣рйЗриЕри░риХрй▒риЯ
ЁЯОк => ЁЯОк, ри╕ри░риХри╕, ридрй░римрйВ, риориирйЛри░рй░риЬрии
ЁЯОн => ЁЯОн, риЪри┐ри╣ри░ри╛ риори╛ри╕риХ, риЕринри┐риирйИ риХри▓ри╛, риХри▓ри╛, риориирйЛри░рй░риЬрии, риЕринри┐риирйИ
ЁЯЦ╝ => ЁЯЦ╝, риХри▓ри╛, рилри░рйЗрио, риори┐риКриЬри╝рйАриЕрио, рикрйЗриЯри┐рй░риЧ, ридри╕ри╡рйАри░
ЁЯОи => ЁЯОи, ри░рй░риЧ рикрйИри▓риЕриЯ, рикрйИри▓риЕриЯ, риХри▓ри╛риХри╛ри░, ри░рй░риЧ, риХри▓ри╛, риори┐риКриЬри╝рйАриЕрио
ЁЯО░ => ЁЯО░, риирй░римри░ риори╕ри╝рйАрии, риирй░римри░, риЦрйЗриб, ри╕ри▓рйЛриЯ
ЁЯЪВ => ЁЯЪВ, ри╕риЯрйАрио ри▓рйЛриХрйЛриорйЛриЯри┐ри╡, ри░рйЗри▓ риЧрй▒рибрйА, ри╡ри╛ри╣рии
ЁЯЪГ => ЁЯЪГ, ри░рйЗри▓ риЧрй▒рибрйА, риЗри▓рйИриХриЯрйНри░ри┐риХ ри░рйЗри▓ риЧрй▒рибрйА, ри░рйЗри▓ри╡рйЗ риХри╛ри░, риЗри▓рйИриХриЯрйНри░ри┐риХ, ри░рйЗри▓ри╡рйЗ, риЯрйНри░рйИрио, ри╡ри╛ри╣рии
ЁЯЪД => ЁЯЪД, ридрйЗриЬри╝-ри░рилридри╛ри░ ри░рйЗри▓ риЧрй▒рибрйА, ри╕ри┐риириХри╛риири╕рйИрии, ри░рйЗри▓ риЧрй▒рибрйА, ри╡ри╛ри╣рии
ЁЯЪЕ => ЁЯЪЕ, ридрйЗрйЗриЬри╝ ри░рилридри╛ри░ ри░рйЗри▓ риЧрй▒рибрйА, римрйБри▓рйЗриЯ риирйЛриЬ, римрйБри▓рйЗриЯ риирйЛриЬ риири╛ри▓ ри╕ри┐риириХри╛риири╕рйИрии, ри╕ри┐риириХри╛риири╕рйИрии, ри░рйЗри▓ риЧрй▒рибрйА, ри╡ри╛ри╣рии
ЁЯЪЖ => ЁЯЪЖ, ри░рйЗри▓ риЧрй▒рй▒рибрйА, ри░рйЗри▓ри╡рйЗ, ри╡ри╛ри╣рии
ЁЯЪЗ => ЁЯЪЗ, ри╕римри╡рйЗ, ри╡ри╛ри╣рии
ЁЯЪИ => ЁЯЪИ, ри░рйЗри▓, ри╡ри╛ри╣рии
ЁЯЪЙ => ЁЯЪЙ, ри░рйЗри▓ риЧрй▒рибрйА ри╕риЯрйЗри╕ри╝рии, ри░рйЗри▓ риЧрй▒рибрйА
ЁЯЪК => ЁЯЪК, ри╡ри╛ри╣рии
ЁЯЪЭ => ЁЯЪЭ, ри╡ри╛ри╣рии
ЁЯЪЮ => ЁЯЪЮ, рикри╣ри╛рйЬрйА риХрйЗримри▓ риХри╛ри░, рикри╣ри╛рйЬ, ри░рйЗри▓ри╡рйЗ, риХри╛ри░, ри╡ри╛ри╣рии
ЁЯЪЛ => ЁЯЪЛ, риЯрйНри░рйИрио риХри╛ри░, риЯрйНри░рйИрио, риХри╛ри░, ри╡ри╛ри╣рии
ЁЯЪМ => ЁЯЪМ, ри╡ри╛ри╣рии
ЁЯЪН => ЁЯЪН, римрй▒ри╕, риЖ ри░ри╣рйА, ри╡ри╛ри╣рии
ЁЯЪО => ЁЯЪО, римрй▒ри╕, риЯри░ри╛ри▓рйА, ри╡ри╛ри╣рии
ЁЯЪП => ЁЯЪП, римрй▒рй▒ри╕ ри╕риЯри╛рик, ри░рйБриХрйЛ, римрй▒ри╕
ЁЯЪР => ЁЯЪР, римрй▒ри╕, ри╡ри╛ри╣рии
ЁЯЪС => ЁЯЪС, ри╡ри╛ри╣рии
ЁЯЪТ => ЁЯЪТ, рилри╛риЗри░ риЯри░рй▒риХ, риЕрй▒риЧ, риЗрй░риЬриг, ри╡ри╛ри╣рии
ЁЯЪУ => ЁЯЪУ, риЧри╕ри╝рид риХри╛ри░, рикрйБри▓ри┐ри╕, ри╡ри╛ри╣рии
ЁЯЪФ => ЁЯЪФ, рикрйБри▓ри┐ри╕ риХри╛ри░, рикрйБри▓ри┐ри╕, ри╡ри╛ри╣рии
ЁЯЪХ => ЁЯЪХ, ри╡ри╛ри╣рии
ЁЯЪЦ => ЁЯЪЦ, риЯрйИриХри╕рйА, ри╡ри╛ри╣рии
ЁЯЪЧ => ЁЯЪЧ, риХри╛ри░, ри╡ри╛ри╣рии
ЁЯЪШ => ЁЯЪШ, риЖриЙриг ри╡ри╛ри▓рйЗ риХри╛ри░, риХри╛ри░, риЖриЯрйЛриорйЛримри╛риИри▓, риЖриЙриг ри╡ри╛ри▓рйЗ, ри╡ри╛ри╣рии
ЁЯЪЩ => ЁЯЪЩ, RV, риХри╛ри░, ри╡ри╛ри╣рии
ЁЯЪЪ => ЁЯЪЪ, риЯри░рй▒риХ, ри╡ри╛ри╣рии
ЁЯЪЫ => ЁЯЪЫ, риЕрй▒риз, ри╡ри┐риЕриХрид ри▓ри╛ри░рйА, риЯри░рй▒риХ, риЯрйНри░рйЗри▓ри░, ри╡ри╛ри╣рии
ЁЯЪЬ => ЁЯЪЬ, риЯри░рйИриХриЯри░, ри╡ри╛ри╣рии
ЁЯЪ▓ => ЁЯЪ▓, римри╛риИриХ, ри╡ри╛ри╣рии
тЫ╜ => тЫ╜, риЧрйИри╕ ри╕риЯрйЗри╕ри╝рии, римри╛ри▓риг, риЧрйИри╕, ри╕риЯрйЗри╕ри╝рии
ЁЯЫг => ЁЯЫг, ри╣ри╛риИри╡рйЗ, ри╕рйЬриХ, ри░рйЛриб, риЖри╡ри╛риЬри╛риИ
ЁЯЫд => ЁЯЫд, ри░рйЗри▓ри╡рйЗ, ри░рйЗри▓, ри░рйЗри▓риЧрй▒рибрйА
ЁЯЪи => ЁЯЪи, риШрйБрй░риорижрйА ри▓ри╛риИриЯ, рикрйБри▓ри┐ри╕ ри▓ри╛риИриЯ, рикрйБри▓ри┐ри╕ римрй▒ридрйА, рикрйБри▓ри┐ри╕ риХри╛ри░
ЁЯЪе => ЁЯЪе, риЯрйНри░рйИрилри┐риХ ри▓ри╛риИриЯри╛риВ, ри╕риоридри▓ риЯрйНри░рйИрилри┐риХ ри▓ри╛риИриЯ, риЯрйНри░рйИрилри┐риХ ри╕ри┐риЧриири▓, ри▓ри╛риИриЯ, риЯрйНри░рйИрилри┐риХ
ЁЯЪж => ЁЯЪж, риЯрйНри░рйИрилри┐риХ ри▓ри╛риИриЯри╛риВ, рикрй▒риЯрйА риЯрйНри░рйИрилри┐риХ ри▓ри╛риИриЯ, риЯрйНри░рйИрилри┐риХ ри╕ри┐риЧриири▓, ри▓ри╛риИриЯ, риЯрйНри░рйИрилри┐риХ
ЁЯЪз => ЁЯЪз, риири┐ри░риори╛риг риЕризрйАрии, риири┐ри░риори╛риг риири┐ри╕ри╝ри╛рии, риири┐ри╕ри╝ри╛рии
тЪУ => тЪУ, риЬри╣ри╛риЬри╝, риФриЬри╝ри╛ри░
тЫ╡ => тЫ╡, римрйЗрйЬри╛, риХри┐ри╕ри╝ридрйА, ри╣рйИрй▒риЯрйА, ри╕риорйБрй░рижри░ ри░ри┐риЬри╛ри░риЯ, ри░ри┐риЬри╛ри░риЯ
ЁЯЪг => ЁЯЪг, риХри┐ри╕ри╝ридрйА, ри╡ри╛ри╣рии
ЁЯЪгтАНтЩА => ЁЯЪгтАНтЩА, риХри┐ри╕ри╝ридрйА, риЗри╕ридри░рйА, риФри░рид, рикридри╡ри╛ри░ ри╡ри╛ри▓рйА риХри┐ри╕ри╝ридрйА
ЁЯЪгтАНтЩВ => ЁЯЪгтАНтЩВ, риХри┐ри╕ри╝ридрйА, рикрйБри░ри╕ри╝, римрй░рижри╛, рикридри╡ри╛ри░ ри╡ри╛ри▓рйА риХри┐ри╕ри╝ридрйА
ЁЯЪд => ЁЯЪд, риЧридрйА риХри┐ри╕ри╝ридрйА, риХри┐ри╕ри╝ридрйА, ри╡ри╛ри╣рии
ЁЯЫ│ => ЁЯЫ│, рипри╛ридри░рйА, ри╕риорйБрй░рижри░рйА риЬри╣ри╛риЬри╝, ри╡ри╛ри╣рии
тЫ┤ => тЫ┤, риХри┐ри╕ри╝ридрйА
ЁЯЫе => ЁЯЫе, риХри┐ри╕ри╝ридрйА, риорйЛриЯри░ ри╡ри╛ри▓рйА риХри┐ри╕ри╝ридрйА, ри╡ри╛ри╣рии
ЁЯЪв => ЁЯЪв, ри╡ри╛ри╣рии
тЬИ => тЬИ, ри╡ри╛ри╣рии
ЁЯЫй => ЁЯЫй, ри╣ри╡ри╛риИ риЬри╣ри╛риЬри╝, ри╡ри╛ри╣рии
ЁЯЫл => ЁЯЫл, ри╣ри╡ри╛риИ риЬри╣ри╛риЬри╝, риЪрйИрй▒риХ-риЗрии, ри░ри╡ри╛риириЧрйА, ри╡ри╛ри╣рии
ЁЯЫм => ЁЯЫм, ри╣ри╡ри╛риИ риЬри╣ри╛риЬри╝, риЖриЧриории, риЖриЙригри╛, ри▓рйИриВрибри┐рй░риЧ, ри╡ри╛ри╣рии
ЁЯТ║ => ЁЯТ║, риЖри╕риг, риХрйБри░ри╕рйА
ЁЯЪБ => ЁЯЪБ, ри╡ри╛ри╣рии
ЁЯЪЯ => ЁЯЪЯ, ри░рйЗри▓ри╡рйЗ, ри╕ри╕рикрйИриири╕ри╝рии, ри╡ри╛ри╣рии
ЁЯЪа => ЁЯЪа, рикри╣ри╛рйЬрйА риХрйЗримри▓ риХри╛ри░, риХрйЗримри▓, риХри╛ри░, рикри╣ри╛рйЬ, ри╡ри╛ри╣рии
ЁЯЪб => ЁЯЪб, риХрйЗримри▓ риХри╛ри░, ри░рйЛрикри╡рйЗ, риПри░рйАриЕри▓, риЯрйНри░рйИриори╡рйЗ, риЧрйЛриирибрйЛри▓ри╛, ри╡ри╛ри╣рии
ЁЯЪА => ЁЯЪА, ри░ри╛риХрйЗриЯ, ри╡ри╛ри╣рии, рикрйБри▓ри╛рйЬ
ЁЯЫ░ => ЁЯЫ░, рикрйБри▓ри╛рйЬ, ри╕рикрйЗри╕, ри╡ри╛ри╣рии
ЁЯЫО => ЁЯЫО, риШрй░риЯрйА, рижри░римри╛рии, ри╣рйЛриЯри▓
ЁЯЪк => ЁЯЪк, рижри░ри╡ри╛риЬри╛
ЁЯЫМ => ЁЯЫМ, ри╣рйЛриЯри▓, риирйАриВриж
ЁЯЫП => ЁЯЫП, ри╣рйЛриЯри▓, ри╡ри┐риЕриХридрйА
ЁЯЫЛ => ЁЯЫЛ, ри╕рйЛрилри╛, ри╣рйЛриЯри▓, ри▓рйИриВрик, рилри░риирйАриЪри░, риЬрйАри╡рии-ри╕ри╝рйИри▓рйА
ЁЯЪ╜ => ЁЯЪ╜, риЯрйЛриЖриЗри▓риЯ
ЁЯЪ┐ => ЁЯЪ┐, рилрйБри╣ри╛ри░ри╛
ЁЯЫА => ЁЯЫА, риири╣ри╛риЙригри╛
ЁЯЫБ => ЁЯЫБ, римри╛рие
тМЫ => тМЫ, риШрйЬрйА, ри░рйЗрид
тП│ => тП│, ри░рйЗрид риШрйЬрйА, риШрйЬрйА
тМЪ => тМЪ, риШрйЬрйА
тП░ => тП░, риЕри▓ри╛ри░рио риШрйЬрйА, риШрйЬрйА
тП▒ => тП▒, риШрйЬрйА, ри╡ри┐ри░ри╛рио
тП▓ => тП▓, риШрйЬрйА, риЯри╛риИриори░
ЁЯХ░ => ЁЯХ░, риШрйЬрйА, риЕри▓ри╛ри░рио
ЁЯХЫ => ЁЯХЫ, риШрйЬрйА, римри╛ри░рйНри╣ри╛риВ, 12:00
ЁЯХз => ЁЯХз, римри╛ри░рйНри╣ри╛риВ-ридрйАри╣, риШрйЬрйА, 12:30
ЁЯХР => ЁЯХР, 1 ри╡риЬри┐риЖ, риШрйЬрйА, риЗрй▒риХ, 1:00
ЁЯХЬ => ЁЯХЬ, риШрйЬрйА, 1:30
ЁЯХС => ЁЯХС, риШрйЬрйА, рижрйЛ, 2:00
ЁЯХЭ => ЁЯХЭ, риШрйЬрйА, 2:30
ЁЯХТ => ЁЯХТ, риШрйЬрйА, ридри┐рй░рии, 3:00
ЁЯХЮ => ЁЯХЮ, риШрйЬрйА, 3:30
ЁЯХУ => ЁЯХУ, риШрйЬрйА, риЪри╛ри░, 4:00
ЁЯХЯ => ЁЯХЯ, риШрйЬрйА, 4:30
ЁЯХФ => ЁЯХФ, риШрйЬрйА, рикрй░риЬ, 5:00
ЁЯХа => ЁЯХа, риШрйЬрйА, 5:30
ЁЯХХ => ЁЯХХ, риШрйЬрйА, риЫрйЗ, 6:00
ЁЯХб => ЁЯХб, риШрйЬрйА, 6:30
ЁЯХЦ => ЁЯХЦ, риШрйЬрйА, ри╕рй▒рид, 7:00
ЁЯХв => ЁЯХв, риШрйЬрйА, 7:30
ЁЯХЧ => ЁЯХЧ, риШрйЬрйА, риЕрй▒риа, 8:00
ЁЯХг => ЁЯХг, риШрйЬрйА, 8:30
ЁЯХШ => ЁЯХШ, риШрйЬрйА, риирйМриВ, 9:00
ЁЯХд => ЁЯХд, риирйМриВ-ридрйАри╣, риШрйЬрйА, 9:30
ЁЯХЩ => ЁЯХЩ, риШрйЬрйА, рижри╕, 10:00
ЁЯХе => ЁЯХе, риШрйЬрйА, 10:30
ЁЯХЪ => ЁЯХЪ, риШрйЬрйА, риЧри┐риЖри░ри╛риВ, 11:00
ЁЯХж => ЁЯХж, риШрйЬрйА, 11:30
ЁЯМС => ЁЯМС, ри╣риирйЗри░ри╛ риЪрй░риж, ри╣риирйЗри░ри╛, риири╡ри╛риВ, риЪрй░риж, рикрйБри▓ри╛рйЬ, риорйМри╕рио
ЁЯМТ => ЁЯМТ, риЕрй▒ризри╛ риЪрй░риж, риЕрй▒ризри╛, ри╡рй▒ризрижри╛, риЪрй░риж, рикрйБри▓ри╛рйЬ, риорйМри╕рио
ЁЯМУ => ЁЯМУ, ридри┐риори╛ри╣рйА риЪрй░риж, риЪрй░риж, ридри┐риори╛ри╣рйА, рикрйБри▓ри╛рйЬ, риорйМри╕рио
ЁЯМФ => ЁЯМФ, ри╡рй▒ризрижри╛ риЪрй░риж, ри╡рй▒ризрижри╛, риирйМриори╛ри╣рйА, риЪрй░риж, риорйМри╕рио, рикрйБри▓ри╛рйЬ
ЁЯМХ => ЁЯМХ, рикрйВри░ри╛, риЪриориХрижри╛ риЪрй░риж, риЪриориХрижри╛, риЪрй░риж, рикрйБри▓ри╛рйЬ, риорйМри╕рио
ЁЯМЦ => ЁЯМЦ, риШрй▒риЯрижри╛, ри╡рй▒ризрижри╛ риЪрй░риж, ри╡рй▒ризрижри╛, риЪрй░риж, рикрйБри▓ри╛рйЬ, риорйМри╕рио
ЁЯМЧ => ЁЯМЧ, ридри┐риори╛ри╣рйА риЪрй░риж, ридри┐риори╛ри╣рйА, рикри┐риЫри▓ри╛ ридри┐риори╛ри╣рйА риЪрй░риж, риЪрй░риж, рикрйБри▓ри╛рйЬ, риорйМри╕рио
ЁЯМШ => ЁЯМШ, риЕрй▒ризри╛ риЪрй░рй░риж, риЕрй▒ризри╛, риШрй▒риЯрижри╛ риЪрй░риж, риШрй▒риЯрижри╛, риЪрй░риж, рикрйБри▓ри╛рйЬ риорйМри╕рио
ЁЯМЩ => ЁЯМЩ, риЕрй▒ризри╛ риЪрй░рй░риж, риЕрй▒ризри╛, риЪрй░риж, рикрйБри▓ри╛рйЬ, риорйМри╕рио
ЁЯМЪ => ЁЯМЪ, риири╡ри╛риВ риЪрй░риж, риири╡рйЗриВ риЪрй░риж рижри╛ риЪри┐ри╣ри░ри╛, риЪрй░риж, риЪри┐ри╣ри░ри╛, рикрйБри▓ри╛рйЬ, риорйМри╕рио
ЁЯМЫ => ЁЯМЫ, ридри┐риори╛ри╣рйА риЪрй░риж рижри╛ риЪри┐ри╣ри░ри╛, ридри┐риори╛ри╣рйА, риЪрй░риж рижри╛ риЪри┐ри╣ри░ри╛, рикри╣ри┐ри▓ри╛ ридри┐риори╛ри╣рйА риЪрй░риж, ридри┐риори╛ри╣рйА риЪрй░риж, риЪрй░риж, риЪри┐ри╣ри░ри╛, рикрйБри▓ри╛рйЬ, риорйМри╕рио
ЁЯМЬ => ЁЯМЬ, ридри┐риори╛ри╣рйА риЪрй░риж рижри╛ риЪри┐ри╣ри░ри╛, ридри┐риори╛ри╣рйА, риЪрй░риж рижри╛ риЪри┐ри╣ри░ри╛, рикри┐риЫри▓ри╛ ридри┐риори╛ри╣рйА риЪрй░риж, ридри┐риори╛ри╣рйА риЪрй░риж, риЪрй░риж, риЪри┐ри╣ри░ри╛, рикрйБри▓ри╛рйЬ, риорйМри╕рио
ЁЯМб => ЁЯМб, ридри╛рикриори╛рии, риорйМри╕рио
тША => тША, риЪриориХрижрйАриЖриВ риХри┐ри░риири╛риВ, рикрйБри▓ри╛рйЬ, ризрйБрй▒рик, риорйМри╕рио
ЁЯМЭ => ЁЯМЭ, риЪриориХрйАри▓ри╛, риЪри┐ри╣ри░рйЗ риири╛ри▓ рикрйВри░ри╛ риЪрй░риж, риЪри┐ри╣ри░рйЗ риири╛ри▓ риЪрй░риж, рикрйВри░ри╛ риЪрй░рижри╛, рикрйВри░ри╛, риЪрй░риж, риЪри┐ри╣ри░ри╛, риорйМри╕рио
ЁЯМЮ => ЁЯМЮ, риЪриориХригри╛, риЪриориХрижри╛, ри╕рйВри░риЬ, риЪри┐ри╣ри░ри╛
тнР => тнР, ри╕рилрйЗриж, ридри╛ри░ри╛
ЁЯМЯ => ЁЯМЯ, риЬриЧриориЧриЙриВрижри╛ ридри╛ри░ри╛, риЪриориХрижри╛, риЭри┐ри▓риори┐ри▓ри╛риЙриВрижри╛, рижриориХрижри╛, ридри╛ри░ри╛
ЁЯМа => ЁЯМа, ридри╛ри░ри╛ риЯрйБрй▒риЯригри╛, риЯрйБрй▒риЯригри╛, рибри┐рй▒риЧригри╛, ридри╛ри░ри╛
тШБ => тШБ, риорйМри╕рио
тЫЕ => тЫЕ, римрй▒рижри▓ри╛риВ рикри┐рй▒риЫрйЗ ри╕рйВри░риЬ, римрй▒рижри▓ри╛риВ риири╛ри▓ ри╕рйВри░риЬ, ри╕рйВри░риЬ, римрй▒рижри▓
тЫИ => тЫИ, римрй▒рижри▓, риорйАриВри╣, ридрйВрилри╛рии, риорйМри╕рио
ЁЯМд => ЁЯМд, ризрйБрй▒рик, римрй▒рижри▓, риорйМри╕рио
ЁЯМе => ЁЯМе, ризрйБрй▒рик, римрй▒рижри▓, риорйМри╕рио
ЁЯМж => ЁЯМж, римрй▒рижри▓, риорйАриВриВри╣ рижри╛ риорйМри╕рио, ризрйБрй▒рик
ЁЯМз => ЁЯМз, римрй▒рижри▓, риорйАриВри╣ рижри╛ риорйМри╕рио
ЁЯМи => ЁЯМи, римрй▒рижри▓, риарй░риб, римри░рил рикрйИригрйА
ЁЯМй => ЁЯМй, римрй▒рижри▓, риорйМри╕рио, римри┐риЬри▓рйА ри▓ри╕ри╝риХригри╛
ЁЯМк => ЁЯМк, римрй▒рй▒рижри▓, риорйМри╕рио, ри╡ри╛ри╡ри░рйЛри▓рйЗ
ЁЯМл => ЁЯМл, римрй▒рижри▓, риорйМри╕рио
ЁЯМм => ЁЯМм, ри╣ри╡ри╛ рижри╛ римрйБрй▒ри▓ри╛, римрй▒рижри▓, риЪри┐ри╣ри░ри╛, риорйМри╕рио
ЁЯМА => ЁЯМА, ридрйВрилри╝ри╛рии, риЯри╡ри┐ри╕риЯри░, ризрйБрй░рижри▓ри╛, римрйЗри╣рйЛри╕ри╝рйА, риорйМри╕рио
ЁЯМИ => ЁЯМИ, риорйАриВри╣, риорйМри╕рио
ЁЯМВ => ЁЯМВ, риЫрй▒ридри░рйА, риорйАриВри╣, римри░ри╕ри╛рид, риорйМри╕рио
тШВ => тШВ, риХрй▒рй▒рикрйЬрйЗ, риорйАриВри╣
тШФ => тШФ, риХрй▒рикрйЬрйЗ, римрйБрй░рижри╛римри╛риВрижрйА ри╣рйЛригри╛, риорйАриВри╣, риЫрй▒ридри░рйА, риорйАриВри╣ рижри╛ риорйМри╕рио
тЫ▒ => тЫ▒, риорйАриВри╣, ри╕рйВри░риЬ, риЫрй▒ридри░рйА, риорйМри╕рио
тЪб => тЪб, ри╣ри╛риИ ри╡рйЛри▓риЯрйЗриЬ риЦридри░ри╛, ри╣ри╛риИ ри╡рйЛри▓риЯрйЗриЬ риири┐ри╕ри╝ри╛рии, ри╣ри╛риИ, ри╡рйЛри▓риЯрйЗриЬ, риири┐ри╕ри╝ри╛рии
тЭД => тЭД, риарй░рй░риб, римри░рил, риорйМри╕рио
тШГ => тШГ, риарй░риб, римри░рил, риорйМри╕рио
тЫД => тЫД, ри╕риирйЛриорйИрии, ри╕риирйЛриорйИрии римри┐риири╛риВ римри░рилри╝, римри░рилри╝, риорйМри╕рио
тШД => тШД, рикрйБри▓ри╛рйЬ
ЁЯФе => ЁЯФе, ри▓ри╛риЯ, риФриЬри╝ри╛ри░
ЁЯТз => ЁЯТз, риарй░рибри╛ риорйБрйЬрйНри╣риХри╛, риорйБрйЬрйНри╣риХри╛, рикри╕рйАриири╛, риХри╛риори┐риХ
ЁЯМК => ЁЯМК, ри▓ри╣ри┐ри░, ри╕ри╛риЧри░, риорйМри╕рио
ЁЯОГ => ЁЯОГ, риЬрйИриХ, ри▓рйИриВриЯри░рии, ри╣рйЗри▓рйЛри╡рйАрии, рикрйЗриари╛, риЬри╕ри╝рии
ЁЯОД => ЁЯОД, риХрйНри░ри┐ри╕риори╕ ри░рйБрй▒риЦ, ри░рйБрй▒риЦ, риЬри╕ри╝рии
ЁЯОЖ => ЁЯОЖ, риЕрй▒риЧ рижри╛ риХрй░рио, риЬри╕ри╝рии
ЁЯОЗ => ЁЯОЗ, риЪриориХ, риЕрй▒риЧ рижри╛ риХрй░рио, риЪриориХрйАри▓ри╛ риЕрй▒риЧ рижри╛ риХрй░рио, риЬри╕ри╝рии
тЬи => тЬи, риЪриориХригри╛, риЪриориХрижрйЗ ридри╛ри░рйЗ, рилрйБрй▒ри▓риЭрйЬрйА, ридри╛ри░рйЗ
ЁЯОИ => ЁЯОИ, риЬри╕ри╝рии
ЁЯОЙ => ЁЯОЙ, рикри╛ри░риЯрйА, рикрйЛрикри░, риЬри╕ри╝рии
ЁЯОК => ЁЯОК, риХрйЛриирилрйЗриЯрйА, риХрйЛриирилрйЗриЯрйА риЧрйЗриВриж, риЧрйЗриВриж, риЬри╕ри╝рии
ЁЯОЛ => ЁЯОЛ, римрйИриири░, ри░рйБрй▒риЦ риЕридрйЗ риХри╛риЧриЬри╝ риЯрйБриХрйЬрйЗ, ридри╛ри░ри╛ ридри┐риЙри╣ри╛ри░, ри░рйБрй▒риЦ, риХри╛риЧриЬри╝ риЯрйБриХрйЬрйЗ, риЬри╕ри╝рии
ЁЯОМ => ЁЯОМ, рикри╛ри░ риЭрй░рибрйЗ, риЬри╛рикри╛рии рижрйЗ рикри╛ри░ риЭрй░рибрйЗ, рикри╛ри░, риЭрй░рибрйЗ, риЬри╕ри╝рии
ЁЯОН => ЁЯОН, римрйИриоримрйЛ, рикри┐рии ри╕риЬри╛ри╡риЯ, риири╡ри╛риВ ри╕ри╛ри▓, риЬри╛рикри╛риирйА, рикри┐рии, риЬри╕ри╝рии
ЁЯОО => ЁЯОО, риЧрйБрй▒рибрйАриЖриВ, риЧрйБрй▒рибрйАриЖриВ ридри┐риЙри╣ри╛ри░, ридри┐риЙри╣ри╛ри░, риЬри╛рикри╛риирйА, риЬри╕ри╝рии
ЁЯОП => ЁЯОП, риХри╛ри░рик риЭрй░рибрйА, риЭрй░рибрйА, риЬри╕ри╝рии
ЁЯОР => ЁЯОР, риШрй░риЯрйА, риЬри╕ри╝рии, риЪри╛риИрио, ри╣ри╡ри╛
ЁЯОС => ЁЯОС, риЪрй░рии ри╡рйЗриЦриг, риЪрй░рии ри╡рйЗриЦриг рижрйА ри░ри╕рио, риЪрй░рии, ри╡рйЗриЦриг, риЬри╕ри╝рии
ЁЯОА => ЁЯОА, риЬри╕ри╝рии
ЁЯОБ => ЁЯОБ, ридрйЛри╣рилри╝ри╛, ри▓рикрйЗриЯри┐риЖ риЙрикри╣ри╛ри░, ри▓рикрйЗриЯри┐риЖ, риЬри╕ри╝рии
ЁЯОЦ => ЁЯОЦ, риЬри╕ри╝ри╝рии, риорйИрибри▓, рилрйМриЬ
ЁЯОЧ => ЁЯОЧ, риЬри╕ри╝рии, рипри╛риж-рижри╣ри╛риирйА, ри░ри┐римрии
ЁЯОЮ => ЁЯОЮ, ри╕ри┐риирйЗриори╛, рилри┐ри▓рио, риорйВри╡рйА
ЁЯОЯ => ЁЯОЯ, рижри╛риЦри▓ри╛, рижри╛риЦри▓ ри╣рйЛригри╛, риЯри┐риХриЯ
ЁЯОл => ЁЯОл, риЯри┐риХриЯ, риориирйЛри░рй░риЬрии, рижри╛риЦри▓ ри╣рйЛригри╛
ЁЯП╖ => ЁЯП╖, риорйЛри╣ри░
тЪ╜ => тЪ╜, рилрйБрй▒риЯримри╛ри▓ римри╛ри▓, римри╛ри▓, риЧрйЗриВриж
тЪ╛ => тЪ╛, риЧрйЗриВриж
ЁЯПА => ЁЯПА, римри╛ри╕риХриЯримри╛ри▓ риХрйЬри╛, риЧрйЗриВриж, риХрйЬри╛, риЦрйЗриб
ЁЯПИ => ЁЯПИ, риЕриори░рйАриХрии, риЧрйЗриВриж, риЦрйЗриб
ЁЯПЙ => ЁЯПЙ, рилрйБрй▒риЯримри╛ри▓, рилрйБрй▒риЯримри╛ри▓ риЧрйЗриВриж, риЧрйЗриВриж, риЦрйЗриб
ЁЯО╛ => ЁЯО╛, риЯрйИриири┐ри╕ риЧрйЗриВриж, риЯрйИриири┐ри╕ ри░рйИриХрйЗриЯ риЕридрйЗ риЧрйЗриВриж, риЧрйЗриВриж, риЦрйЗриб
ЁЯО▒ => ЁЯО▒, риЕрй▒риа риЧрйЗриВрижри╛риВ, риЦрйЗриб
ЁЯО│ => ЁЯО│, римрйМри▓ри┐рй░риЧ риЧрйЗриВриж, риЧрйЗриВриж, риЦрйЗриб
тЫ│ => тЫ│, риорйЛри░рйА ри╡ри┐рй▒риЪ риЭрй░рибри╛, риЧрйЛри▓рил, риЧрйЛри▓рил риЭрй░рибри╛, риорйЛри░рйА, риЦрйБрй▒риб
ЁЯПМ => ЁЯПМ, риЧрйЗриВриж, риЧрйЛри▓рил рижри╛ риЦрйЗриб
ЁЯПМтАНтЩА => ЁЯПМтАНтЩА, риЧрйЛри▓рил, риЗри╕ридри░рйА, риФри░рид
ЁЯПМтАНтЩВ => ЁЯПМтАНтЩВ, риЧрйЛри▓рил, рикрйБри░ри╕ри╝, римрй░рижри╛
тЫ╕ => тЫ╕, римри░рил, ри╕риХрйЗриЯ, ри╕риХрйЗриЯри┐рй░риЧ
ЁЯОг => ЁЯОг, риорй▒риЫрйА рилрйЬриири╛, риорй▒риЫрйА риЕридрйЗ риорй▒риЫрйА рилрйЬрии ри▓риИ риЦрй░римри╛, риорй▒риЫрйА, риЦрй░римри╛, риориирйЛри░рй░риЬрии
ЁЯО╜ => ЁЯО╜, рижрйМрйЬрии ри▓риИ риХриорйАриЬри╝, рикрйЗриЯрйА рижрйЗ риири╛ри▓ рижрйМрйЬрии ри▓риИ риХриорйАриЬри╝, рижрйМрйЬриири╛, риХриорйАриЬри╝, рикрйЗриЯрйА, риЦрйЗриб
ЁЯО┐ => ЁЯО┐, ри╕риХрйА, ри╕риХрйА риЕридрйЗ римрйВриЯ, римрйВриЯ, риЦрйЗриб
тЫ╖ => тЫ╖, ри╕риХрйА, римри░рил, римри░рил рижрйЗ риЦрйЗриб
ЁЯПВ => ЁЯПВ, ри╕риХрйА, ри╕риирйЛримрйЛри░рибри┐рй░риЧ, ри╕риирйЛримрйЛри░риб, риЦрйЗриб
ЁЯПД => ЁЯПД, ридрйИри░ри╛риХрйА, ридрйИри░ри╛риХ, риЦрйЗриб
ЁЯПДтАНтЩА => ЁЯПДтАНтЩА, риЗри╕ридри░рйА, риФри░рид, ри╕ри░рилри┐рй░риЧ риХри░риири╛
ЁЯПДтАНтЩВ => ЁЯПДтАНтЩВ, рикрйБри░ри╕ри╝, римрй░рижри╛, ри╕ри░рилри┐рй░риЧ риХри░риири╛
ЁЯПЗ => ЁЯПЗ, риШрйЛрйЬ рижрйМрйЬ, рижрйМрйЬри╛риХ риШрйЛрйЬри╛, риШрйБри░ри╕ри╡ри╛ри░, рижрйМрйЬ, риШрйЛрйЬри╛, риЦрйЗриб
ЁЯПК => ЁЯПК, ридрйИри░ри╛риХрйА, ридрйИри░риири╛, риЦрйЗриб
ЁЯПКтАНтЩА => ЁЯПКтАНтЩА, риЗри╕ридри░рйА, ридрйИри░риири╛, риФри░рид
ЁЯПКтАНтЩВ => ЁЯПКтАНтЩВ, рикрйБри░ри╕ри╝, римрй░рижри╛, ридрйИри░риири╛
тЫ╣ => тЫ╣, риЧрйЗриВриж, риЧрйЗриВриж риири╛ри▓ ри╡ри┐риЕриХридрйА
тЫ╣тАНтЩА => тЫ╣тАНтЩА, риЧрйЗриВриж, риЗри╕ридри░рйА, риФри░рид
тЫ╣тАНтЩВ => тЫ╣тАНтЩВ, риЧрйЗриВриж, рикрйБри░ри╕ри╝, римрй░рижри╛
ЁЯПЛ => ЁЯПЛ, ринри╛ри░, ринри╛ри░ риЪрйБрй▒риХригри╛
ЁЯПЛтАНтЩА => ЁЯПЛтАНтЩА, риЗри╕ридри░рйА, риФри░рид, ринри╛ри░ ридрйЛри▓риХ
ЁЯПЛтАНтЩВ => ЁЯПЛтАНтЩВ, рикрйБри░ри╕ри╝, римрй░рижри╛, ринри╛ри░ ридрйЛри▓риХ
ЁЯЪ┤ => ЁЯЪ┤, римри╛риИриХ
ЁЯЪ┤тАНтЩА => ЁЯЪ┤тАНтЩА, римри╛риИри╕ри╛риИриХри▓, римри╛риИриХ риЪри▓ри╛риЙригри╛, ри╕ри╛риИриХри▓ ри╕ри╡ри╛ри░, риЗри╕ридри░рйА, риФри░рид
ЁЯЪ┤тАНтЩВ => ЁЯЪ┤тАНтЩВ, римри╛риИри╕ри╛риИриХри▓, римри╛риИриХ риЪри▓ри╛риЙригри╛, ри╕ри╛риИриХри▓ ри╕ри╡ри╛ри░, рикрйБри░ри╕ри╝, римрй░рижри╛
ЁЯЪ╡ => ЁЯЪ╡, рикри╣ри╛рйЬрйА ри╕ри╛риИриХри▓ ри╕ри╡ри╛ри░, римри╛риИриХ, ри╕ри╛риИриХри▓ ри╕ри╡ри╛ри░, рикри╣ри╛рйЬ
ЁЯЪ╡тАНтЩА => ЁЯЪ╡тАНтЩА, римри╛риИри╕ри╛риИриХри▓, римри╛риИриХ, ри╕ри╛риИриХри▓ ри╕ри╡ри╛ри░, риЗри╕ридри░рйА, риФри░рид, рикри╣ри╛рйЬ
ЁЯЪ╡тАНтЩВ => ЁЯЪ╡тАНтЩВ, римри╛риИри╕ри╛риИриХри▓, римри╛риИриХ, ри╕ри╛риИриХри▓ ри╕ри╡ри╛ри░, рикрйБри░ри╕ри╝, римрй░рижри╛, рикри╣ри╛рйЬ
ЁЯПО => ЁЯПО, риХри╛ри░, риХри╛ри░ ри░рйЗри╕ри┐рй░риЧ
ЁЯПН => ЁЯПН, ри░рйЗри╕ри┐рй░риЧ, римри╛риИриХ ри░рйЗри╕ри┐рй░риЧ
ЁЯПЕ => ЁЯПЕ, риорйИрйИрибри▓, риЗриири╛рио
ЁЯПЖ => ЁЯПЖ, риЯри░ри╛рилрйА, риЗриири╛рио
ЁЯПП => ЁЯПП, риХрйНри░ри┐риХрйЗриЯ риЦрйЗриб, риЦрйЗриб, риЧрйЗриВриж
ЁЯПР => ЁЯПР, риЦрйЗриб, римри╛ри▓
ЁЯПС => ЁЯПС, ри╣ри╛риХрйА, риЦрйЗриб
ЁЯПТ => ЁЯПТ, ри╣ри╛риХрйА, риЖриИри╕ ри╣ри╛риХрйА, римри░рил, рикриХ
ЁЯПУ => ЁЯПУ, риЯрйЗримри▓ риЯрйИриири┐ри╕, риЦрйЗриб, риЧрйЗриВриж, римрйИриЯ
ЁЯП╕ => ЁЯП╕, римри░рибрйА, риЧрйЗрио, риЪри┐рйЬрйА-риЫри┐рй▒риХри╛ риЦрйЗриб, риЫри┐рй▒риХри╛, риЪри┐рйЬрйА
ЁЯОп => ЁЯОп, римри▓риж рижрйА риЕрй▒риЦ, ри╕ри┐рй▒ризри╛ риори╛ри░риири╛, ри╕ри╣рйА риЯрйАриЪрйЗ ридрйЗ, риЯрйАриЪри╛, риори╛ри░риири╛, риЦрйЗриб
ЁЯОо => ЁЯОо, ри╡рйАрибрйАриУ риЦрйЗриб, риЦрйЗриб риХрй░риЯри░рйЛри▓ри░, риХрй░риЯри░рйЛри▓ри░, риЦрйЗриб, риЧрйЗрио
ЁЯХ╣ => ЁЯХ╣, риЧрйЗрио, ри╡рйАрибрйАриУ риЧрйЗрио
ЁЯО▓ => ЁЯО▓, рибри╛риИри╕, рибри╛риИ, риЧрйЗрио
тЩа => тЩа, ри╕рикрйЗриб, ридри╛ри╕ри╝
тЩе => тЩе, рижри┐ри▓, ридри╛ри╕ри╝
тЩж => тЩж, ри╣рйАри░ри╛, ри╣рйАри░рйЗ, риЧрйЗрио, ридри╛ри╕ри╝
тЩг => тЩг, риХри╛ри░риб, риЧрйЗрио, ридри╛ри╕ри╝
ЁЯГП => ЁЯГП, риЬрйЛриХри░ риХри╛ри░риб, риЬрйЛриХри░, ридри╛ри╕ри╝ риЦрйЗрибригри╛, риХри╛ри░риб
ЁЯАД => ЁЯАД, Mahjong риЯри╛риИри▓, ри▓ри╛ри▓ рибрйНри░рйИриЧрии, рибрйНри░рйИриЧрии, mahjong, риЯри╛риИри▓
ЁЯО┤ => ЁЯО┤, риЦрйЗриб риХри╛ри░риб, рилрйБрй▒ри▓ риХри╛ри░риб, рилрйБрй▒ри▓, риХри╛ри░риб риЦрйЗриб, риХри╛ри░риб, риЦрйЗриб, ри╣ри╛риири╛рилрй░рибри╛
ЁЯФЗ => ЁЯФЗ, римрйЛри▓рйЛ риири╛, риХри┐ри░рикри╛ ри╕ри╝ри╛риВрид, ри╕ри╝ри╛риВрид, ри░рй▒риж риХри░рии рижрйЗ риири┐ри╕ри╝ри╛рии риири╛ри▓ ри╕рикрйАриХри░
ЁЯФИ => ЁЯФИ, ри▓ри╛риЙрибри╕рикрйАриХри░
ЁЯФЙ => ЁЯФЙ, ри╕рикрйАриХри░, риШрй▒риЯ риЖри╡ри╛риЬри╝, риШрй▒риЯ, риШрй▒риЯ риЕри╛ри╡ри╛риЬри╝ риири╛ри▓ ри╕рикрйАриХри░
ЁЯФК => ЁЯФК, ри╕рикрйАриХри░, ри╡рй▒риз риЖри╡ри╛риЬри╝, ри╡рй▒риз, ри╡рй▒риз риЖри╡ри╛риЬри╝ риири╛ри▓ ри╕рикрйАриХри░
ЁЯУв => ЁЯУв, ри▓ри╛риКрибри╕рикрйАриХри░, риЬрииридриХ рикридри╛, ри╣рй▒рие ри╕рикрйАриХри░, ри╕рй░риЪри╛ри░
ЁЯУг => ЁЯУг, риЙридри╕ри╝ри╛ри╣ ри╡ризри╛риЙригри╛, ри╕рй░риЪри╛ри░
ЁЯУп => ЁЯУп, рибри╛риХ ри╣ри╛ри░рии, рибри╛риХ, ри╣ри╛ри░рии
ЁЯФФ => ЁЯФФ, риЪрйИрикри▓
ЁЯФХ => ЁЯФХ, риШрй░риЯрйА риири╣рйАриВ, риЕри╛ри╡ри╛риЬри╝ риири╣рйАриВ, ри░рй▒риж риХри░рии рижрйЗ риири┐ри╕ри╝ри╛рии риири╛ри▓ риШрй░риЯрйА, риШрй░риЯрйА
ЁЯО╝ => ЁЯО╝, ри╕рй░риЧрйАрид ри╕риХрйЛри░, ри╕рй░риЧрйАрид, ри╕риХрйЛри░
ЁЯО╡ => ЁЯО╡, ри╕рй░риЧрйАрид, риирйЛриЯ
ЁЯО╢ => ЁЯО╢, ри╕рй░риЧрйАрид риирйЛриЯ, ри╕рй░риЧрйАрид, риирйЛриЯ
ЁЯОЩ => ЁЯОЩ, риори╛риИриХ, риори╛риИриХрйНри░рйЛрилрйЛрии, ри╕рй░риЧрйАрид, ри╕риЯрйВрибрйАриУ
ЁЯОЪ => ЁЯОЪ, рикрй▒ризри░, ри╕рй░риЧрйАрид, ри╕ри▓ри╛риИрибри░
ЁЯОЫ => ЁЯОЫ, риХрй░риЯри░рйЛри▓, римриЯрии, ри╕рй░риЧрйАрид
ЁЯОд => ЁЯОд, риори╛риИриХ, риХри╛ри░ри╛риУриХрйЗ, риориирйЛри░рй░риЬрии
ЁЯОз => ЁЯОз, риориирйЛри░рй░риЬрии
ЁЯО╖ => ЁЯО╖, ри╕рйИриХри╕, ри╕рйИриХри╕рйЛрйЛрилрйЛрии, ри╕рй░риЧрйАрид ри╕ри╛риЬри╝, ри╕рй░риЧрйАрид, ри╕ри╛риЬри╝
ЁЯО╕ => ЁЯО╕, ри╕рй░риЧрйАрид ри╕ри╛риЬри╝, ри╕рй░риЧрйАрид, ри╕ри╛риЬри╝
ЁЯО╣ => ЁЯО╣, рикри┐риЖриирйЛ, ри╕рй░риЧрйАрид риХрйАримрйЛри░риб, риХрйАримрйЛри░риб, ри╕рй░риЧрйАрид ри╕ри╛риЬри╝, ри╕рй░риЧрйАрид, ри╕ри╛риЬри╝
ЁЯО║ => ЁЯО║, ри╕рй░риЧрйАрид ри╕ри╛риЬри╝, ри╕рй░риЧрйАрид, ри╕ри╛риЬри╝
ЁЯО╗ => ЁЯО╗, ри╕рй░риЧрйАрид ри╕ри╛риЬри╝, ри╕рй░риЧрйАрид, ри╕ри╛риЬри╝
ЁЯУ╗ => ЁЯУ╗, ри╡рйАрибрйАриУ
ЁЯУ▒ => ЁЯУ▒, ри╕рйИрй▒ри▓рилрйЛрии, риорйЛримри╛риЗри▓, рилрйЛрии, риЯрйИри▓рйАрилрйЛрии
ЁЯУ▓ => ЁЯУ▓, ри╕рйИрй▒ри▓рилрйЛрйЛрии ридрйАри░ риири╛ри▓, риЗрй▒риХ риХри╛ри▓ риХри░рйЛ, риорйЛримри╛риЗри▓ рилрйЛрии, риЯрйИри▓рйАрилрйЛрии
тШО => тШО, рилрйЛрии
ЁЯУЮ => ЁЯУЮ, рилрйЛрии, риЯрйЗри▓рйАрилрйЛрии, рилрйЛрии ри░ри╕рйАри╡ри░, ри╕рй░риЪри╛ри░
ЁЯУЯ => ЁЯУЯ, ри╕рй░риЪри╛ри░
ЁЯУа => ЁЯУа, рилрйИриХри╕, ри╕рй░рй░риЪри╛ри░
ЁЯФЛ => ЁЯФЛ, римрйИриЯри░рйА
ЁЯФМ => ЁЯФМ, римри┐риЬри▓рйА
ЁЯТ╗ => ЁЯТ╗, pc, риири┐рй▒риЬрйА риХрй░рикри┐риЙриЯри░, риири┐рй▒риЬрйА
ЁЯЦе => ЁЯЦе, риХрй░рикри┐риКриЯри░ рибрйИри╕риХриЯри╛рик
ЁЯЦи => ЁЯЦи, риХрй░рикри┐ри┐риКриЯри░ рикрйНри░ри┐рй░риЯри░
тМи => тМи, риХрй░рй░рикри┐риКриЯри░ риХрйА-римрйЛри░риб
ЁЯЦ▒ => ЁЯЦ▒, 3, римриЯрии, риХрй░рикри┐риКриЯри░, риори╛риКри╕, ридри┐рй░рии
ЁЯЦ▓ => ЁЯЦ▓, риХрй░рикри┐риКриЯри░
ЁЯТ╜ => ЁЯТ╜, риХрй░рикри┐риКриЯри░, рибри┐ри╕риХ, риЖрикриЯрйАриХри▓
ЁЯТ╛ => ЁЯТ╛, рилри▓рйМрикрйА, рибри┐ри╕риХ
ЁЯТ┐ => ЁЯТ┐, римри▓рйВ-ри░рйЗ, рибрйАри╡рйАрибрйА, ри╕рйАрибрйА, риЖрикриЯрйАриХри▓ рибри┐ри╕риХ, рибри┐ри╕риХ
ЁЯУА => ЁЯУА, римри▓рйВ-ри░рйЗ, рибри┐ри╕риХ, ри╕рйАрибрйА, риЖрикриЯрйАриХри▓, риХрй░рикри┐риКриЯри░
ЁЯОе => ЁЯОе, рилри┐ри▓рио риХрйИриори░ри╛, рилри┐ри▓рио, ри╕ри┐риирйЗриори╛, риориирйЛри░рй░риЬрии
ЁЯОм => ЁЯОм, риХри▓рйИрикри░, рилри┐ри▓рио, риориирйЛри░рй░риЬрии
ЁЯУ╜ => ЁЯУ╜, ри╕ри┐риирйЗриори╛, рилри┐ри▓рио, риорйВри╡рйА, рикрйНри░рйЛриЬрйИриХриЯри░, ри╡рйАрибрйАриУ
ЁЯУ║ => ЁЯУ║, риЯрйАри╡рйА, ри╡рйАрибрйАриУ, tv
ЁЯУ╖ => ЁЯУ╖, ри╡рйАрибрйАриУ
ЁЯУ╕ => ЁЯУ╕, риХрйИриори░ри╛, рилри▓рйИри╕, ри╡рйАрибрйАриУ
ЁЯУ╣ => ЁЯУ╣, ри╡рйАрибрйАриУ риХрйИрио, риХрйИриори░ри╛, ри╡рйАрибрйАриУ
ЁЯУ╝ => ЁЯУ╝, ри╡рйАрибрйАриУ риЯрйЗрик, ри╡рйАрибрйАриУ, риЯрйЗрик, vhs
ЁЯФН => ЁЯФН, риорйИриЧриирйАрилри╛риЗрй░риЧ риЧри▓ри╛ри╕, риЦрйЛриЬ, риЦрй▒римрйЗ рикри╛риЗрй░риЯ ридрйЛриВ риорйИриЧриирйАрилри╛риЗрй░риЧ риЧри▓ри╛ри╕, риЦрй▒римри╛ рикри╛риЗрй░риЯ, риЧри▓ри╛ри╕
ЁЯФО => ЁЯФО, риорйИриЧриирйАрилри╛риЗрй░риЧ риЧри▓ри╛ри╕, риЦрйЛриЬ, ри╕рй▒риЬрйЗ рикри╛риЗрй░риЯ ридрйЛриВ риорйИриЧриирйАрилри╛риЗрй░риЧ риЧри▓ри╛ри╕, ри╕рйЛриЬри╛ рикри╛риЗрй░риЯ, риЧри▓ри╛ри╕
ЁЯФм => ЁЯФм, риори╛риИриХри░рйЛри╕риХрйЛрик, риФриЬри╝ри╛ри░
ЁЯФн => ЁЯФн, риФриЬри╝ри╛ри░
ЁЯУб => ЁЯУб, ри╕рйИриЯри▓ри╛риИриЯ рибри┐ри╕ри╝, ри╕рйИриЯри▓ри╛риИриЯ риЕрй░риЯрйАриири╛, риЕрй░риЯрйАриири╛, рибри┐ри╕ри╝, ри╕рйИриЯри▓ри╛риИриЯ, ри╕рй░риЪри╛ри░
ЁЯХп => ЁЯХп, ри░рйМри╕ри╝риирйА, ри▓ри╛риИриЯри░
ЁЯТб => ЁЯТб, риЪри╛риириг римрй▒ри▓рим, риЗрй▒риХ ри╡ри┐риЪри╛ри░ риори┐ри▓ри┐риЖ, римри┐риЬри▓рйА, риЪри╛риириг, римрй▒ри▓рим, риХри╛риори┐риХ
ЁЯФж => ЁЯФж, рилри▓рйИри╕ри╝ ри▓ри╛риИриЯ, риЪри╛риириг, риЯри╛ри░риЪ, римри┐риЬри▓рйА, риФриЬри╝ри╛ри░
ЁЯПо => ЁЯПо, ри▓ри╛ри▓ римрй▒ридрйА, ри▓ри╛ри▓риЯрйЗрии, ри╣рйЛриЯри▓, риЬри╛рикри╛риирйА, римри╛ри░
ЁЯУФ => ЁЯУФ, ри╕риЬри╛риЗриЖ риирйЛриЯримрйБрй▒риХ, ри╕риЬри╛ри╡риЯ риири╛ри▓ риирйЛриЯримрйБрй▒риХ, риирйЛриЯримрйБрй▒риХ, риХри╡ри░
ЁЯУХ => ЁЯУХ, риХри┐ридри╛рим
ЁЯУЦ => ЁЯУЦ, риЦрйБрй▒ри▓рйНри╣рйА риХри┐ридрим, риХри┐ридри╛рим
ЁЯУЧ => ЁЯУЧ, риХри┐ридри╛рим
ЁЯУШ => ЁЯУШ, риХри┐ридри╛рим
ЁЯУЩ => ЁЯУЩ, риХри┐ридри╛рим
ЁЯУЪ => ЁЯУЪ, риХри┐ридри╛рим
ЁЯУУ => ЁЯУУ, риирйЛриЯримрйБрй▒риХ
ЁЯУТ => ЁЯУТ, риирйЛриЯримрйБрй▒риХ
ЁЯУГ => ЁЯУГ, рижри╕ридри╛ри╡рйЗриЬри╝, риХри░ри▓ риири╛ри▓ рикрй░риири╛, рикрй░риири╛
ЁЯУЬ => ЁЯУЬ, рикрйЗрикри░
ЁЯУД => ЁЯУД, рижри╕ридри╛ри╡рйЗриЬри╝, рикрй░риирйЗ рижри╛ риЙрй▒ридри▓ри╛ ри╣ри┐рй▒ри╕ри╛, риЙрй▒ридри▓ри╛ ри╣ри┐рй▒ри╕ри╛, рикрй░риири╛
ЁЯУ░ => ЁЯУ░, риЦри╝римри░ри╛риВ, риЕриЦримри╛ри░, рикрйЗрикри░
ЁЯЧЮ => ЁЯЧЮ, риЦри╝римри░ри╛риВ, риЕриЦримри╛ри░, рикрйЗрикри░, ри▓рикрйЗриЯри┐риЖ риЕриЦримри╛ри░
ЁЯУС => ЁЯУС, римрйБрй▒риХриори╛ри░риХ риЯрйИрим, риори╛ри░риХ, риЯрйИрим, римрйБрй▒риХриори╛ри░риХ, риЪри┐рй░риирйНри╣
ЁЯФЦ => ЁЯФЦ, римрйБрй▒риХриори╛ри░риХ, риори╛ри░риХ, риЪри┐рй░риирйНри╣
ЁЯТ░ => ЁЯТ░, рибри╛ри▓ри░ римрйИриЧ, рикрйИри╕ри╛, римрйИриЧ
ЁЯТ┤ => ЁЯТ┤, рипрйЗрии риирйЛриЯ, римрйИрй▒риХриирйЛриЯ, рипрйЗрии, рикрйИри╕ри╛, римри┐ри▓, риирйЛриЯ, риХри░рй░ри╕рйА
ЁЯТ╡ => ЁЯТ╡, рибри╛ри▓ри░ риирйЛриЯ, римрйИрй▒риХриирйЛриЯ, рибри╛ри▓ри░, рикрйИри╕ри╛, римри┐ри▓, риирйЛриЯ, риХри░рй░ри╕рйА
ЁЯТ╢ => ЁЯТ╢, рипрйВри░рйЛ риирйЛриЯ, рипрйВри░рйЛ, римрйИрй▒риХриирйЛриЯ, рикрйИри╕ри╛, римри┐ри▓, риирйЛриЯ, риХри░рй░ри╕рйА
ЁЯТ╖ => ЁЯТ╖, римрйИриВриХ, рикрйМриВриб, римрйИрй▒риХриирйЛриЯ, рикрйИри╕ри╛, риХри░рй░ри╕рйА, римри┐ри▓
ЁЯТ╕ => ЁЯТ╕, риЙрй▒рибрижрйЗ рикрйИри╕рйЗ, риЦрй░римри╛ риири╛ри▓ рикрйИри╕рйЗ, риЙрйЬрижри╛ римрйИриВриХриирйЛриЯ, римрйИриВриХ, риирйЛриЯ, рикрйИри╕ри╛, римри┐ри▓
ЁЯТ│ => ЁЯТ│, римрйИриВриХ, риХри╛ри░риб, риХрйНри░рйИрибри┐риЯ, рикрйИри╕ри╛
ЁЯТ╣ => ЁЯТ╣, римрйИриВриХ, риЪри╛ри░риЯ, риХри░рй░ри╕рйА, ри╡ри╛ризри╛, ри░рйБриЭри╛рии, риЪрйЬрйНри╣рижри╛ римри╛риЬри╝ри╛ри░, ри╡рй▒ризрижрйЗ ри░рйБриЭри╛рии, риЙрй▒рикри░, римри╛риЬри╝ри╛ри░
тЬЙ => тЬЙ, риИ-риорйЗри▓, риИриорйЗри▓
ЁЯУз => ЁЯУз, риИриорйЗри▓, риорйЗри▓, риЦрй▒рид, ри╕рй░риЪри╛ри░
ЁЯУи => ЁЯУи, риорйЗри▓ риЖриЙригри╛, рикрйНри░ри╛рикрид риХрйАридри╛ риорйЗри▓, риЖриЙригри╛, риИ-риорйЗри▓, риорйЗри▓, риЦрй▒рид, ри▓ри┐рилри╛рилри╛, ри╕рй░риЪри╛ри░
ЁЯУй => ЁЯУй, ринрйЗриЬрйА риЬри╛риг ри╡ри╛ри▓рйА риорйЗри▓, ринрйЗриЬри┐риЖ риорйЗри▓, римри╛ри╣ри░ риЬри╛ригри╛, риИ-риорйЗри▓, риорйЗри▓, риЦрй▒рид, ри▓ри┐рилри╛рилри╛, ри╕рй░риЪри╛ри░, ридрйАри░
ЁЯУд => ЁЯУд, ринрйЗриЬри┐риЖ риорйЗри▓, ринрйЗриЬри┐риЖ римри╛риХри╕, риорйЗри▓, ринрйЗриЬригри╛, римри╛риХри╕, риЖриЙриЯримри╛риХри╕, риЯрйНри░рйЗ, ри╕рй░риЪри╛ри░
ЁЯУе => ЁЯУе, риЗрииримри╛риХри╕, риорйЗри▓ риори┐ри▓рйА, риорйЗри▓, риори┐ри▓рйА, римри╛риХри╕, риЯрйНри░рйЗ, ри╕рй░риЪри╛ри░
ЁЯУж => ЁЯУж, рикри╛ри░ри╕ри▓, римри╛риХри╕
ЁЯУл => ЁЯУл, рикрйЛри╕риЯримри╛риХри╕, римрй░риж, риорйЗри▓римри╛риХри╕ риЪрйЬрйНри╣рижрйЗ риЭрй░рибрйЗ риири╛ри▓, риорйЗри▓, риЭрй░рибри╛
ЁЯУк => ЁЯУк, рикрйЛри╕риЯримри╛риХри╕, римрй░риж, риорйЗри▓римри╛риХри╕ риЭрйБриХрижрйЗ риЭрй░рибрйЗ риири╛ри▓, риорйЗри▓римри╛риХри╕, риорйЗри▓, риЭрй░рибри╛
ЁЯУм => ЁЯУм, рикрйЛри╕риЯримри╛риХри╕, риЦрйЗри▓рйНри╣рйЛ, риЪрйЬрйНри╣рижрйЗ риЭрй░рибрйЗ риири╛ри▓ риорйЗри▓римри╛риХри╕, риорйЗри▓, риЭрй░рибри╛
ЁЯУн => ЁЯУн, рикрйЛри╕риЯримри╛риХри╕, риЦрйЛри▓рйНри╣рйЛ, риЭрйБриХрижрйЗ риЭрй░рибрйЗ риири╛ри▓ риорйЗри▓римри╛риХри╕, риорйЗри▓, риЭрй░рибри╛
ЁЯУо => ЁЯУо, риорйЗри▓, риорйЗри▓римри╛риХри╕
ЁЯЧ│ => ЁЯЧ│, римрйИри▓риЯ, римриХри╕ри╛
тЬП => тЬП, рикрйИриири╕ри┐ри▓
тЬТ => тЬТ, риири┐рим, рикрйИрии, риХри▓рио
ЁЯЦЛ => ЁЯЦЛ, рикрйИрии, риХри▓рио
ЁЯЦК => ЁЯЦК, римри╛ри▓ рикрйБриЖриЗрй░риЯ, риХри▓рио
ЁЯЦМ => ЁЯЦМ, ри░рй░риЧ ринри░риири╛, рикрйЗриВриЯри┐рй░риЧ, риЪри┐рй▒ридри░риХри╛ри░рйА
ЁЯЦН => ЁЯЦН, риХрйНри░рйЗриЖрии
ЁЯУЭ => ЁЯУЭ, рикрйИриВри╕ри┐ри▓
ЁЯТ╝ => ЁЯТ╝, римри░рйАрилриХрйЗри╕
ЁЯУБ => ЁЯУБ, рилри╛риЗри▓ рилрйЛри▓рибри░, рилри╛риЗри▓, рилрйЛри▓рибри░
ЁЯУВ => ЁЯУВ, рилрйЛри▓рибри░ риЦрйЛри▓рйНри╣рйЛ, рилри╛риЗри▓ рилрйЛри▓рибри░ риЦрйЛри▓рйНри╣рйЛ, риЦрйЛри▓рйНри╣рйЛ, рилри╛риЗри▓, рилрйЛри▓рибри░
ЁЯЧВ => ЁЯЧВ, риХри╛ри░риб, ри╡рй░рибриг ри╡ри╛ри▓ри╛, ри╕рйВриЪрйА
ЁЯУЕ => ЁЯУЕ, риори┐ридрйА
ЁЯУЖ => ЁЯУЖ, риХрйИри▓рй░рибри░
ЁЯЧТ => ЁЯЧТ, риирйЛриЯ, рикрйИриб, риирйЛриЯрикрйИриб, риЪрйВрйЬрйАрижри╛ри░
ЁЯЧУ => ЁЯЧУ, риХрйИри▓рй░рибри░, рикрйИриб, риЪрйВрйЬрйАрижри╛ри░
ЁЯУЗ => ЁЯУЗ, риХри╛ри░риб риЗрй░рибрйИриХри╕, ри░рйЛри▓рйЛрибрйИриХри╕ риЗрй░рибрйИриХри╕, ри╕рйВриЪрйА
ЁЯУИ => ЁЯУИ, ри╡ризрижри╛ ри░рйБриЭри╛рии, ри╡ризрижри╛ ри░рйБриЭри╛рии риЪри╛ри░риЯ, риЪри╛ри░риЯ, риЧри░ри╛рил, ри╡ризрижри╛
ЁЯУЙ => ЁЯУЙ, риШрй▒риЯрижри╛ ри░рйБриЭри╛рии, риШрй▒риЯрижри╛ ри░рйБриЭри╛рии риЪри╛ри░риЯ, риЪри╛ри░риЯ, риЧри░ри╛рил, риШрй▒риЯрижри╛
ЁЯУК => ЁЯУК, римри╛ри░ риЧри░ри╛рил, риЪри╛ри░риЯ
ЁЯУЛ => ЁЯУЛ, риХри▓ри┐рй▒рикримрйЛри░риб
ЁЯУМ => ЁЯУМ, рикри┐рй░рии
ЁЯУН => ЁЯУН, рикрйБри╕ри╝ рикри┐рй░рии, рикри┐рй░рии
ЁЯУО => ЁЯУО, риХри▓ри┐рй▒рик
ЁЯЦЗ => ЁЯЦЗ, ри▓ри┐рй░риХ, рикрйЗрикри░риХри▓ри┐рй▒рикри╛риВ
ЁЯУП => ЁЯУП, ри░рйВри▓ри░
ЁЯУР => ЁЯУР, ридри┐риХрйЛригри╛, ри╕рйИрй▒риЯ ри╡ри░риЧ, ри░рйВри▓ри░
тЬВ => тЬВ, риФриЬри╝ри╛ри░
ЁЯЧГ => ЁЯЧГ, римриХри╕ри╛, риХри╛ри░риб, рилри╛риЗри▓
ЁЯЧД => ЁЯЧД, рилри╛риЗри▓ри╛риВ ри╡ри╛ри▓ри╛ риХрйИримри┐риирйИриЯ, рилри╝ри╛риЗри▓ри╛риВ
ЁЯЧС => ЁЯЧС, ри░рй▒рижрйА ри╡ри╛ри▓рйА риЯрйЛриХри░рйА
ЁЯФТ => ЁЯФТ, ри▓ри╛риХ римрй░риж, ри▓рйМриХ, римрй░риж
ЁЯФУ => ЁЯФУ, ри▓ри╛риХ, риЦрйБрй▒ри▓рйНри╣ри╛ ри▓ри╛риХ, риЕригри▓рйМриХ, риЕригри▓ри╛риХ
ЁЯФП => ЁЯФП, ри▓ри╛риХ, рикри░рижрйЗрижри╛ри░рйА, риЗрй▒риХ ри╕ри┐риЖри╣рйА риХри▓рио риири╛ри▓ ри▓ри╛риХ, ри╕ри┐риЖри╣рйА риХри▓рио
ЁЯФР => ЁЯФР, римрй░риж ри▓ри╛риХ, риЗрй▒риХ риХрйБрй░риЬрйА риири╛ри▓ ри▓ри╛риХ, ри╕рйБри░рй▒риЦри┐риЕрид
ЁЯФС => ЁЯФС, рикри╛ри╕ри╡ри░риб, ри▓рйМриХ, ри▓ри╛риХ
ЁЯЧЭ => ЁЯЧЭ, ри╕рйБри░ри╛риЧ, риХрйБрй░риЬрйА, ри▓ри╛риХ, ри▓рйМриХ, рикрйБри░ри╛ригри╛
ЁЯФи => ЁЯФи, риФриЬри╝ри╛ри░
тЫП => тЫП, риЦриирии риФриЬри╝ри╛ри░, риХри╣ри╛рйЬрйА, риФриЬри╝ри╛ри░
тЪТ => тЪТ, ри╣риерйМрйМрйЬри╛ риЕридрйЗ риХри╣ри╛рйЬрйА, риЪрйБрй▒риХригри╛, риФриЬри╝ри╛ри░
ЁЯЫа => ЁЯЫа, риФриЬри╝ри╛ри░, ри░рйИриВриЪ риФриЬри╝ри╛ри░
ЁЯФз => ЁЯФз, риЪри╛римрйА, риФриЬри╝ри╛ри░
ЁЯФй => ЁЯФй, риирй▒риЯ, римрйЛри▓риЯ, риФриЬри╝ри╛ри░
тЪЩ => тЪЩ, риЧри┐риЖри░ риФриЬри╝ри╛ри░, риФриЬри╝ри╛ри░
ЁЯЧЬ => ЁЯЧЬ, риФриЬри╝ри╛ри░, ри╡ри╛риИри╕ риФриЬри╝ри╛ри░
тЪЧ => тЪЧ, ри░ри╕ри╛риЗриг, ри░ри╕ри╛риЗриг ри╡ри┐риЧри┐риЖрии, риФриЬри╝ри╛ри░
тЪЦ => тЪЦ, риЗриири╕ри╛рил, ридрйБри▓ри╛, ри╕риХрйЗри▓, риФриЬри╝ри╛ри░, ринри╛ри░, ри░ри╛ри╕ри╝рйА риЪрй▒риХри░
ЁЯФЧ => ЁЯФЧ, ри▓ри┐рй░риХ риири┐ри╕ри╝ри╛рии, рижрйЛ риХрйЬрйЗ
тЫУ => тЫУ, риЪрйЗрии, риЬри╝рй░риЬрйАри░
ЁЯТЙ => ЁЯТЙ, ри╕ри╝ри╛риЯ, ри╕рйВриИ, рижри╡ри╛риИ, рибри╛риХриЯри░, риФриЬри╝ри╛ри░
ЁЯТК => ЁЯТК, риЧрйЛри▓рйА, рижри╡ри╛риИ, рибри╛риХриЯри░, римрйАриори╛ри░
ЁЯЧб => ЁЯЧб, риЪри╛риХрйВ, ри╣риери┐риЖри░
ЁЯФк => ЁЯФк, риЦри╛ригри╛ рикриХри╛риЙриг риЪри╛риХрйВ, риЪри╛риХрйВ
тЪФ => тЪФ, риХрйНри░ри╛ри╕ риХрйАридрйАриЖриВ, ридри▓ри╡ри╛ри░ри╛риВ, ри╣риери┐риЖри░
ЁЯФл => ЁЯФл, римрй░рижрйВриХ, рикри┐ри╕ридрйМри▓, ри░ри┐ри╡ри╛ри▓ри╡ри░, ри╣риери┐риЖри░
ЁЯЫб => ЁЯЫб, ри╣риери┐риЖри░
ЁЯП╣ => ЁЯП╣, ридрйАри░риЕрй░рижри╛риЬри╝, ридрйАри░, риХриори╛рии, ризриирйБ ри░ри╛ри╕ри╝рйА, риФриЬри╝ри╛ри░, ри╣риери┐риЖри░, ри░ри╛ри╕ри╝рйА риЪрй▒риХри░
ЁЯПБ => ЁЯПБ, риЭрй░рибри╛, рибрй▒римрйАрижри╛ри░, ри░рйЗри╕ри┐рй░риЧ, риЦрйЗриб
ЁЯП│ => ЁЯП│, риЭрй░рибри╛ ри▓ри╣ри┐ри░ри╛риЙригри╛, ри╕рилрйЗриж риЭрй░рибри╛
ЁЯП│тАНЁЯМИ => ЁЯП│тАНЁЯМИ, риЭрй░рибри╛, ри╕ридри░рй░риЧрйА рикрйАриВриШ
ЁЯП┤ => ЁЯП┤, риЭрй░рибри╛ ри▓ри╣ри┐ри░ри╛риЙригри╛, риХри╛ри▓ри╛ риЭрй░рибри╛
ЁЯЪй => ЁЯЪй, ри╕риери┐ридрйА риЭрй░рибри╛, ри╕риери┐ридрйА риЬри╛ригриХри╛ри░рйА риЭрй░рибри╛, ридри┐риХрйЛриирйА ри╕риери┐ридрйА риЭрй░рибри╛, ридри┐риХрйЛриири╛ риЭрй░рибри╛, риЭрй░рибри╛, ри╕риери┐ридрйА
ЁЯЪм => ЁЯЪм, ри╕риорйЛриХри┐рй░риЧ риЪри┐рй░риирйНри╣, ри╕риорйЛриХри┐рй░риЧ, риЪри┐рй░риирйНри╣
тЪ░ => тЪ░, риорйМрид
тЪ▒ => тЪ▒, риорйМрид, ри╕рй░ри╕риХри╛ри░, um
ЁЯЧ┐ => ЁЯЧ┐, риорйЛрипри╛риИ ри╕риЯрйИриЪрйВ, римрйБрй▒рид, риорйЛрипри╛риИ
ЁЯЫв => ЁЯЫв, рибрйНри░рио, ридрйЗри▓
ЁЯФо => ЁЯФо, ри╕ри╝рйАри╕ри╝ри╛ риЧрйЗриВриж, риХри┐ри╕риорид рижрй▒ри╕ригри╛, ри╕ри╝рйАри╕ри╝ри╛, риЧрйЗриВриж, риХри┐ри╕риорид, риФриЬри╝ри╛ри░
ЁЯПз => ЁЯПз, риПриЯрйАриРрио, ри╕ри╡рйИ-риЪри▓рид риЧри┐ригридрйА, ри╕ри╡рйИ-риЪри▓рид, риЧри┐ригриири╛
ЁЯЪо => ЁЯЪо, риХрйВрйЬри╛ римри╛риХри╕, риХрйВрйЬрйЗ риирйВрй░ риЙри╕ рижрйА риери╛риВ тАШридрйЗ ри╕рйБрй▒риЯрйЛ, риЪри┐рй░риирйНри╣
ЁЯЪ░ => ЁЯЪ░, рикрйАригри╛, рикрйАриг ри╡ри╛ри▓ри╛ рикри╛ригрйА риири┐ри╕ри╝ри╛рии, риЪри┐рй░риирйНри╣
тЩ┐ => тЩ┐, рикри╣рйАриЖ риХрйБри░ри╕рйА рикри╣рйБрй░риЪ, рикри╣рйБрй░риЪ, рикри╣рйАриЖ риХрйБри░ри╕рйА рикрйНри░ридрйАриХ, риири┐ри╕ри╝ри╛рии
ЁЯЪ╣ => ЁЯЪ╣, римрй░рижрйЗ, римрй░рижри┐риЖриВ рижри╛ рикрйНри░ридрйАриХ, риири┐ри╕ри╝ри╛рии, риЪри┐рй░риирйНри╣
ЁЯЪ║ => ЁЯЪ║, риФри░ридри╛риВ риири┐ри╕ри╝ри╛рии, риФри░ридри╛риВ рижри╛ рикрйНри░ридрйАриХ, риири┐ри╕ри╝ри╛рии, риЪри┐рй░риирйНри╣
ЁЯЪ╗ => ЁЯЪ╗, риЖри░ри╛рио риХриори░ри╛ риЪри┐рй░риирйНри╣, риЯри╛риЗри▓риЯ, wc
ЁЯЪ╝ => ЁЯЪ╝, римрй▒риЪри╛, римрйЛри░риб ридрйЗ римрй▒риЪри╛, римрижри▓ригри╛, риЪри┐рй░риирйНри╣
ЁЯЪ╛ => ЁЯЪ╛, рилри▓рй▒ри╕ри╝, WC, риЯрйИриВриХрйА, риЯри╛риЗри▓риЯ
ЁЯЫВ => ЁЯЫВ, рикри╛ри╕рикрйЛри░риЯ, риХрй░риЯри░рйЛри▓
ЁЯЫГ => ЁЯЫГ, риХри╕риЯриориЬри╝
ЁЯЫД => ЁЯЫД, ри╕ри╛риори╛рии ридрйЗ рижри╛риЕри╡ри╛, ри╕ри╛риори╛рии
ЁЯЫЕ => ЁЯЫЕ, риЫрй▒рибри┐риЖ ри╕ри╛риори╛рии, ри╕ри╛риори╛рии ри╕рйЗри╡ри╛, ри╕ри╛риори╛рии, ри▓ри╛риХри░
тЪа => тЪа, риЪри┐ридри╛ри╡риирйА риЪри┐рй░риирйНри╣, риЪри┐рй░риирйНри╣
ЁЯЪ╕ => ЁЯЪ╕, римрй▒риЪрйЗ ри▓рй░риШ ри░ри╣рйЗ, римрй▒риЪрйЗ, ри▓рй░риШригри╛, риЪри┐рй░риирйНри╣
тЫФ => тЫФ, рижри╛риЦри▓ри╛ риориирйНри╣ри╛ риЪри┐рй░риирйНри╣, риориирйНри╣ри╛, риЪри┐рй░риирйНри╣
ЁЯЪл => ЁЯЪл, рижри╛риЦри▓ри╛ риири╣рйАриВ риЪри┐рй░риирйНри╣, рижри╛риЦри▓ри╛ риири╣рйАриВ, риЪри┐рй░риирйНри╣
ЁЯЪ│ => ЁЯЪ│, римри╛риИриХ риири╣рйАриВ, ри╕ри╛риИриХри▓ риири╣рйАриВ, ри╕ри╛риИриХри▓ риориириЬри╝рйВри░ риири╣рйАриВ, римри╛риИриХ, ри╡ри╛ри╣рии
ЁЯЪн => ЁЯЪн, ри╕ри┐риЧри░рйЗриЯ риири╣рйАриВ риЪри┐рй░риирйНри╣, ри╕ри┐риЧри░рйЗриЯ риири╣рйАриВ, риЪри┐рй░риирйНри╣, риориирйНри╣ри╛
ЁЯЪп => ЁЯЪп, риХрйВрйЬри╛ риири╛ ри╕рйБрй▒риЯрйЛ риЪри┐рй░риирйНри╣, риХрйВрйЬри╛ риири╛ ри╕рйБрй▒риЯрйЛ, риЪри┐рй░риирйНри╣, риХрйВрйЬри╛
ЁЯЪ▒ => ЁЯЪ▒, рикри╛ригрйА, рикрйАригрипрйЛриЧ риири╣рйАриВ
ЁЯЪ╖ => ЁЯЪ╖, рикрйИрижри▓ риири╣рйАриВ, рикрйИрижри▓ ри▓рйЛриХри╛риВ рижрйА риориириЬри╝рйВри░рйА риири╣рйАриВ, рикрйИрижри▓, риЪри┐рй░риирйНри╣
тШв => тШв, ри░рйЗрибрйАриУриРриХриЯри┐ри╡, ри╕рй░риХрйЗрид
тШг => тШг, риЬрйИри╡ри┐риХ-риЬрйЛриЦрио, ри╕рй░риХрйЗрид
тмЖ => тмЖ, ридрйАри░, риХри╛ри░рибрйАриири▓, рижри┐ри╕ри╝ри╛, риЙрй▒ридри░
тЖЧ => тЖЧ, ридрйАри░, рижри┐ри╕ри╝ри╛, риЗрй░риЯри░риХри╛ри░рибрйАриири▓, риЙрй▒ридри░-рикрйВри░рим
тЮб => тЮб, ридрйАри░, риХри╛ри░рибрйАриири▓, рижри┐ри╕ри╝ри╛, рикрйВри░рим
тЖШ => тЖШ, ридрйАри░, рижри┐ри╕ри╝ри╛, риЗрй░риЯри░риХри╛ри░рибрйАриири▓, рижрй▒риЦриг-рикрйВри░рим
тмЗ => тмЗ, ридрйАри░, риХри╛ри░рибрйАриири▓, рижри┐ри╕ри╝ри╛, риерй▒ри▓рйЗ, рижрй▒риЦриг
тЖЩ => тЖЩ, ридрйАри░, рижри┐ри╕ри╝ри╛, риЗрй░риЯри░риХри╛ри░рибрйАриири▓
тмЕ => тмЕ, ридрйАри░, риХри╛ри░рибрйАриири▓, рижри┐ри╕ри╝ри╛, рикрй▒риЫрио
тЖЦ => тЖЦ, ридрйАри░, рижри┐ри╕ри╝ри╛, риЗрй░риЯри░риХри╛ри░рйАрибриириори▓, риЙрй▒ридри░-рикрй▒риЫрио
тЖХ => тЖХ, ридрйАри░
тЖФ => тЖФ, ридрйАри░
тЖй => тЖй, ридрйАри░
тЖк => тЖк, ридрйАри░
тд┤ => тд┤, ридрйАри░
тд╡ => тд╡, ридрйАри░
ЁЯФГ => ЁЯФГ, ри░рйАри▓рйЛриб, ри░рйАри▓рйЛриб риири┐ри╕ри╝ри╛рии, ри▓рй░римриХри╛ри░рйА риШрйЬрйА рижрйА рижри┐ри╕ри╝ри╛ ри╡ри┐рй▒риЪ ридрйАри░, ридрйАри░
ЁЯФД => ЁЯФД, риШрйЬрйА рижрйА риЙри▓риЯ рижри┐ри╕ри╝ри╛ ри╡ри┐рй▒риЪ ридрйАри░, риШрйЬрйА рижрйА риЙри▓риЯ рижри┐ри╕ри╝ри╛, ридрйАри░
ЁЯФЩ => ЁЯФЩ, рикри┐рй▒риЫрйЗ, рикри┐рй▒риЫрйЗ ридрйАри░, риЦрй▒римрйЗ ридрйАри░ риири╛ри▓ рикри┐рй▒риЫрйЗ, риЦрй▒римри╛ ридрйАри░, ридрйАри░
ЁЯФЪ => ЁЯФЪ, ри╕риори╛рикрид, ри╕риори╛рикрид ридрйАри░, риЦрй▒римрйЗ ридрйАри░ риири╛ри▓ ри╕риори╛рикрид, риЦрй▒римри╛ ридрйАри░, ридрйАри░
ЁЯФЫ => ЁЯФЫ, ON ридрйАри░, ON ри╣рйИри░ри╛риирйАри╡ри╛риЪриХ риири┐ри╕ри╝ри╛рии риири╛ри▓ риЕридрйЗ ридрйАри░, ридрйАри░, ри╣рйИри░ри╛риирйАри╡ри╛риЪриХ риири┐ри╕ри╝ри╛рии, ри╣рйИри░ри╛риирйАри╡ри╛риЪриХ
ЁЯФЬ => ЁЯФЬ, риЬри▓рижрйА риири┐ри╕ри╝ри╛рии, риЬри▓рижрйА, риЬри▓рижрйА риири┐ри╕ри╝ри╛рии ри╕рй▒риЬрйЗ ридрйАри░ риири╛ри▓, ридрйАри░
ЁЯФЭ => ЁЯФЭ, риЙрй▒рикри░ рижри╛ риири┐ри╕ри╝ри╛рии, риЙрй▒рикри░, риЙрй▒ридрйЗ ридрйАри░ риири╛ри▓ риЙрй▒рикри░, риЙрй▒ридрйЗ ридрйАри░, риЙрй▒ридрйЗ
ЁЯЫР => ЁЯЫР, ризри░рио, ринриЧридрйА риХри░риири╛, ринриЧридрйА
тЪЫ => тЪЫ, риири╛ри╕ридриХ, риРриЯрио риЪри┐рй░риирйНри╣
ЁЯХЙ => ЁЯХЙ, ри╣ри┐рй░рижрйВ, риУрио риЪри┐рй░риирйНри╣, ризри░рио
тЬб => тЬб, рибрйЗри╡ри┐риб, рипри╣рйВрижрйА
тШ╕ => тШ╕, римрйЛризрйА, ризри░рио, риЪрй▒риХри░
тШп => тШп, ризри░рио, ридри╛риУ, ридри╛риУри╡ри╛рижрйА, рипрйИриВриЧ, рипри┐рии
тЬЭ => тЬЭ, риЗри╕ри╛риИ, риХрйНри░ри╛ри╕ рижри╛ риЪри┐рй░риирйНри╣, ризри░рио
тШж => тШж, риЗри╕ри╛риИ, риХрйНри░ри╛ри╕ рижри╛ риЪри┐рй░риирйНри╣, ризри░рио
тШк => тШк, риЗри╕ри▓ри╛рио, риорйБри╕ри▓ри┐рио, ризри░рио
тШо => тШо, риЕриории, риЪрйИрии
ЁЯХО => ЁЯХО, риХрйИриВрибри▓ ри╣рйЛри▓рибри░, риорйЛриоримрй▒ридрйА, ризри░рио
ЁЯФп => ЁЯФп, риХри┐ри╕риорид рижри╕ригри╛, риЫрйЗ-римри┐рй░рижрйВ, ридри╛ри░ри╛, риХри┐ри╕риорид
тЩ╗ => тЩ╗, ри░рйАри╕ри╛риИриХри▓ рикрйНри░ридрйАриХ, ри╕ри╛ри▓рйАриб рипрйВриирйАри╡ри░ри╕ри▓ ри░рйАри╕ри╛риИриХри▓ри┐рй░риЧ рикрйНри░ридрйАриХ, ри░рйАри╕ри╛риИриХри▓ри┐рй░риЧ, рипрйВриирйАри╡ри░ри╕ри▓, риири┐ри╕ри╝ри╛рии
ЁЯУЫ => ЁЯУЫ, римрйИриЬ, риири╛риВ
тЪЬ => тЪЬ, риХриорйБрижри┐риирйА рижри╛ рилрйБрй▒ри▓
ЁЯФ░ => ЁЯФ░, ри╣ри░ри╛ риЕридрйЗ рикрйАри▓ри╛ рикрй▒ридри╛, ри╣ри░ри╛ риЕридрйЗ рикрйАри▓ри╛, ри╕ри╝рйВри░рйБриЖридрйА, риЬри╛рикри╛риирйА
ЁЯФ▒ => ЁЯФ▒, ридри┐рйНри░ри╕ри╝рйВри▓ риири┐ри╕ри╝ри╛рии, ри▓рй░риЧри░, ридри┐рйНри░ри╕ри╝рйВри▓, риири┐ри╕ри╝ри╛рии
тнХ => тнХ, риЧрйЛри▓ри╛, ри▓ри╛ри▓, риЧрйЛри▓рйЗ рижри╛ риЪри┐рй░риирйНри╣, o
тЬЕ => тЬЕ, риарйАриХ риЪри┐рй░риирйНри╣, риарйАриХ, ринри╛ри░рйА риарйАриХ риЪри┐рй░риирйНри╣
тШС => тШС, римрйИри▓риЯ, риоридрижри╛рии рикрйЗриЯрйА, римриХри╕ри╛, риЪрйИрй▒риХ риЪри┐рй░риирйНри╣, ри╕ри╣рйА рижри╛ риири┐ри╕ри╝ри╛рии
тЬФ => тЬФ, риЪрйИрй▒риХ риХри░риири╛, риЪрйИрй▒риХ риЪри┐рй░риирйНри╣
тЬЦ => тЬЦ, ри░рй▒риж риХри░риири╛, риЧрйБригри╛ риХри░риири╛, риЧрйБригри╛, риЧрйБригри╛ риЪри┐рй░риирйНри╣
тЭМ => тЭМ, риХри░ри╛ри╕ риЪри┐рй░риирйНри╣, тАЬXтАЭ
тЭО => тЭО, риХри░ри╛ри╕ риЪри┐рй░риирйНри╣, риЦри╝ри╛риирйЗ ри╡ри┐рй▒риЪ тАЬXтАЭ
тЮХ => тЮХ, риЬриорйНри╣ри╛риВ, ринри╛ри░рйА риЬриорйНри╣ри╛риВ риири┐ри╕ри╝ри╛рии, риЬриорйНри╣ри╛риВ риири┐ри╕ри╝ри╛рии, риири┐ри╕ри╝ри╛рии, риЪри┐рй░риирйНри╣
тЮЦ => тЮЦ, риШриЯри╛риУ, ринри╛ри░рйА риШриЯри╛риУ риири┐ри╕ри╝ри╛рии, риШриЯри╛риУ риири┐ри╕ри╝ри╛рии, риири┐ри╕ри╝ри╛рии, риЪри┐рй░риирйНри╣
тЮЧ => тЮЧ, ри╡рй░риб, ринри╛ри░рйА ри╡рй░риб риири┐ри╕ри╝ри╛рии, ри╡рй░риб риири┐ри╕ри╝ри╛рии, риири┐ри╕ри╝ри╛рии, риЪри┐рй░риирйНри╣
тЮ░ => тЮ░, риорйЛрйЬ, ри▓рйВрик
тЮ┐ => тЮ┐, риХри░ри▓рйА ри▓рйВрик, риЬри╛рикри╛рии, рилрйНри░рйА рибри╛риЗри▓
уА╜ => уА╜, риЪри┐рй░риирйНри╣, ринри╛риЧ, ри╣ри┐рй▒ри╕ри╛, риЕрй▒риЦри░
тЬ│ => тЬ│, ридри╛ри░ри╛
тЬ┤ => тЬ┤, ридри╛ри░ри╛
тЭЗ => тЭЗ, ри▓ри┐ри╕ри╝риХ, риЪриориХригри╛
ЁЯТ▒ => ЁЯТ▒, риорйБрй▒рижри░ри╛ римрижри▓рйА, риорйБрй▒рижри░ри╛, рикрйИри╕ри╛, римрижри▓ригри╛
ЁЯТ▓ => ЁЯТ▓, рибри╛ри▓ри░ риири┐ри╕ри╝ри╛рии, риЧрйБрйЬрйНри╣ри╛ рибри╛ри▓ри░ риири┐ри╕ри╝ри╛рии, рибри╛ри▓ри░, рикрйИри╕ри╛
тА╝ => тА╝, римрйИриВриЧ-римрйИриВриЧ, ри╣рйИри░ри╛риирйАри╡ри╛риЪриХ, риЪри┐рй░риирйНри╣, ри╡ри┐ри░ри╛рио риЪри┐рй░риирйНри╣
тБЙ => тБЙ, ри╣рйИри░ри╛риирйАри╡ри╛риЪриХ, ри╕ри╡ри╛ри▓ри┐риЖ риЪри┐рй░риирйНри╣, риЪри┐рй░риирйНри╣, ри╡ри┐ри░ри╛рио риЪри┐рй░риирйНри╣, ри╕ри╡ри╛ри▓
тЭУ => тЭУ, риЪри┐рй░риирйНри╣, ри╕ри╡ри╛ри▓
тЭФ => тЭФ, ри╕ри╡ри╛ри▓ риЪри┐рй░риирйНри╣, ри╕ри╡ри╛ри▓, ри╡ри┐ри░ри╛рио риЪри┐рй░риирйНри╣
тЭХ => тЭХ, ри╣рйИри░ри╛риирйАри╡ри╛риЪриХ, ри╡ри┐ри╕риорйБриХ, ри╡ри┐ри░ри╛рио риЪри┐рй░риирйНри╣, риЪри┐рй░риирйНри╣
тЭЧ => тЭЧ, ри╣рйИри░ри╛риирйАри╡ри╛риЪриХ, риЪри┐рй░риирйНри╣, ри╡ри┐ри░ри╛рио риЪри┐рй░риирйНри╣
уА░ => уА░, ри▓рй░риорйА риЖри╡ри╛риЬри╝ риири┐ри╕ри╝ри╛рии, ри▓ри╣ри┐ри░, рибрйИри╕
┬й => ┬й, риХри╛рикрйАри░ри╛риИриЯ рикрйНри░ридрйАриХ, риХри╛рикрйАри░ри╛риИриЯ
┬о => ┬о, ри░риЬри┐ри╕риЯри░риб рикрйНри░ридрйАриХ, ри░риЬри┐ри╕риЯри░риб
тДв => тДв, риЯрйНри░рйЗрибриори╛ри░риХ риири┐ри╕ри╝ри╛рии, риири┐ри╕ри╝ри╛рии, риЪри┐рй░риирйНри╣
тЩИ => тЩИ, риорйЗриЦ, ри░ри╛ри╕ри╝рйА
тЩЙ => тЩЙ, ри╡рйНри░ри╕ри╝, ри░ри╛ри╕ри╝рйА
тЩК => тЩК, риори┐риерйБрии, ри░ри╛ри╕ри╝рйА
тЩЛ => тЩЛ, риХри░риХ, ри░ри╛ри╕ри╝рйА
тЩМ => тЩМ, ри╕ри┐рй░риЧ, ри░ри╛ри╕ри╝рйА
тЩН => тЩН, риХрй░риири┐риЖ, ри░ри╛ри╕ри╝рйА
тЩО => тЩО, риЗриири╕ри╛рил, ридрйБри▓ри╛, ридрй▒риХрйЬрйА, ри░ри╛ри╕ри╝рйА
тЩП => тЩП, римри┐рй▒риЫрйВ, ри╡рйНри░ри┐ри╕ри╝риЪриХ, ри░ри╛ри╕ри╝рйА
тЩР => тЩР, ризриирйБ, ри░ри╛ри╕ри╝рйА
тЩС => тЩС, риорй▒риХри░, ри░ри╛ри╕ри╝рйА
тЩТ => тЩТ, риХрйБрй░рин, ри░ри╛ри╕ри╝рйА
тЩУ => тЩУ, риорйАрии, ри░ри╛ри╕ри╝рйА
тЫО => тЫО, риЕри╣рйБрижрйЗрижри╛ри░, риЗрй▒риХ ри╡рй▒рибри╛ ри╕рй▒рик, ри░ри╛ри╕ри╝рйА риЪрй▒риХри░
ЁЯФА => ЁЯФА, риЖри░-рикри╛ри░ ридрйАри░, риарйАриХ риЖри░-рикри╛ри░ ридрйАри░, ридрйАри░
ЁЯФБ => ЁЯФБ, риШрйЬрйА рижрйА рижри┐ри╕ри╝ри╛ ри╡ри┐рй▒риЪ ридрйАри░, риШрйЬрйА рижрйА рижри┐ри╕ри╝ри╛, ридрйАри░, рижрйБри╣ри░ри╛риУ
ЁЯФВ => ЁЯФВ, риШрйЬрйА рижрйА рижри┐ри╕ри╝ри╛, риШрйЬрйА рижрйА рижри┐ри╕ри╝ри╛ ри╡ри┐рй▒риЪ ридрйАри░, риЗрй▒риХ ри╡ри╛ри░
тЦ╢ => тЦ╢, ридрйАри░, риЪри▓ри╛риУ, ри╕рй▒риЬрйЗ, ридри┐риХрйЛриг
тПй => тПй, ридрйЗриЬри╝рйА риири╛ри▓ риЕрй▒риЧрйЗ, ри╕рй▒риЬрйЗ рижрйЛ ридрйАри░, ри╕рй▒риЬрйЗ, ридрйАри░
тПн => тПн, ридрйАри░, риЕриЧри▓ри╛ ри╕рйАрии, риЕриЧри▓ри╛ риЯри░рйИриХ, ридри┐риХрйЛриг
тПп => тПп, ридрйАри░, ри░рйЛриХрйЛ, риЪри▓ри╛риУ, ри╕рй▒риЬрйЗ, ридри┐риХрйЛриг
тЧА => тЧА, ридрйАри░, риЦрй▒римрйЗ, рикри┐рй▒риЫрйЗ, рикри┐рй▒риЫрйЗ риЬри╛ригри╛, ридри┐риХрйЛриг
тПк => тПк, риорйЛрйЬригри╛, риЦрй▒римрйЗ рижрйЛ ридрйАри░, риЦрй▒римрйЗ, ридрйАри░
тПо => тПо, ридрйАри░, рикри┐риЫри▓ри╛ ри╕рйАрии, рикри┐риЫри▓ри╛ риЯри░рйИриХ, ридри┐риХрйЛриг
ЁЯФ╝ => ЁЯФ╝, риЙрй▒ридрйЗ ри╡рй▒ри▓ ридри┐риХрйЛригри╛, ридри┐риХрйЛригри╛ римриЯрии риЙрй▒ридрйЗ ри╡рй▒ри▓, ридри┐риХрй▒ригри╛, римриЯрии
тПл => тПл, риЙрй▒рикри░ ридрйАри░, риЙрй▒рикри░ рижрйЛ ридрйАри░, риЙрй▒рикри░, ридрйАри░
ЁЯФ╜ => ЁЯФ╜, риерй▒ри▓рйЗ ри╡рй▒ри▓ ридри┐риХрйЛригри╛, ридри┐риХрйЛригри╛ римриЯрии риерй▒ри▓рйЗ ри╡рй▒ри▓, ридри┐риХрй▒ригри╛, римриЯрии
тПм => тПм, риерй▒ри▓рйЗ ридрйАри░, риерй▒ри▓рйЗ рижрйЛ ридрйАри░, риерй▒ри▓рйЗ, ридрйАри░
тП╕ => тП╕, римри╛ри░, рикрй▒риЯрйА, риХрйАриХрйИрик ри░рйЛриХригри╛, ри▓рй░римриХри╛ри░рйА
тП╣ => тП╣, ри╡ри░риЧ, риХрйАриХрйИрик, ри░рйЛриХригри╛
тП║ => тП║, риЧрйЛри▓ри╛, риХрйАриХрйИрик, ри░ри┐риХри╛ри░риб риХри░риири╛
тПП => тПП, риХрй▒риврйЛ, риХрйАриХрйИрик, риХрй▒ривригри╛
ЁЯОж => ЁЯОж, рилри┐ри▓рио, риорйВри╡рйА, риориирйЛри░рй░риЬрии
ЁЯФЕ => ЁЯФЕ, риШрй▒риЯ риЪриориХ, риШрй▒риЯ, риХриориЬри╝рйЛри░, риШрй▒риЯ риЪриориХ риири┐ри╕ри╝ри╛рии, риЪриориХ
ЁЯФЖ => ЁЯФЖ, ри╡рй▒риз риЪриориХ, риЪриориХрижри╛ри░, ри╡рй▒риз, ри╡рй▒риз риЪриориХ риири┐ри╕ри╝ри╛рии, риЪриориХ
ЁЯУ╢ => ЁЯУ╢, риорйЛримри╛риЗри▓ ри╕ри┐риЧриири▓, римри╛ри░ риири╛ри▓ риЕрй░риЯрйАриири╛, ри╕ри┐риЧриири▓ ридри╛риХрид, ри╕ри┐риЧриири▓, риЕрй░риЯрйАриири╛, риорйЛримри╛риЗри▓, риЯрйИри▓рйАрилрйЛрии
ЁЯУ╡ => ЁЯУ╡, ри╕рйИри▓, рикри╛римрй░рижрйА, рилрйЛрии, риири╣рйАриВ, риорйЛримри╛риЗри▓, риЯрйИри▓рйАрилрйЛрии
ЁЯУ│ => ЁЯУ│, риХрй░римригрйА, риорйЛриб, ри╕рйИрй▒ри▓, рилрйЛрии, риорйЛримри╛риЗри▓
ЁЯУ┤ => ЁЯУ┤, рилрйЛрии, ри╕рйИрй▒ри▓ рилрйЛрии, риЯрйИри▓рйАрилрйЛрии, риорйЛримри╛риЗри▓ рилрйЛрии, римрй░риж
#тГг => #тГг, ри╣рйИри╕ри╝, риХрйАриХрйИрик
*тГг => *тГг, ридри╛ри░ри╛, риХрйАриХрйИрик, ридри╛ри░ри╛
ЁЯФЯ => ЁЯФЯ, 10, риХрйАриХрйИрик, рижри╕
ЁЯТп => ЁЯТп, 100, рикрйВри░рйЗ, ри╕риХрйЛри░
ЁЯФЮ => ЁЯФЮ, риХрйЛриИ 18 ридрйЛриВ риерй▒ри▓рйЗ риири╣рйАриВ, 18 ридрйЛриВ риерй▒ри▓рйЗ риориири╛ри╣рйА, 18 ридрйЛриВ риерй▒ри▓рйЗ, 18
ЁЯФа => ЁЯФа, ри╡рй▒рибрйЗ риЕрй▒риЦри░, ри╡рй▒рибрйЗ ри▓рйЗриЯри┐рии, ри╡рй▒рибрйЗ, ри▓рйЗриЯри┐рии
ЁЯФб => ЁЯФб, abcd, риЫрйЛриЯрйЗ риЕрй▒риЦри░, риЫрйЛриЯрйЗ ри▓рйЗриЯри┐рии, риЫрйЛриЯрйЗ, ри▓рйЗриЯри┐рии
ЁЯФв => ЁЯФв, 1234, риЗриирикрйБрй▒риЯ, риирй░римри░
ЁЯФг => ЁЯФг, риири┐ри╕ри╝ри╛рии, риЪри┐рй░риирйНри╣, риЗриирикрйБрй▒риЯ риири┐ри╕ри╝ри╛рии
ЁЯФд => ЁЯФд, abc, ри▓рйЗриЯри┐рии риЕрй▒риЦри░, ри▓рйЗриЯри┐рии риЕрй░риЧри░рйЗриЬри╝рйА, риПримрйАри╕рйА
ЁЯЕ░ => ЁЯЕ░, риЦрйВрии риХри┐ри╕рио A, риХри┐ри╕рио A, риЦрйВрии риХри┐ри╕рио, риЦрйВрии, A
ЁЯЖО => ЁЯЖО, риЦрйВрии риХри┐ри╕рио AB, риХри┐ри╕рио AB, риЦрйВрии риХри┐ри╕рио, риЦрйВрии, AB
ЁЯЕ▒ => ЁЯЕ▒, риЦрйВрии риХри┐ри╕рио B, риХри┐ри╕рио B, риЦрйВрии риХри┐ри╕рио, риЦрйВрии, B
ЁЯЖС => ЁЯЖС, CL, ри╕ри╛рил, CL риири┐ри╕ри╝ри╛рии, риЪри┐рй░риирйНри╣
ЁЯЖТ => ЁЯЖТ, риарй░рибри╛, риЪри┐рй░риирйНри╣
ЁЯЖУ => ЁЯЖУ, риорйБрилри╝рид, риЪри┐рй░риирйНри╣, риири┐ри╕ри╝ри╛рии
тД╣ => тД╣, i, риЬри╛ригриХри╛ри░рйА
ЁЯЖФ => ЁЯЖФ, ID, ID риири┐ри╕ри╝ри╛рии, рикриЫри╛риг, риири┐ри╕ри╝ри╛рии
тУВ => тУВ, риЧрйЛри▓ри╛, m
ЁЯЖХ => ЁЯЖХ, риири╡ри╛риВ, риири╡ри╛риВ риЪри┐рй░риирйНри╣, риири┐ри╕ри╝ри╛рии
ЁЯЖЦ => ЁЯЖЦ, NG, риЪри┐рй░риирйНри╣, риири┐ри╕ри╝ри╛рии
ЁЯЕ╛ => ЁЯЕ╛, риЦрйВрии риХри┐ри╕рио O, риХри┐ри╕рио O, риЦрйВрии риХри┐ри╕рио, риЦрйВрии, O
ЁЯЖЧ => ЁЯЖЧ, риарйАриХ, риЪрй░риЧри╛, риарйАриХ рижри╛ рикрйНри░ридрйАриХ
ЁЯЕ┐ => ЁЯЕ┐, рикри╛ри░риХри┐рй░риЧ
ЁЯЖШ => ЁЯЖШ, SOS, SOS риири┐ри╕ри╝ри╛рии, ри╕ри╣ри╛риЗридри╛, риири┐ри╕ри╝ри╛рии, риЪри┐рй░риирйНри╣
ЁЯЖЩ => ЁЯЖЩ, UP!, UP! риири┐ри╕ри╝ри╛рии, риири┐ри╕ри╝ри╛рии, риЪри┐рй░риирйНри╣
ЁЯЖЪ => ЁЯЖЪ, римриири╛рио, vs, vs риири┐ри╕ри╝ри╛рии, риири┐ри╕ри╝ри╛рии, риЪри┐рй░риирйНри╣
ЁЯИБ => ЁЯИБ, риЬри╛рикри╛риирйА ри╕ри╝римриж
ЁЯИВ => ЁЯИВ, риЬри╛рикри╛риирйА ри╕ри╝римриж
ЁЯИ╖ => ЁЯИ╖, риЬри╛рикри╛риирйА ри╕ри╝римриж
ЁЯИ╢ => ЁЯИ╢, риЬри╛рикри╛риирйА ри╕ри╝римриж
ЁЯИп => ЁЯИп, риЬри╛рикри╛риирйА ри╕ри╝римриж
ЁЯЙР => ЁЯЙР, риЬри╛рикри╛риирйА ри╕ри╝римриж
ЁЯИ╣ => ЁЯИ╣, риЬри╛рикри╛риирйА ри╕ри╝римриж
ЁЯИЪ => ЁЯИЪ, риЬри╛рикри╛риирйА ри╕ри╝римриж
ЁЯИ▓ => ЁЯИ▓, риЬри╛рикри╛риирйА ри╕ри╝римриж
ЁЯЙС => ЁЯЙС, риЪрйАриирйА ри╕ри╝римриж
ЁЯИ╕ => ЁЯИ╕, риЪрйАриирйА ри╕ри╝римриж
ЁЯИ┤ => ЁЯИ┤, риЪрйАриирйА ри╕ри╝римриж
ЁЯИ│ => ЁЯИ│, риЪрйАриирйА ри╕ри╝римриж
уКЧ => уКЧ, риЪрйАриирйА, ри╡ризри╛риИ, ри╡ризри╛риИриЖриВ, риЖриИрибри┐риУриЧрйНри░ри╛рил
уКЩ => уКЩ, риЪрйАриирйА, риЖриИрибри┐риУриЧрйНри░ри╛рил, риЧрйБрикрид
ЁЯИ║ => ЁЯИ║, риЪрйАриирйА ри╕ри╝римриж
ЁЯИ╡ => ЁЯИ╡, риЪрйАриирйА ри╕ри╝римриж
тЦк => тЦк, риЬрипри╛риори┐ридрйА, ри╡ри░риЧ
тЦл => тЦл, риЬрипри╛риори┐ридрйА, ри╡ри░риЧ
тЧ╗ => тЧ╗, риЬрипри╛риори┐ридрйА, ри╡ри░риЧ
тЧ╝ => тЧ╝, риЬрипри╛риори┐ридрйА, ри╡ри░риЧ
тЧ╜ => тЧ╜, риЬрипри╛риори┐ридрйА, ри╡ри░риЧ
тЧ╛ => тЧ╛, риЬрипри╛риори┐ридрйА, ри╡ри░риЧ
тмЫ => тмЫ, риЬрипри╛риори┐ридрйА, ри╡ри░риЧ
тмЬ => тмЬ, риЬрипри╛риори┐ридрйА, ри╡ри░риЧ
ЁЯФ╢ => ЁЯФ╢, ри╡рй▒рибри╛ ри╣рйАри░ри╛, ри╣рйАри░ри╛, ри╕рй░ридри░рйА, риЬрипри╛риори┐ридрйА
ЁЯФ╖ => ЁЯФ╖, ри╡рй▒рибри╛ ри╣рйАри░ри╛, ри╣рйАри░ри╛, риирйАри▓ри╛, риЬрипри╛риори┐ридрйА
ЁЯФ╕ => ЁЯФ╕, риЫрйЗрйЛриЯри╛ ри╣рйАри░ри╛, ри╣рйАри░ри╛, ри╕рй░ридри░рйА, риЬрипри╛риори┐ридрйА
ЁЯФ╣ => ЁЯФ╣, риЫрйЗрйЛриЯри╛ ри╣рйАри░ри╛, ри╣рйАри░ри╛, риирйАри▓ри╛, риЬрипри╛риори┐ридрйА
ЁЯФ║ => ЁЯФ║, риЙрй▒ридрйЗ ри╡рй▒ри▓ ридри┐риХрйЛригри╛, ридри┐риХрйЛригри╛, ри▓ри╛ри▓, риЬрипри╛риори┐ридрйА
ЁЯФ╗ => ЁЯФ╗, риерй▒ри▓рйЗ ри╡рй▒ри▓ ридри┐риХрйЛригри╛, ридри┐риХрйЛригри╛, ри▓ри╛ри▓, риЬрипри╛риори┐ридрйА
ЁЯТа => ЁЯТа, риХри╛риори┐риХ, ри╕рйЛри╣ригри╛, рилрйБрй▒ри▓, ри╣рйАри░рйЗ рижри╛ риЕриХри╛ри░, ри╣рйАри░ри╛, риЬрипри╛риори┐ридрйА
ЁЯФШ => ЁЯФШ, риЬрипри╛риори┐ридрйА, римриЯрии, ри░рйЗрибрйАриУ
ЁЯФ▓ => ЁЯФ▓, ри╡ри░риЧ римриЯрии, риЬрипри╛риори┐ридрйА, ри╡ри░риЧ, римриЯрии
ЁЯФ│ => ЁЯФ│, ри╡ри░риЧ римриЯрии, риЬрипри╛риори┐ридрйА, ри╡ри░риЧ, римриЯрии, ри░рйЗриЦри╛риВриХри┐рид
тЪк => тЪк, риЧрйЛри▓ри╛, риЪрй▒риХри░, риЬрипри╛риори┐ридрйА
тЪл => тЪл, риЧрйЛри▓ри╛, риЪрй▒риХри░, риЬрипри╛риори┐ридрйА
ЁЯФ┤ => ЁЯФ┤, ри▓ри╛ри▓, риЧрйЛри▓ри╛, риШрйЗри░ри╛, риЬрипри╛риори┐ридрйА
ЁЯФ╡ => ЁЯФ╡, риирйАри▓ри╛, риЧрйЛри▓ри╛, риШрйЗри░ри╛, риЬрипри╛риори┐ридрйА
ЁЯЫС => ЁЯЫС, риЕрй▒риариХрйЛриг, ри╕рй░риХрйЗрид, ри░рйБриХрйЛ
ЁЯЫТ => ЁЯЫТ, риЦри░рйАрижрижри╛ри░рйА риЫриХрйЬри╛, риЧрй▒рибрйА, риЯри░ри╛ри▓рйА, риЧрибрйНри╣рйАри░ри╛
ЁЯЫ┤ => ЁЯЫ┤, ри╕риХрйВриЯри░, ри▓рй▒рид
ЁЯЫ╡ => ЁЯЫ╡, риорйЛриЯри░, ри╕риХрйВриЯри░
ЁЯЫ╢ => ЁЯЫ╢, рикриЦрй░рибрйА, риХри┐ри╕ри╝ридрйА
0тГг => 0тГг, риХрйАриХрйИрик, ри╕ри┐рилри╝ри░
1тГг => 1тГг, 1, риХрйАриХрйИрик, риЗрй▒риХ
2тГг => 2тГг, 2, риХрйАриХрйИрик, рижрйЛ
3тГг => 3тГг, 3, риХрйАриХрйИрик, ридри┐рй░рии
4тГг => 4тГг, 4, риХрйАриХрйИрик, риЪри╛ри░
5тГг => 5тГг, 5, риХрйАриХрйИрик, рикрй░риЬ
6тГг => 6тГг, 6, риХрйАриХрйИрик, риЫрйЗ
7тГг => 7тГг, 7, риХрйАриХрйИрик, ри╕рй▒рид
8тГг => 8тГг, 8, риХрйАриХрйИрик, риЕрй▒риа
9тГг => 9тГг, 9, риХрйАриХрйИрик, риирйМ
ЁЯЗжЁЯЗи => ЁЯЗжЁЯЗи, риЕри╕рйИриВри╕ри╝рии риЯри╛рикрйВ
ЁЯЗжЁЯЗй => ЁЯЗжЁЯЗй, риЕрй░рибрйЛри░ри╛
ЁЯЗжЁЯЗк => ЁЯЗжЁЯЗк, ри╕рй░рипрйБриХрид риЕри░рим риЕриорйАри░ри╛рид
ЁЯЗжЁЯЗл => ЁЯЗжЁЯЗл, риЕрилри╝риЧри╛риири┐ри╕ридри╛рии
ЁЯЗжЁЯЗм => ЁЯЗжЁЯЗм, риРриВриЯрйАриЧрйБриЖ риЕридрйЗ римри╛ри░римрйБрибри╛
ЁЯЗжЁЯЗо => ЁЯЗжЁЯЗо, риЕрй░риЧрйБриЗри▓ри╛
ЁЯЗжЁЯЗ▒ => ЁЯЗжЁЯЗ▒, риЕри▓римри╛риирйАриЖ
ЁЯЗжЁЯЗ▓ => ЁЯЗжЁЯЗ▓, риЕри░риорйАриирйАриЖ
ЁЯЗжЁЯЗ┤ => ЁЯЗжЁЯЗ┤, риЕрй░риЧрйЛри▓ри╛
ЁЯЗжЁЯЗ╢ => ЁЯЗжЁЯЗ╢, риЕрй░риЯри╛ри░риХриЯри┐риХри╛
ЁЯЗжЁЯЗ╖ => ЁЯЗжЁЯЗ╖, риЕри░риЬриириЯрйАриири╛
ЁЯЗжЁЯЗ╕ => ЁЯЗжЁЯЗ╕, риЕриорйИри░рйАриХрии ри╕риорйЛриЖ
ЁЯЗжЁЯЗ╣ => ЁЯЗжЁЯЗ╣, риЖри╕риЯри░рйАриЖ
ЁЯЗжЁЯЗ║ => ЁЯЗжЁЯЗ║, риЖри╕риЯрйНри░рйЗри▓рйАриЖ
ЁЯЗжЁЯЗ╝ => ЁЯЗжЁЯЗ╝, риЕри░рйВримри╛
ЁЯЗжЁЯЗ╜ => ЁЯЗжЁЯЗ╜, риЕри▓рйИриВриб риЯри╛рикрйВ
ЁЯЗжЁЯЗ┐ => ЁЯЗжЁЯЗ┐, риЕриЬри╝ри░римри╛риИриЬри╛рии
ЁЯЗзЁЯЗж => ЁЯЗзЁЯЗж, римрйЛри╕риирйАриЖ риЕридрйЗ ри╣ри░риЬри╝рйЗриЧрйЛри╡рйАриири╛
ЁЯЗзЁЯЗз => ЁЯЗзЁЯЗз, римри╛ри░римри╛рибрйЛри╕
ЁЯЗзЁЯЗй => ЁЯЗзЁЯЗй, римрй░риЧри▓ри╛рижрйЗри╕ри╝
ЁЯЗзЁЯЗк => ЁЯЗзЁЯЗк, римрйИри▓риЬрйАриЕрио
ЁЯЗзЁЯЗл => ЁЯЗзЁЯЗл, римрйБри░риХрйАриири╛ рилри╝ри╛ри╕рйЛ
ЁЯЗзЁЯЗм => ЁЯЗзЁЯЗм, римрйБри▓риЧри╛ри░рйАриЖ
ЁЯЗзЁЯЗн => ЁЯЗзЁЯЗн, римри╣ри┐ри░рйАрии
ЁЯЗзЁЯЗо => ЁЯЗзЁЯЗо, римрйБри░рйБрй░рибрйА
ЁЯЗзЁЯЗп => ЁЯЗзЁЯЗп, римрйЗриири┐рии
ЁЯЗзЁЯЗ▒ => ЁЯЗзЁЯЗ▒, ри╕рйЗриВриЯ римри╛ри░риерйЗри▓рйЗриорйА
ЁЯЗзЁЯЗ▓ => ЁЯЗзЁЯЗ▓, римри░риорйВрибри╛
ЁЯЗзЁЯЗ│ => ЁЯЗзЁЯЗ│, римри░рйВриирйЗриИ
ЁЯЗзЁЯЗ┤ => ЁЯЗзЁЯЗ┤, римрйЛри▓рйАри╡рйАриЖ
ЁЯЗзЁЯЗ╢ => ЁЯЗзЁЯЗ╢, риХрйИри░рйЗримрйАриЖриИ риирйАрижри░ри▓рйИриВриб
ЁЯЗзЁЯЗ╖ => ЁЯЗзЁЯЗ╖, римрйНри░ри╛риЬри╝рйАри▓
ЁЯЗзЁЯЗ╕ => ЁЯЗзЁЯЗ╕, римри╣ри╛риори╛ри╕
ЁЯЗзЁЯЗ╣ => ЁЯЗзЁЯЗ╣, ринрйВриЯри╛рии
ЁЯЗзЁЯЗ╗ => ЁЯЗзЁЯЗ╗, римрйМри╡рйЗриЯ риЯри╛рикрйВ
ЁЯЗзЁЯЗ╝ => ЁЯЗзЁЯЗ╝, римрйЛридри╕ри╡ри╛риири╛
ЁЯЗзЁЯЗ╛ => ЁЯЗзЁЯЗ╛, римрйЗри▓ри╛ри░рйВри╕
ЁЯЗзЁЯЗ┐ => ЁЯЗзЁЯЗ┐, римрйЗри▓рйАриЬри╝
ЁЯЗиЁЯЗж => ЁЯЗиЁЯЗж, риХрйИриирйЗрибри╛
ЁЯЗиЁЯЗи => ЁЯЗиЁЯЗи, риХрйЛриХрйЛри╕ (риХрйАри▓ри┐рй░риЧ) риЯри╛рикрйВ
ЁЯЗиЁЯЗй => ЁЯЗиЁЯЗй, риХри╛риВриЧрйЛ - риХри┐рй░ри╕ри╝ри╛ри╕ри╛
ЁЯЗиЁЯЗл => ЁЯЗиЁЯЗл, риХрйЗриВрижри░рйА риЕрилри╝ри░рйАриХрйА риЧригри░ри╛риЬ
ЁЯЗиЁЯЗм => ЁЯЗиЁЯЗм, риХри╛риВриЧрйЛ - римрйНри░ри╛риЬри╝ри╛ри╡ри┐ри▓рйЗ
ЁЯЗиЁЯЗн => ЁЯЗиЁЯЗн, ри╕ри╡ри┐риЯриЬри╝ри░ри▓рйИриВриб
ЁЯЗиЁЯЗо => ЁЯЗиЁЯЗо, риХрйЛриЯ рибрйАри╡рйЛриЖри░
ЁЯЗиЁЯЗ░ => ЁЯЗиЁЯЗ░, риХрйБрй▒риХ риЯри╛рикрйВ
ЁЯЗиЁЯЗ▒ => ЁЯЗиЁЯЗ▒, риЪри┐ри▓рйА
ЁЯЗиЁЯЗ▓ => ЁЯЗиЁЯЗ▓, риХрйИриори░рйВрии
ЁЯЗиЁЯЗ│ => ЁЯЗиЁЯЗ│, риЪрйАрии
ЁЯЗиЁЯЗ┤ => ЁЯЗиЁЯЗ┤, риХрйЛри▓рй░римрйАриЖ
ЁЯЗиЁЯЗ╡ => ЁЯЗиЁЯЗ╡, риХри▓ри┐рй▒рикри░риЯрии риЯри╛рикрйВ
ЁЯЗиЁЯЗ╖ => ЁЯЗиЁЯЗ╖, риХрйЛри╕риЯри╛ ри░рйАриХри╛
ЁЯЗиЁЯЗ║ => ЁЯЗиЁЯЗ║, риХри┐риКримри╛
ЁЯЗиЁЯЗ╗ => ЁЯЗиЁЯЗ╗, риХрйЗрик ри╡ри░рибрйЗ
ЁЯЗиЁЯЗ╝ => ЁЯЗиЁЯЗ╝, риХрйБри░ри╛риХри╛риУ
ЁЯЗиЁЯЗ╜ => ЁЯЗиЁЯЗ╜, риХрйНри░ри┐ри╕риори┐ри╕ риЯри╛рикрйВ
ЁЯЗиЁЯЗ╛ => ЁЯЗиЁЯЗ╛, ри╕ри╛риЗрикрйНри░ри╕
ЁЯЗиЁЯЗ┐ => ЁЯЗиЁЯЗ┐, риЪрйИрй▒риХ риЧригри░ри╛риЬ
ЁЯЗйЁЯЗк => ЁЯЗйЁЯЗк, риЬри░риориирйА
ЁЯЗйЁЯЗм => ЁЯЗйЁЯЗм, рибрйАриЗриЧрйЛ риЧри╛ри░ри╕рйАриЖ
ЁЯЗйЁЯЗп => ЁЯЗйЁЯЗп, риЬри╝рйАримрйВридрйА
ЁЯЗйЁЯЗ░ => ЁЯЗйЁЯЗ░, рибрйИриириори╛ри░риХ
ЁЯЗйЁЯЗ▓ => ЁЯЗйЁЯЗ▓, рибрйЛриорйАриири┐риХри╛
ЁЯЗйЁЯЗ┤ => ЁЯЗйЁЯЗ┤, рибрйЛриорйАриири┐риХри╛риИ риЧригри░ри╛риЬ
ЁЯЗйЁЯЗ┐ => ЁЯЗйЁЯЗ┐, риЕри▓риЬрйАри░рйАриЖ
ЁЯЗкЁЯЗж => ЁЯЗкЁЯЗж, ри╕ри┐риУриЯри╛ риЕридрйЗ риорйЗри▓ри┐рй▒ри▓ри╛
ЁЯЗкЁЯЗи => ЁЯЗкЁЯЗи, риЗриХри╡рйЗрибрйЛри░
ЁЯЗкЁЯЗк => ЁЯЗкЁЯЗк, риЗри╕риЯрйЛриирйАриЖ
ЁЯЗкЁЯЗм => ЁЯЗкЁЯЗм, риори┐ри╕ри░
ЁЯЗкЁЯЗн => ЁЯЗкЁЯЗн, рикрй▒риЫриорйА ри╕ри╣ри╛ри░ри╛
ЁЯЗкЁЯЗ╖ => ЁЯЗкЁЯЗ╖, риЗри░рйАриЯрйНри░ри┐риЖ
ЁЯЗкЁЯЗ╕ => ЁЯЗкЁЯЗ╕, ри╕рикрйЗрии
ЁЯЗкЁЯЗ╣ => ЁЯЗкЁЯЗ╣, риЗриерйЛрикрйАриЖ
ЁЯЗкЁЯЗ║ => ЁЯЗкЁЯЗ║, рипрйВри░рикрйА ри╕рй░риШ
ЁЯЗлЁЯЗо => ЁЯЗлЁЯЗо, рилри┐риири▓рйИриВриб
ЁЯЗлЁЯЗп => ЁЯЗлЁЯЗп, рилри╝ри┐риЬрйА
ЁЯЗлЁЯЗ░ => ЁЯЗлЁЯЗ░, рилри╝ри╛риХри▓рйИриВриб риЯри╛рикрйВ
ЁЯЗлЁЯЗ▓ => ЁЯЗлЁЯЗ▓, риори╛риЗриХрйНри░рйЛриирйЗри╕ри╝рйАриЖ
ЁЯЗлЁЯЗ┤ => ЁЯЗлЁЯЗ┤, рилрйИри░рйЛ риЯри╛рикрйВ
ЁЯЗлЁЯЗ╖ => ЁЯЗлЁЯЗ╖, рилри╝ри░ри╛риВри╕
ЁЯЗмЁЯЗж => ЁЯЗмЁЯЗж, риЧримрйЛрии
ЁЯЗмЁЯЗз => ЁЯЗмЁЯЗз, рипрйВриири╛риИриЯриб риХри┐рй░риЧрибрио
ЁЯЗмЁЯЗй => ЁЯЗмЁЯЗй, риЧрйНри░рйЗриири╛рибри╛
ЁЯЗмЁЯЗк => ЁЯЗмЁЯЗк, риЬри╛ри░риЬрйАриЖ
ЁЯЗмЁЯЗл => ЁЯЗмЁЯЗл, рилри░рйИриВриЪ риЧрйБриЗриЖриири╛
ЁЯЗмЁЯЗм => ЁЯЗмЁЯЗм, риЧри░риириЬрйА
ЁЯЗмЁЯЗн => ЁЯЗмЁЯЗн, риШри╛риири╛
ЁЯЗмЁЯЗо => ЁЯЗмЁЯЗо, риЬри┐римри░ри╛ри▓риЯри░
ЁЯЗмЁЯЗ▒ => ЁЯЗмЁЯЗ▒, риЧрйНри░рйАриири▓рйИриВриб
ЁЯЗмЁЯЗ▓ => ЁЯЗмЁЯЗ▓, риЧрйИриВримрйАриЖ
ЁЯЗмЁЯЗ│ => ЁЯЗмЁЯЗ│, риЧри┐риирйА
ЁЯЗмЁЯЗ╡ => ЁЯЗмЁЯЗ╡, риЧрйБриЖрибрйЗри▓рйЛрик
ЁЯЗмЁЯЗ╢ => ЁЯЗмЁЯЗ╢, ринрйВ-риЦрй░рибрйА риЧри┐риирйА
ЁЯЗмЁЯЗ╖ => ЁЯЗмЁЯЗ╖, риЧрйНри░рйАри╕
ЁЯЗмЁЯЗ╕ => ЁЯЗмЁЯЗ╕, рижрй▒риЦригрйА риЬри╛ри░риЬрйАриЖ риЕридрйЗ рижрй▒риЦригрйА ри╕рйИриВрибри╡ри┐риЪ риЯри╛рикрйВ
ЁЯЗмЁЯЗ╣ => ЁЯЗмЁЯЗ╣, риЧрйБриЖриЯрйЗриори╛ри▓ри╛
ЁЯЗмЁЯЗ║ => ЁЯЗмЁЯЗ║, риЧрйБриЖрио
ЁЯЗмЁЯЗ╝ => ЁЯЗмЁЯЗ╝, риЧри┐риирйА-римри┐ри╕ри╛риЙ
ЁЯЗмЁЯЗ╛ => ЁЯЗмЁЯЗ╛, риЧрйБрипри╛риири╛
ЁЯЗнЁЯЗ░ => ЁЯЗнЁЯЗ░, ри╣ри╛риВриЧ риХри╛риВриЧ риРри╕риПриЖри░ риЪрйАрии
ЁЯЗнЁЯЗ▓ => ЁЯЗнЁЯЗ▓, ри╣ри░риб ридрйЗ риорйИриХрибрйЛриири╛ри▓риб риЯри╛рикрйВ
ЁЯЗнЁЯЗ│ => ЁЯЗнЁЯЗ│, ри╣рйЛриВрибрйБри░ри╕
ЁЯЗнЁЯЗ╖ => ЁЯЗнЁЯЗ╖, риХри░рйЛриПри╕ри╝рйАриЖ
ЁЯЗнЁЯЗ╣ => ЁЯЗнЁЯЗ╣, ри╣рйИридрйА
ЁЯЗнЁЯЗ║ => ЁЯЗнЁЯЗ║, ри╣рй░риЧри░рйА
ЁЯЗоЁЯЗи => ЁЯЗоЁЯЗи, риХрйЗриири╛ри░рйА риЯри╛рикрйВ
ЁЯЗоЁЯЗй => ЁЯЗоЁЯЗй, риЗрй░рибрйЛриирйЗри╕ри╝рйАриЖ
ЁЯЗоЁЯЗк => ЁЯЗоЁЯЗк, риЖриЗри░ри▓рйИриВриб
ЁЯЗоЁЯЗ▒ => ЁЯЗоЁЯЗ▒, риЗриЬри╝ри░ри╛риИри▓
ЁЯЗоЁЯЗ▓ => ЁЯЗоЁЯЗ▓, риЖриЗри▓ риЖрил риорйИрии
ЁЯЗоЁЯЗ│ => ЁЯЗоЁЯЗ│, ринри╛ри░рид
ЁЯЗоЁЯЗ┤ => ЁЯЗоЁЯЗ┤, римри░ридри╛риири╡рйА ри╣ри┐рй░риж риори╣ри╛риВри╕ри╛риЧри░ риЦри┐рй▒ридри╛
ЁЯЗоЁЯЗ╢ => ЁЯЗоЁЯЗ╢, риЗри░ри╛риХ
ЁЯЗоЁЯЗ╖ => ЁЯЗоЁЯЗ╖, риИри░ри╛рии
ЁЯЗоЁЯЗ╕ => ЁЯЗоЁЯЗ╕, риЖриИри╕ри▓рйИриВриб
ЁЯЗоЁЯЗ╣ => ЁЯЗоЁЯЗ╣, риЗриЯри▓рйА
ЁЯЗпЁЯЗк => ЁЯЗпЁЯЗк, риЬри░ри╕рйА
ЁЯЗпЁЯЗ▓ => ЁЯЗпЁЯЗ▓, риЬриори╛риЗриХри╛
ЁЯЗпЁЯЗ┤ => ЁЯЗпЁЯЗ┤, риЬри╛ри░рибрии
ЁЯЗпЁЯЗ╡ => ЁЯЗпЁЯЗ╡, риЬрикри╛рии
ЁЯЗ░ЁЯЗк => ЁЯЗ░ЁЯЗк, риХрйАриирйАриЖ
ЁЯЗ░ЁЯЗм => ЁЯЗ░ЁЯЗм, риХри┐ри░риЧри┐риЬри╝ри╕ридри╛рии
ЁЯЗ░ЁЯЗн => ЁЯЗ░ЁЯЗн, риХрй░римрйЛрибрйАриЖ
ЁЯЗ░ЁЯЗо => ЁЯЗ░ЁЯЗо, риХри┐ри░римри╛ридрйА
ЁЯЗ░ЁЯЗ▓ => ЁЯЗ░ЁЯЗ▓, риХрйЛриорйЛри░рйЛри╕
ЁЯЗ░ЁЯЗ│ => ЁЯЗ░ЁЯЗ│, ри╕рйЗриВриЯ риХри┐риЯри╕ риРриВриб риирйЗри╡ри┐ри╕
ЁЯЗ░ЁЯЗ╡ => ЁЯЗ░ЁЯЗ╡, риЙрй▒ридри░ риХрйЛри░рйАриЖ
ЁЯЗ░ЁЯЗ╖ => ЁЯЗ░ЁЯЗ╖, рижрй▒риЦриг риХрйЛри░рйАриЖ
ЁЯЗ░ЁЯЗ╝ => ЁЯЗ░ЁЯЗ╝, риХрйБри╡рйИрид
ЁЯЗ░ЁЯЗ╛ => ЁЯЗ░ЁЯЗ╛, риХрйЗриорйИрии риЯри╛рикрйВ
ЁЯЗ░ЁЯЗ┐ => ЁЯЗ░ЁЯЗ┐, риХриЬри╝ри╛риЦри╕ридри╛рии
ЁЯЗ▒ЁЯЗж => ЁЯЗ▒ЁЯЗж, ри▓ри╛риУри╕
ЁЯЗ▒ЁЯЗз => ЁЯЗ▒ЁЯЗз, ри▓рйИримриири╛рии
ЁЯЗ▒ЁЯЗи => ЁЯЗ▒ЁЯЗи, ри╕рйЗриВриЯ ри▓рйВри╕рйАриЖ
ЁЯЗ▒ЁЯЗо => ЁЯЗ▒ЁЯЗо, ри▓ри┐риЪрйЗриВри╕риЯри╛риЗрии
ЁЯЗ▒ЁЯЗ░ => ЁЯЗ▒ЁЯЗ░, ри╕рйНри░рйА ри▓рй░риХри╛
ЁЯЗ▒ЁЯЗ╖ => ЁЯЗ▒ЁЯЗ╖, ри▓ри╛риИримрйАри░рйАриЖ
ЁЯЗ▒ЁЯЗ╕ => ЁЯЗ▒ЁЯЗ╕, ри▓рйЗри╕рйЛриерйЛ
ЁЯЗ▒ЁЯЗ╣ => ЁЯЗ▒ЁЯЗ╣, ри▓ри┐риерйБриЖриирйАриЖ
ЁЯЗ▒ЁЯЗ║ => ЁЯЗ▒ЁЯЗ║, ри▓риХриЬри╝риоримри░риЧ
ЁЯЗ▒ЁЯЗ╗ => ЁЯЗ▒ЁЯЗ╗, ри▓ри╛ридри╡рйАриЖ
ЁЯЗ▒ЁЯЗ╛ => ЁЯЗ▒ЁЯЗ╛, ри▓рйАримрйАриЖ
ЁЯЗ▓ЁЯЗж => ЁЯЗ▓ЁЯЗж, риорйЛри░рй▒риХрйЛ
ЁЯЗ▓ЁЯЗи => ЁЯЗ▓ЁЯЗи, риорйЛриири╛риХрйЛ
ЁЯЗ▓ЁЯЗй => ЁЯЗ▓ЁЯЗй, риорйЛри▓рибрйЛри╡ри╛
ЁЯЗ▓ЁЯЗк => ЁЯЗ▓ЁЯЗк, риорйЛриВриЯрйЗриирйЗриЧри░рйЛ
ЁЯЗ▓ЁЯЗл => ЁЯЗ▓ЁЯЗл, ри╕рйЗриВриЯ риори╛ри░риЯри┐рии
ЁЯЗ▓ЁЯЗм => ЁЯЗ▓ЁЯЗм, риорйИрибри╛риЧри╛ри╕риХри░
ЁЯЗ▓ЁЯЗн => ЁЯЗ▓ЁЯЗн, риори╛ри░ри╕ри╝ри▓ риЯри╛рикрйВ
ЁЯЗ▓ЁЯЗ░ => ЁЯЗ▓ЁЯЗ░, риорйИриХрибрйЛриирйАриЖ
ЁЯЗ▓ЁЯЗ▒ => ЁЯЗ▓ЁЯЗ▒, риори╛ри▓рйА
ЁЯЗ▓ЁЯЗ▓ => ЁЯЗ▓ЁЯЗ▓, риори┐риЖриВриори╛ри░ (римри░риори╛)
ЁЯЗ▓ЁЯЗ│ => ЁЯЗ▓ЁЯЗ│, риорй░риЧрйЛри▓рйАриЖ
ЁЯЗ▓ЁЯЗ┤ => ЁЯЗ▓ЁЯЗ┤, риориХри╛риЙ риРри╕риПриЖри░ риЪрйАрии
ЁЯЗ▓ЁЯЗ╡ => ЁЯЗ▓ЁЯЗ╡, риЙрй▒ридри░рйА риори╛ри░рйАриЖриири╛ риЯри╛рикрйВ
ЁЯЗ▓ЁЯЗ╢ => ЁЯЗ▓ЁЯЗ╢, риори╛ри░риЯрйАриири┐риХ
ЁЯЗ▓ЁЯЗ╖ => ЁЯЗ▓ЁЯЗ╖, риорйЛри░ри┐риЯри╛риирйАриЖ
ЁЯЗ▓ЁЯЗ╕ => ЁЯЗ▓ЁЯЗ╕, риорйЛриВриЯри╕рйЗри░ри╛рид
ЁЯЗ▓ЁЯЗ╣ => ЁЯЗ▓ЁЯЗ╣, риори╛ри▓риЯри╛
ЁЯЗ▓ЁЯЗ║ => ЁЯЗ▓ЁЯЗ║, риорйМри░ри┐ри╕ри╝ри╕
ЁЯЗ▓ЁЯЗ╗ => ЁЯЗ▓ЁЯЗ╗, риори╛ри▓рижрйАри╡
ЁЯЗ▓ЁЯЗ╝ => ЁЯЗ▓ЁЯЗ╝, риори▓ри╛ри╡рйА
ЁЯЗ▓ЁЯЗ╜ => ЁЯЗ▓ЁЯЗ╜, риорйИриХри╕рйАриХрйЛ
ЁЯЗ▓ЁЯЗ╛ => ЁЯЗ▓ЁЯЗ╛, риори▓рйЗри╕ри╝рйАриЖ
ЁЯЗ▓ЁЯЗ┐ => ЁЯЗ▓ЁЯЗ┐, риорйЛриЬри╝ри╛риоримрйАриХ
ЁЯЗ│ЁЯЗж => ЁЯЗ│ЁЯЗж, риири╛риорйАримрйАриЖ
ЁЯЗ│ЁЯЗи => ЁЯЗ│ЁЯЗи, риири┐риК риХрйИри▓рйЗрибрйЛриирйАриЖ
ЁЯЗ│ЁЯЗк => ЁЯЗ│ЁЯЗк, риири╛риИриЬри░
ЁЯЗ│ЁЯЗл => ЁЯЗ│ЁЯЗл, риирйЛри░рилрйМриХ риЯри╛рикрйВ
ЁЯЗ│ЁЯЗм => ЁЯЗ│ЁЯЗм, риири╛риИриЬрйАри░рйАриЖ
ЁЯЗ│ЁЯЗо => ЁЯЗ│ЁЯЗо, риири┐риХри╛ри░ри╛риЧрйБриЖ
ЁЯЗ│ЁЯЗ▒ => ЁЯЗ│ЁЯЗ▒, риирйАрижри░ри▓рйИриВриб
ЁЯЗ│ЁЯЗ┤ => ЁЯЗ│ЁЯЗ┤, риири╛ри░ри╡рйЗ
ЁЯЗ│ЁЯЗ╡ => ЁЯЗ│ЁЯЗ╡, риирйЗрикри╛ри▓
ЁЯЗ│ЁЯЗ╖ => ЁЯЗ│ЁЯЗ╖, риири╛риЙри░рйВ
ЁЯЗ│ЁЯЗ║ => ЁЯЗ│ЁЯЗ║, риири┐рипрйВ
ЁЯЗ│ЁЯЗ┐ => ЁЯЗ│ЁЯЗ┐, риири┐риКриЬри╝рйАри▓рйИриВриб
ЁЯЗ┤ЁЯЗ▓ => ЁЯЗ┤ЁЯЗ▓, риУриори╛рии
ЁЯЗ╡ЁЯЗж => ЁЯЗ╡ЁЯЗж, рикриири╛риори╛
ЁЯЗ╡ЁЯЗк => ЁЯЗ╡ЁЯЗк, рикрйЗри░рйВ
ЁЯЗ╡ЁЯЗл => ЁЯЗ╡ЁЯЗл, рилри░рйИриВриЪ рикрйЛри▓рйАриирйЗри╕ри╝рйАриЖ
ЁЯЗ╡ЁЯЗм => ЁЯЗ╡ЁЯЗм, рикри╛рикрйВриЖ риири┐риК риЧри┐риирйА
ЁЯЗ╡ЁЯЗн => ЁЯЗ╡ЁЯЗн, рилри┐ри▓рйАрикрйАриириЬ
ЁЯЗ╡ЁЯЗ░ => ЁЯЗ╡ЁЯЗ░, рикри╛риХри┐ри╕ридри╛рии
ЁЯЗ╡ЁЯЗ▒ => ЁЯЗ╡ЁЯЗ▒, рикрйЛри▓рйИриВриб
ЁЯЗ╡ЁЯЗ▓ => ЁЯЗ╡ЁЯЗ▓, ри╕рйЗриВриЯ рикрйАриЕри░рйЗ риРриВриб риори┐риХрйЗри▓рии
ЁЯЗ╡ЁЯЗ│ => ЁЯЗ╡ЁЯЗ│, рикри┐риЯриХрйЗри░рии риЯри╛рикрйВ
ЁЯЗ╡ЁЯЗ╖ => ЁЯЗ╡ЁЯЗ╖, рикри┐риКри░риЯрйЛ ри░ри┐риХрйЛ
ЁЯЗ╡ЁЯЗ╕ => ЁЯЗ╡ЁЯЗ╕, рилри┐ри▓рйАри╕ридрйАриирйА риЗри▓ри╛риХри╛
ЁЯЗ╡ЁЯЗ╣ => ЁЯЗ╡ЁЯЗ╣, рикрйБри░ридриЧри╛ри▓
ЁЯЗ╡ЁЯЗ╝ => ЁЯЗ╡ЁЯЗ╝, рикри▓ри╛риЙ
ЁЯЗ╡ЁЯЗ╛ => ЁЯЗ╡ЁЯЗ╛, рикрйИри░ри╛риЧри╡рйЗ
ЁЯЗ╢ЁЯЗж => ЁЯЗ╢ЁЯЗж, риХридри░
ЁЯЗ╢ЁЯЗ┤ => ЁЯЗ╢ЁЯЗ┤, риЖриКриЯри▓ри╛риЗрй░риЧ риУри╕ри╝рйАриирйАриЖ
ЁЯЗ╖ЁЯЗк => ЁЯЗ╖ЁЯЗк, ри░ри┐рипрйВриирйАриЕрии
ЁЯЗ╖ЁЯЗ┤ => ЁЯЗ╖ЁЯЗ┤, ри░рйЛриори╛риирйАриЖ
ЁЯЗ╖ЁЯЗ╕ => ЁЯЗ╖ЁЯЗ╕, ри╕ри░римрйАриЖ
ЁЯЗ╖ЁЯЗ║ => ЁЯЗ╖ЁЯЗ║, ри░рйВри╕
ЁЯЗ╖ЁЯЗ╝ => ЁЯЗ╖ЁЯЗ╝, ри░ри╡ри╛риВрибри╛
ЁЯЗ╕ЁЯЗж => ЁЯЗ╕ЁЯЗж, ри╕ри╛риКрижрйА риЕри░рим
ЁЯЗ╕ЁЯЗз => ЁЯЗ╕ЁЯЗз, ри╕рйЛри▓рйЛриории риЯри╛рикрйВ
ЁЯЗ╕ЁЯЗи => ЁЯЗ╕ЁЯЗи, ри╕рйЗри╕ри╝ри▓ри╕
ЁЯЗ╕ЁЯЗй => ЁЯЗ╕ЁЯЗй, ри╕рйВрибри╛рии
ЁЯЗ╕ЁЯЗк => ЁЯЗ╕ЁЯЗк, ри╕ри╡рйАрибрии
ЁЯЗ╕ЁЯЗм => ЁЯЗ╕ЁЯЗм, ри╕ри┐рй░риЧри╛рикрйБри░
ЁЯЗ╕ЁЯЗн => ЁЯЗ╕ЁЯЗн, ри╕рйЗриВриЯ ри╣рйЗри▓рйЗриири╛
ЁЯЗ╕ЁЯЗо => ЁЯЗ╕ЁЯЗо, ри╕ри▓рйЛри╡рйЗриирйАриЖ
ЁЯЗ╕ЁЯЗп => ЁЯЗ╕ЁЯЗп, ри╕ри╡ри╛ри▓римри░риб риЕридрйЗ риЬри╛рии риори╛рипрйЗрии
ЁЯЗ╕ЁЯЗ░ => ЁЯЗ╕ЁЯЗ░, ри╕ри▓рйЛри╡ри╛риХрйАриЖ
ЁЯЗ╕ЁЯЗ▒ => ЁЯЗ╕ЁЯЗ▒, ри╕ри┐риПри░ри╛ ри▓ри┐риУрии
ЁЯЗ╕ЁЯЗ▓ => ЁЯЗ╕ЁЯЗ▓, ри╕рйИрии риори░рйАриирйЛ
ЁЯЗ╕ЁЯЗ│ => ЁЯЗ╕ЁЯЗ│, ри╕рйЗриирйЗриЧри▓
ЁЯЗ╕ЁЯЗ┤ => ЁЯЗ╕ЁЯЗ┤, ри╕рйЛриори╛ри▓рйАриЖ
ЁЯЗ╕ЁЯЗ╖ => ЁЯЗ╕ЁЯЗ╖, ри╕рйВри░рйАриири╛рио
ЁЯЗ╕ЁЯЗ╕ => ЁЯЗ╕ЁЯЗ╕, рижрй▒риЦриг ри╕рйБрибри╛рии
ЁЯЗ╕ЁЯЗ╣ => ЁЯЗ╕ЁЯЗ╣, ри╕ри╛риУ риЯрйЛрио риЕридрйЗ рикрйНри░ри┐рй░ри╕рйАрикрйЗ
ЁЯЗ╕ЁЯЗ╗ => ЁЯЗ╕ЁЯЗ╗, риЕри▓ ри╕ри▓ри╡ри╛рибрйЛри░
ЁЯЗ╕ЁЯЗ╜ => ЁЯЗ╕ЁЯЗ╜, ри╕ри┐рй░риЯ риори╛ри░риЯрйАрии
ЁЯЗ╕ЁЯЗ╛ => ЁЯЗ╕ЁЯЗ╛, ри╕рйАри░рйАриЖ
ЁЯЗ╕ЁЯЗ┐ => ЁЯЗ╕ЁЯЗ┐, ри╕ри╡ри╛риЬри╝рйАри▓рйИриВриб
ЁЯЗ╣ЁЯЗж => ЁЯЗ╣ЁЯЗж, риЯрйНри░ри┐ри╕риЯри╛рии рижри╛ риХрйБрй░ри╣ри╛
ЁЯЗ╣ЁЯЗи => ЁЯЗ╣ЁЯЗи, риЯрйБри░риХри╕ риЕридрйЗ риХрйИриХрйЛри╕ риЯри╛рикрйВ
ЁЯЗ╣ЁЯЗй => ЁЯЗ╣ЁЯЗй, риЪри╛риб
ЁЯЗ╣ЁЯЗл => ЁЯЗ╣ЁЯЗл, рилри░рйИриВриЪ рижрй▒риЦригрйА рикрйНри░рижрйЗри╕ри╝
ЁЯЗ╣ЁЯЗм => ЁЯЗ╣ЁЯЗм, риЯрйЛриЧрйЛ
ЁЯЗ╣ЁЯЗн => ЁЯЗ╣ЁЯЗн, риери╛риИри▓рйИриВриб
ЁЯЗ╣ЁЯЗп => ЁЯЗ╣ЁЯЗп, ридри╛риЬри┐риХри┐ри╕ридри╛рии
ЁЯЗ╣ЁЯЗ░ => ЁЯЗ╣ЁЯЗ░, риЯрйЛриХрйЗри▓ри╛риЙ
ЁЯЗ╣ЁЯЗ▒ => ЁЯЗ╣ЁЯЗ▒, ридри┐риорйЛри░-ри▓рйЗри╕ридрйЗ
ЁЯЗ╣ЁЯЗ▓ => ЁЯЗ╣ЁЯЗ▓, ридрйБри░риХриорйЗриири┐ри╕ридри╛рии
ЁЯЗ╣ЁЯЗ│ => ЁЯЗ╣ЁЯЗ│, риЯри┐риКриирйАри╕ри╝рйАриЖ
ЁЯЗ╣ЁЯЗ┤ => ЁЯЗ╣ЁЯЗ┤, риЯрйМриВриЧри╛
ЁЯЗ╣ЁЯЗ╖ => ЁЯЗ╣ЁЯЗ╖, ридрйБри░риХрйА
ЁЯЗ╣ЁЯЗ╣ => ЁЯЗ╣ЁЯЗ╣, риЯрйНри░ри┐риирйАрибри╛риб риЕридрйЗ риЯрйЛримри╛риЧрйЛ
ЁЯЗ╣ЁЯЗ╗ => ЁЯЗ╣ЁЯЗ╗, риЯрйБри╡ри╛ри▓рйВ
ЁЯЗ╣ЁЯЗ╝ => ЁЯЗ╣ЁЯЗ╝, ридри╛риЗри╡ри╛рии
ЁЯЗ╣ЁЯЗ┐ => ЁЯЗ╣ЁЯЗ┐, ридриириЬри╝ри╛риирйАриЖ
ЁЯЗ║ЁЯЗж => ЁЯЗ║ЁЯЗж, рипрйВриХри░рйЗрии
ЁЯЗ║ЁЯЗм => ЁЯЗ║ЁЯЗм, рипрйВриЧри╛риВрибри╛
ЁЯЗ║ЁЯЗ▓ => ЁЯЗ║ЁЯЗ▓, рипрйВ.риРрй▒ри╕. рижрйВри░-рижрйБри░ри╛рибрйЗ риЯри╛рикрйВ
ЁЯЗ║ЁЯЗ│ => ЁЯЗ║ЁЯЗ│, ри╕рй░рипрйБриХрид ри░ри╛ри╕ри╝риЯри░
ЁЯЗ║ЁЯЗ╕ => ЁЯЗ║ЁЯЗ╕, ри╕рй░рипрйБриХрид ри░ри╛риЬ
ЁЯЗ║ЁЯЗ╛ => ЁЯЗ║ЁЯЗ╛, риЙри░рйВриЧри╡рйЗ
ЁЯЗ║ЁЯЗ┐ => ЁЯЗ║ЁЯЗ┐, риЙриЬри╝римрйЗриХри┐ри╕ридри╛рии
ЁЯЗ╗ЁЯЗж => ЁЯЗ╗ЁЯЗж, ри╡рйИриЯрйАриХрии ри╕ри┐риЯрйА
ЁЯЗ╗ЁЯЗи => ЁЯЗ╗ЁЯЗи, ри╕рйЗриВриЯ ри╡ри┐риири╕рйИриВриЯ риРриВриб риЧрйНри░рйЗриири╛рибрйАриири╕
ЁЯЗ╗ЁЯЗк => ЁЯЗ╗ЁЯЗк, ри╡рйЗриирйЗриЬри╝рйВриПри▓ри╛
ЁЯЗ╗ЁЯЗм => ЁЯЗ╗ЁЯЗм, римрйНри░ри┐риЯри┐ри╕ри╝ ри╡ри░риЬри┐рии риЯри╛рикрйВ
ЁЯЗ╗ЁЯЗо => ЁЯЗ╗ЁЯЗо, рипрйВ риРрй▒ри╕ ри╡ри░риЬри┐рии риЯри╛рикрйВ
ЁЯЗ╗ЁЯЗ│ => ЁЯЗ╗ЁЯЗ│, ри╡рйАриЕридриири╛рио
ЁЯЗ╗ЁЯЗ║ => ЁЯЗ╗ЁЯЗ║, ри╡ри╛риирйВриЖриЯрйВ
ЁЯЗ╝ЁЯЗл => ЁЯЗ╝ЁЯЗл, ри╡ри╛ри▓ри┐ри╕ риЕридрйЗ рилрйВриЯрйВриири╛
ЁЯЗ╝ЁЯЗ╕ => ЁЯЗ╝ЁЯЗ╕, ри╕ри╛риорйЛриЖ
ЁЯЗ╜ЁЯЗ░ => ЁЯЗ╜ЁЯЗ░, риХрйЛри╕рйЛри╡рйЛ
ЁЯЗ╛ЁЯЗк => ЁЯЗ╛ЁЯЗк, риприории
ЁЯЗ╛ЁЯЗ╣ => ЁЯЗ╛ЁЯЗ╣, риори╛рипрйЛриЯрйА
ЁЯЗ┐ЁЯЗж => ЁЯЗ┐ЁЯЗж, рижрй▒риЦриг риЕрилри░рйАриХри╛
ЁЯЗ┐ЁЯЗ▓ => ЁЯЗ┐ЁЯЗ▓, риЬри╝ри╛риоримрйАриЖ
ЁЯЗ┐ЁЯЗ╝ => ЁЯЗ┐ЁЯЗ╝, риЬри╝ри┐рй░римри╛римри╡рйЗ
ЁЯЗ┐ЁЯЗ┐ => ЁЯЗ┐ЁЯЗ┐, риЕригрикриЫри╛ридри╛ риЗри▓ри╛риХри╛