тЩА => тЩА, рк╕рлНркдрлНрк░рлА, ркорк╣рк┐рк▓рк╛
тЩВ => тЩВ, рккрлБрк░рлБрк╖
тЪХ => тЪХ, ркжрк╡рк╛, рк╕рлНркЯрк╛ркл
ЁЯХ║ => ЁЯХ║, ркбрк╛ркирлНрк╕, ркорк╛ркгрк╕
ЁЯЦд => ЁЯЦд, ркХрк╛рк│рлБркВ, рк╣рлГркжркп, ркЦрк░рк╛ркм
ЁЯдЩ => ЁЯдЩ, ркХрлЙрк▓, рк╣рк╛рке
ЁЯдЪ => ЁЯдЪ, ркмрлЗркХрк╣рлЗркирлНркб, рк╣рк╛рке
ЁЯдЫ => ЁЯдЫ, ркорлБркарлНркарлА, ркбрк╛ркмрлАркмрк╛ркЬрлБ
ЁЯдЬ => ЁЯдЬ, ркорлБркарлНркарлА, ркЬркоркгрлАркмрк╛ркЬрлБ
ЁЯдЭ => ЁЯдЭ, рк╣рк╛рке ркорк┐рк▓рк╛рк╡рк╡рлЛ, ркХрк░рк╛рк░, ркорлАркЯрк┐ркВркЧ, ркорк┐рк▓рк╛рк╡рк╡рлБркВ, рк╣рк╛рке
ЁЯдЮ => ЁЯдЮ, ркХрлНрк░рлЙрк╕, рклрк┐ркВркЧрк░, рк╣рк╛рке, ркнрк╛ркЧрлНркп
ЁЯда => ЁЯда, ркХрк╛ркЙркмрлЙркп, ркЪрк╣рлЗрк░рлЛ, рк╣рлЕркЯ, ркХрк╛ркЙркЧрк░рлНрк▓
ЁЯдб => ЁЯдб, рк╡рк┐ркжрлВрк╖ркХ, ркЪрк╣рлЗрк░рлЛ
ЁЯдв => ЁЯдв, ркЪрк╣рлЗрк░рлЛ, ркЪрлАркдрк░рлА ркЪркбрлЗрк▓рлЛ, ркКрк▓ркЯрлА
ЁЯдг => ЁЯдг, ркЬркорлАрки, рк╣рк╕рк╡рлБркВ, рк▓рлЛркЯрк╡рлБркВ, ркЪрк╣рлЗрк░рлЛ
ЁЯдд => ЁЯдд, рк▓рк╛рк│, ркЪрк╣рлЗрк░рлЛ
ЁЯде => ЁЯде, ркЪрк╣рлЗрк░рлЛ, ркЦрлЛркЯрлБркВ
ЁЯдж => ЁЯдж, ркЪрк╣рлЗрк░рлЛ, рк╣рк╛рке, ркЕрк╡рк┐рк╢рлНрк╡рк╛рк╕, рк░рлЛрк╖
ЁЯджтАНтЩА => ЁЯджтАНтЩА, ркЕрк╡рк┐рк╢рлНрк╡рк╛рк╕, рк░рлЛрк╖, рк╕рлНркдрлНрк░рлА, рк╣рк╛рке, ркорк╛ркерк╛ ркЙрккрк░ рк╣рк╛рке ркжрлЗрк╡рлЛ
ЁЯджтАНтЩВ => ЁЯджтАНтЩВ, ркЕрк╡рк┐рк╢рлНрк╡рк╛рк╕, рк░рлЛрк╖, рккрлБрк░рлБрк╖, рк╣рк╛рке, ркорк╛ркерк╛ ркЙрккрк░ рк╣рк╛рке ркжрлЗрк╡рлЛ
ЁЯдз => ЁЯдз, ркЪрк╣рлЗрк░рлЛ, ркЫрлАркВркХ
ЁЯд░ => ЁЯд░, рк╕ркЧрк░рлНркнрк╛, рк╕рлНркдрлНрк░рлА
ЁЯд│ => ЁЯд│, рк╕рлЗрк▓рлНрклрлА, ркХрлЕркорк░рк╛, рклрлЛрки
ЁЯд┤ => ЁЯд┤, рк░рк╛ркЬркХрлБркорк╛рк░
ЁЯд╡ => ЁЯд╡, рк╡рк░рк░рк╛ркЬрк╛, ркорк╛ркгрк╕, ркЯркХрлНрк╕рлАркбрлЛ
ЁЯд╢ => ЁЯд╢, ркХрлНрк░рк┐рк╕рлНркорк╕, ркоркзрк░
ЁЯд╖ => ЁЯд╖, ркмрлЗркжрк░ркХрк╛рк░рлА, рк╢ркВркХрк╛, ркЕркЬрлНркЮрк╛рки, рк▓рк╛рккрк░рк╡рк╛ркИ
ЁЯд╖тАНтЩА => ЁЯд╖тАНтЩА, ркЕркЬрлНркЮрк╛рки, ркмрлЗркжрк░ркХрк╛рк░рлА, рк▓рк╛рккрк░рк╡рк╛ркИ, рк╕рлНркдрлНрк░рлА, рк╢ркВркХрк╛
ЁЯд╖тАНтЩВ => ЁЯд╖тАНтЩВ, ркЕркЬрлНркЮрк╛рки, ркмрлЗркжрк░ркХрк╛рк░рлА, рк▓рк╛рккрк░рк╡рк╛ркИ, рккрлБрк░рлБрк╖, рк╢ркВркХрк╛
ЁЯд╕ => ЁЯд╕, ркХрк╛рк░рлНркЯрк╡рлНрк╣рлАрк▓, ркЬрк┐ркорлНркирлЗрк╕рлНркЯрк┐ркХрлНрк╕, ркорк╛ркгрк╕, рк╕рлНрккрлЙрк░рлНркЯ
ЁЯд╕тАНтЩА => ЁЯд╕тАНтЩА, ркХрк╛рк░рлНркЯрк╡рлНрк╣рлАрк▓, ркЬрк┐ркорлНркирлЗрк╕рлНркЯрк┐ркХрлНрк╕, ркорк╛ркгрк╕, рк╕рлНркдрлНрк░рлА, рк╕рлНрккрлЙрк░рлНркЯ
ЁЯд╕тАНтЩВ => ЁЯд╕тАНтЩВ, ркХрк╛рк░рлНркЯрк╡рлНрк╣рлАрк▓, ркЬрк┐ркорлНркирлЗрк╕рлНркЯрк┐ркХрлНрк╕, ркорк╛ркгрк╕, рккрлБрк░рлБрк╖, рк╕рлНрккрлЙрк░рлНркЯ
ЁЯд╣ => ЁЯд╣, ркЬркЧрк▓, ркмрк╣рлБ ркХрк╛рк░рлНркп, рк╕ркВркдрлБрк▓рки, ркХрлМрк╢рк▓рлНркп
ЁЯд╣тАНтЩА => ЁЯд╣тАНтЩА, ркЬркЧрк▓рк┐ркВркЧ, рк╕рлНркдрлНрк░рлА, ркмрк╣рлБ ркХрк╛рк░рлНркп
ЁЯд╣тАНтЩВ => ЁЯд╣тАНтЩВ, ркЬркЧрк▓рк┐ркВркЧ, рккрлБрк░рлБрк╖, ркмрк╣рлБ ркХрк╛рк░рлНркп
ЁЯд║ => ЁЯд║, рклрлЗркирлНрк╕рк░, рклрлЗркирлНрк╕рк┐ркВркЧ, ркдрк▓рк╡рк╛рк░, рк╕рлНрккрлЙрк░рлНркЯ, ркорк╛ркгрк╕
ЁЯд╝ => ЁЯд╝, рккрк╣рлЗрк▓рк╡рк╛рки, ркХрлБрк╕рлНркдрлА, рк╕рлНрккрлЙрк░рлНркЯ, ркорк╛ркгрк╕
ЁЯд╝тАНтЩА => ЁЯд╝тАНтЩА, ркХрлБрк╕рлНркдрлА, рккрк╣рлЗрк▓рк╡рк╛рки, ркорк╛ркгрк╕, рк╕рлНркдрлНрк░рлА, рк╕рлНрккрлЙрк░рлНркЯ
ЁЯд╝тАНтЩВ => ЁЯд╝тАНтЩВ, ркХрлБрк╕рлНркдрлА, рккрк╣рлЗрк▓рк╡рк╛рки, ркорк╛ркгрк╕, рккрлБрк░рлБрк╖, рк╕рлНрккрлЙрк░рлНркЯ
ЁЯд╜ => ЁЯд╜, рккрлЛрк▓рлЛ, рк╡рлЙркЯрк░, ркорк╛ркгрк╕, рк╕рлНрккрлЙрк░рлНркЯ
ЁЯд╜тАНтЩА => ЁЯд╜тАНтЩА, рккрлЛрк▓рлЛ, рк╕рлНркдрлНрк░рлА, рк╡рлЙркЯрк░, рк╕рлНрккрлЙрк░рлНркЯ
ЁЯд╜тАНтЩВ => ЁЯд╜тАНтЩВ, рккрлЛрк▓рлЛ, рккрлБрк░рлБрк╖, рк╡рлЙркЯрк░, рк╕рлНрккрлЙрк░рлНркЯ
ЁЯд╛ => ЁЯд╛, рк╣рлЕркирлНркбркмрлЛрк▓, ркмрлЛрк▓, рк╕рлНрккрлЙрк░рлНркЯ, ркорк╛ркгрк╕
ЁЯд╛тАНтЩА => ЁЯд╛тАНтЩА, рк╣рлЕркирлНркбркмрлЛрк▓, рк╕рлНркдрлНрк░рлА, рк╕рлНрккрлЙрк░рлНркЯ
ЁЯд╛тАНтЩВ => ЁЯд╛тАНтЩВ, рк╣рлЕркирлНркбркмрлЛрк▓, рккрлБрк░рлБрк╖, рк╕рлНрккрлЙрк░рлНркЯ
ЁЯеА => ЁЯеА, рклрлВрк▓, ркорлБрк░рлНркЬрк╛ркпрлЗрк▓рлБркВ
ЁЯеБ => ЁЯеБ, ркбрлНрк░рко, ркбрлНрк░ркорк╕рлНркЯрк┐ркХ, рк╕ркВркЧрлАркд
ЁЯеВ => ЁЯеВ, ркХрлНрк▓рк┐ркВркХ, ркЧрлНрк▓рк╛рк╕, рккрлАркгрлБркВ, ркЙркЬрк╡ркгрлА
ЁЯеГ => ЁЯеГ, ркЧрлНрк▓рк╛рк╕, ркЯркорлНркмрлНрк▓рк░, рк╡рк┐рк╕рлНркХрлА, ркжрк╛рк░рлВ, рк╢рлЙркЯ
ЁЯеД => ЁЯеД, ркЪркоркЪрлА, ркЫрк░рлАркХрк╛ркВркЯрк╛
ЁЯеЕ => ЁЯеЕ, ркЧрлЛрк▓, ркирлЗркЯ, рк╕рлНрккрлЙрк░рлНркЯ
ЁЯеЗ => ЁЯеЗ, рккрк╣рлЗрк▓рлБркВ, рк╕рлБрк╡рк░рлНркг, рккркжркХ
ЁЯеИ => ЁЯеИ, рккркжркХ, ркмрлАркЬрлБркВ, рк░ркЬркд
ЁЯеЙ => ЁЯеЙ, ркХрк╛ркВрк╕рлНркп, рккркжркХ, ркдрлНрк░рлАркЬрлБ
ЁЯеК => ЁЯеК, ркмрлЙркХрлНрк╕рк┐ркВркЧ, ркЧрлНрк▓рк╡, рк╕рлНрккрлЙрк░рлНркЯ
ЁЯеЛ => ЁЯеЛ, ркЬрлБркбрлЛ, ркХрк░рк╛ркЯрлЗ, ркорк╛рк░рлНрк╢рк▓ ркЖркЯрк░рлНрк╕, ркпрлВркирк┐рклрлЙрк░рлНрко, рк╕рлНрккрлЙрк░рлНркЯ
ЁЯеР => ЁЯеР, ркХрлНрк░рлЛркЗрк╕рлИрки, рклрлНрк░рлЗркирлНркЪ, ркнрлЛркЬрки, рк░рлЛркЯрк▓рлА
ЁЯеС => ЁЯеС, ркНрк╡ркХрк╛ркбрлЛ, рклрк│, ркнрлЛркЬрки
ЁЯеТ => ЁЯеТ, ркХрк╛ркХркбрлА, ркЕркерк╛ркгрлБркВ, рк╢рк╛ркХркнрк╛ркЬрлА, ркнрлЛркЬрки
ЁЯеУ => ЁЯеУ, ркмрлЗркХрки, ркорк╛ркВрк╕, ркнрлЛркЬрки
ЁЯеФ => ЁЯеФ, ркмркЯрк╛ркЯрлЛ, рк╢рк╛ркХркнрк╛ркЬрлА, ркнрлЛркЬрки
ЁЯеХ => ЁЯеХ, ркЧрк╛ркЬрк░, рк╢рк╛ркХркнрк╛ркЬрлА, ркнрлЛркЬрки
ЁЯеЦ => ЁЯеЦ, ркмрлЗркЧрлЗркЯ, рк░рлЛркЯрк▓рлА, рклрлНрк░рлЗркирлНркЪ, ркнрлЛркЬрки
ЁЯеЧ => ЁЯеЧ, рк▓рлАрк▓рлБркВ, рк╕рлЕрк▓ркб, ркнрлЛркЬрки
ЁЯеШ => ЁЯеШ, ркХрлЕрк╕рк░рлЛрк▓, ркдрк╡рлЛ, ркЫрлАркЫрк░рлЛ, ркнрлЛркЬрки
ЁЯеЩ => ЁЯеЩ, ркХркмрк╛ркм, рклрк▓рк╛рклрк▓, рклрк▓рлЗркЯркмрлНрк░рлЗркб, ркнрк░рлЗрк▓рлБркВ, ркнрлЛркЬрки
ЁЯеЪ => ЁЯеЪ, ркИркВркбрлБркВ, ркнрлЛркЬрки
ЁЯеЫ => ЁЯеЫ, ркЧрлНрк▓рк╛рк╕, ркжрлБркз, рккрлАркгрлБркВ
ЁЯеЬ => ЁЯеЬ, ркоркЧрклрк│рлА, ркЕркЦрк░рлЛркЯ, ркнрлЛркЬрки, рк╢рк╛ркХркнрк╛ркЬрлА
ЁЯеЭ => ЁЯеЭ, ркХрк┐рк╡рлА, рклрк│, ркнрлЛркЬрки
ЁЯеЮ => ЁЯеЮ, рк╣рлЙркЯркХрлЗркХ, рккрлЕркирлНркХрлЗркХ, ркнрлЛркЬрки
ЁЯжЕ => ЁЯжЕ, ркЧрк░рлБркб, рккркХрлНрк╖рлА
ЁЯжЖ => ЁЯжЖ, ркмркдркХ, рккркХрлНрк╖рлА
ЁЯжЗ => ЁЯжЗ, ркЪрк╛ркорк╛ркЪрлАркбрк┐ркпрлБркВ, рк╡рлЕркорлНрккрк╛ркпрк░, рккрлНрк░рк╛ркгрлА
ЁЯжИ => ЁЯжИ, рк╢рк╛рк░рлНркХ, ркорк╛ркЫрк▓рлА
ЁЯжЙ => ЁЯжЙ, ркШрлБрк╡ркб, рккркХрлНрк╖рлА, ркмрлБркжрлНркзрк┐ркорк╛рки
ЁЯжК => ЁЯжК, ркЪрк╣рлЗрк░рлЛ, рк╢рк┐ркпрк╛рк│, рккрлНрк░рк╛ркгрлА
ЁЯжЛ => ЁЯжЛ, ркмркЯрк░рклрлНрк▓рк╛ркЗ, ркЬркВркдрлБ, рк╕рлБркВркжрк░
ЁЯжМ => ЁЯжМ, рк╣рк░ркг, рккрлНрк░рк╛ркгрлА
ЁЯжН => ЁЯжН, ркЧрлЛрк░рлАрк▓рк╛, рккрлНрк░рк╛ркгрлА
ЁЯжО => ЁЯжО, ркЧрк░рлЛрк│рлА, рк╕рк░рк┐рк╕рлГркк
ЁЯжП => ЁЯжП, ркЧрлЗркВркбрлЛ, рккрлНрк░рк╛ркгрлА
ЁЯжР => ЁЯжР, ркЭрлАркВркЧрлБркВ, ркирк╛ркирлБркВ, ркХрк░ркЪрк▓рлЛ, ркнрлЛркЬрки
ЁЯжС => ЁЯжС, рк╕рлНркХрлНрк╡рк┐ркб, ркнрлЛркЬрки
ЁЯША => ЁЯША, рк╕рлНркорк┐ркд, рк╕рлНркорк┐ркд ркХрк░рк╡рлБркВ, рк╕рлНркорк╛ркЗрк▓рлА, ркЪрк╣рлЗрк░рлЛ, рк╣рк╕рк╡рлБркВ, ркорлЛркЯрлЗркерлА рк╣рк╕рк╡рлБркВ, рк╡рк┐ркирлЛркжрлА
ЁЯШБ => ЁЯШБ, рк╕рлНркорк┐ркд, рк╣рк╕ркдрлА ркЖркВркЦрлЛ, рк╕рлНркорк┐ркд ркХрк░рк╡рлБркВ, рк╕рлНркорк╛ркЗрк▓, рк╕рлНркорк╛ркЗрк▓рлА, рк╕рлНркорк┐ркд ркХрк░ркдрлЛ, рк╣рк╛рк╕рлНркп ркХрк░рк╡рлБркВ, ркЪрк╣рлЗрк░рлЛ, рк╣рк╕рк╡рлБркВ, ркорлЛркЯрлЗркерлА рк╣рк╕рк╡рлБркВ, рк╡рк┐ркирлЛркжрлА
ЁЯШВ => ЁЯШВ, ркЖркиркВркжрк╛рк╢рлНрк░рлБ, ркЖркиркВркж, ркЕрк╢рлНрк░рлБ, ркЖркиркВркжрк╛рк╢рлНрк░рлБ рк╕рк╛ркерлЗркирлЛ ркЪрк╣рлЗрк░рлЛ, ркЪрк╣рлЗрк░рлЛ
ЁЯШГ => ЁЯШГ, ркЦрлБрк▓рлНрк▓рк╛ ркорлЛркВркП рк╣рк╛рк╕рлНркп, рк╣рк╛рк╕рлНркп ркХрк░рк╡рлБркВ, рк╕рлНркорк╛ркЗрк▓рлА, ркЦрлБрк▓рлНрк▓рк╛ркВ ркорлЛркВркП рк╣рк╕ркдрлЛ ркЪрк╣рлЗрк░рлЛ, ркЪрк╣рлЗрк░рлЛ, рк╣рк╕рк╡рлБркВ, ркорлЛркЯрлЗркерлА рк╣рк╕рк╡рлБркВ, рк╡рк┐ркирлЛркжрлА
ЁЯШД => ЁЯШД, ркЦрлБрк▓рлНрк▓рк╛ ркорлЛркВркП рк╣рк╛рк╕рлНркп, рк╣рк╛рк╕рлНркп ркХрк░рк╡рлБркВ, рк╕рлНркорк╛ркЗрк▓рлА, ркЦрлБрк▓рлНрк▓рлБркВ ркорлЛркврлБркВ, рк╣рк╕ркдрлА ркЖркВркЦрлЛ, рк╣рк╕рк╡рлБркВ, ркорлЛркЯрлЗркерлА рк╣рк╕рк╡рлБркВ, рк╡рк┐ркирлЛркжрлА
ЁЯШЕ => ЁЯШЕ, ркаркВркбрк╛ рккрк░рк╕рлЗрк╡рк╛ рк╕рк╛ркерлЗ рк╣рк╛рк╕рлНркп, рк╣рк╛рк╕рлНркп рккрк░ркВркдрлБ ркаркВркбрк╛ рккрк░рк╕рлЗрк╡рк╛ рк╕рк╛ркерлЗ, ркаркВркбрлЛ рккрк░рк╕рлЗрк╡рлЛ
ЁЯШЖ => ЁЯШЖ, ркЦрлБрк▓рлНрк▓рк╛ ркорлЛркВркП рк╣рк╛рк╕рлНркп, ркмркВркз ркЖркВркЦрлЛ рк╕рк╛ркерлЗркирлБркВ рк╣рк╛рк╕рлНркп, ркЦрлБрк▓рлНрк▓рлБркВ ркорлЛркврлБркВ, ркмркВркз ркЖркВркЦрлЛ, ркЪрк╣рлЗрк░рлЛ
ЁЯШЙ => ЁЯШЙ, ркЖркВркЦ ркорк╛рк░рк╡рлА, ркЪрк╣рлЗрк░рлЛ
ЁЯШК => ЁЯШК, рк╣рк╛рк╕рлНркп, рк╣рк╕ркдрлА ркЖркВркЦрлЛ, рк╣рк╕ркдрлЛ ркЪрк╣рлЗрк░рлЛ ркЕркирлЗ ркЖркВркЦрлЛ, рк╣рк╕ркдрлЛ ркЪрк╣рлЗрк░рлЛ, ркЪрк╣рлЗрк░рлЛ
ЁЯШЛ => ЁЯШЛ, рк╕рлНрк╡рк╛ркжрк┐рк╖рлНркЯ, ркпрко ркпрко ркорк╕рлНркд, рк╣рк╕ркдрлЛ ркЪрк╣рлЗрк░рлЛ, рк╕рлНрк╡рк╛ркжрк┐рк╖рлНркЯ ркнрлЛркЬрки, ркЪрк╣рлЗрк░рлЛ
ЁЯШО => ЁЯШО, ркаркВркбрлЛ, ркЬрлЙ ркХрлВрк▓, ркЬрлЗрки ркХрлВрк▓, рк╣рк╛рк╕рлНркп, рк╕ркиркЧрлНрк▓рк╛рк╕рлЗрк╕, ркЪрк╣рлЗрк░рлЛ, ркорлБркЦ
ЁЯШН => ЁЯШН, рк╣рк╕ркдрлЛ ркЪрк╣рлЗрк░рлЛ, рк╣рлГркжркпрк╛ркХрк╛рк░ ркЖркВркЦрлЛ, рккрлНрк░рлЗрко, рк╕рлНркирлЗрк╣рлА, рк╣рлГркжркп, ркЖркВркЦрлЛ, ркЪрк╣рлЗрк░рлЛ, ркорлБркЦ
ЁЯШШ => ЁЯШШ, ркЪрлБркВркмрки ркЙркЫрк╛рк│рк╡рк╛, ркЪрк╣рлЗрк░рлЛ, ркорлБркЦ
ЁЯШЧ => ЁЯШЧ, ркЪрлБркВркмркирк╡рк╛рк│рлЛ ркЪрк╣рлЗрк░рлЛ, ркЪрлБркВркмрки, ркЪрк╣рлЗрк░рлЛ, ркорлБркЦ
ЁЯШЩ => ЁЯШЩ, ркЪрлБркВркмрки ркЕркирлЗ рк╣рк╛рк╕рлНркп, рк╣рк╛рк╕рлНркп рк╕рк╛ркерлЗркирлЛ ркЪрлБркВркмрки ркХрк░ркдрлЛ ркЪрк╣рлЗрк░рлЛ, ркЪрк╣рлЗрк░рлЛ, рк╣рк╛рк╕рлНркп, рк╣рк╕ркдрлА ркЖркВркЦрлЛ, ркорлБркЦ
ЁЯШЪ => ЁЯШЪ, ркЪрлБркВркмрки ркХрк░рк╡рлБркВ, ркмркВркз ркЖркВркЦрлЛ рк╕рк╛ркерлЗ ркЪрлБркВркмрки ркХрк░рк╡рлБркВ, ркмркВркз ркЖркВркЦрлЛ, ркЪрк╣рлЗрк░рлЛ, ркорлБркЦ
тШ║ => тШ║, рк╕рлНркорк╛ркЗрк▓рлА, ркмрк┐рки-ркнрк░рлЗрк▓рлЛ рк╕рлНркорк╛ркЗрк▓рлА ркЪрк╣рлЗрк░рлЛ, ркЪрк╣рлЗрк░рлЛ, ркорлБркЦ
ЁЯЩВ => ЁЯЩВ, ркЪрк╣рлЗрк░рлЛ, рк╕рлНркорк┐ркд, рк╣рк╛рк╕рлНркп, ркорлБркЦ
ЁЯдЧ => ЁЯдЧ, ркЪрк╣рлЗрк░рлЛ, ркорлБркЦ, ркЖрк▓рк┐ркВркЧрки, ркЖрк▓рк┐ркВркЧрки ркХрк░рк╡рлБркВ
ЁЯШЗ => ЁЯШЗ, рккрлНрк░ркнрк╛рк╡рк▓ркп рк╕рк╛ркерлЗркирлБркВ рк╣рк╛рк╕рлНркп, рк╣рк╛рк╕рлНркп, рккрлНрк░ркнрк╛рк╡рк▓ркп, ркЪрк╣рлЗрк░рлЛ, ркорлБркЦ
ЁЯдФ => ЁЯдФ, рк╡рк┐ркЪрк╛рк░рк╢рлАрк▓, рк╡рк┐ркЪрк╛рк░ ркХрк░ркдрлЛ, ркЪрк╣рлЗрк░рлЛ, ркорлБркЦ
ЁЯШР => ЁЯШР, ркнрк╛рк╡рк╢рлВркирлНркп ркЪрк╣рлЗрк░рлЛ, ркнрк╛рк╡рк╢рлВркирлНркп, ркдркЯрк╕рлНрке, ркЪрк╣рлЗрк░рлЛ, ркХрлЛркИ ркЯрк┐рккрлНрккркгрлА ркирк╣рлАркВ
ЁЯШС => ЁЯШС, рк╣рк╛рк╡ркнрк╛рк╡рк╡рк┐рк╣рлАрки, ркЕркХркеркирлАркп ркЪрк╣рлЗрк░рлЛ, ркЪрк╣рлЗрк░рлЛ, ркХрлЛркИ ркЯрк┐рккрлНрккркгрлА ркирк╣рлАркВ, ркорлБркЦ
ЁЯШ╢ => ЁЯШ╢, ркорлЛркВркврк╛ рк╡ркЧрк░ркирлЛ, ркЪрк╣рлЗрк░рлЛ, ркорлБркЦ
ЁЯЩД => ЁЯЩД, ркЖркВркЦрлЛ, ркорлБркЦ, ркЪрк╣рлЗрк░рлЛ, рклрлЗрк░рк╡рк╡рлА, рклрлЗрк░рк╡ркдрлЛ
ЁЯШП => ЁЯШП, ркХрлГркдрлНрк░рк┐рко рк╣рк╛рк╕рлНркп, ркЪрк╣рлЗрк░рлЛ, ркорлБркЦ
ЁЯШг => ЁЯШг, ркдрлЗ ркнрлВрк▓ ркеркИ, ркорк╛рк░рк╛ркерлА ркнрлВрк▓ ркеркИркирлЛ ркЪрк╣рлЗрк░рлЛ, ркЬркмрк░ркжрк╕рлНркд, ркЪрк╣рлЗрк░рлЛ, ркорлБркЦ
ЁЯШе => ЁЯШе, ркирк╡рк╛ркИ!, ркирк╛ркЦрлБрк╢ рккрк░ркВркдрлБ рк░рк╛рк╣ркдрк╡рк╛рк│рлЛ, рк░рк╛рк╣ркд, ркирк╛ркЦрлБрк╢, ркЪрк╣рлЗрк░рлЛ
ЁЯШо => ЁЯШо, ркЦрлБрк▓рлНрк▓рлБркВ ркорлЛркврлБркВ, ркорлЛркВркврлБркВ, ркЪрк╣рлЗрк░рлЛ, рк╕рк╣рк╛ркирлБркнрлВркдрк┐
ЁЯдР => ЁЯдР, ркЪрк╣рлЗрк░рлЛ, ркорлБркЦ, ркЭрк┐рккркерлА ркмркВркз ркХрк░рлЗрк▓рлЛ ркорлЛркврлБркВ
ЁЯШп => ЁЯШп, ркЕрк╡рк╛ркХ, ркЕркЪркВркнрк┐ркд, ркЪрк╣рлЗрк░рлЛ
ЁЯШк => ЁЯШк, ркКркВркШркдрлБркВ, ркЪрк╣рлЗрк░рлЛ
ЁЯШл => ЁЯШл, ркерк╛ркХрлЗрк▓рлЛ, ркЪрк╣рлЗрк░рлЛ
ЁЯШ┤ => ЁЯШ┤, ркирк┐ркжрлНрк░рк╛ркорк╛ркВ, ркирк┐ркжрлНрк░рк╛ркорк╛ркВркирлЛ ркЪрк╣рлЗрк░рлЛ, ркЪрк╣рлЗрк░рлЛ
ЁЯШМ => ЁЯШМ, рк░рк╛рк╣ркдрк╡рк╛рк│рлЛ ркЪрк╣рлЗрк░рлЛ, рк░рк╛рк╣ркд, ркЪрк╣рлЗрк░рлЛ
ЁЯдУ => ЁЯдУ, ркЪрк╣рлЗрк░рлЛ, ркорлБркЦ, ркнрлЛрк│рккркг, ркорлБрк░рлНркЦркдрк╛ркирк╛ ркнрк╛рк╡рк╡рк╛рк│рлЛ ркЪрк╣рлЗрк░рлЛ
ЁЯШЫ => ЁЯШЫ, ркЬрлАркн ркмрк╣рк╛рк░, ркмрк╣рк╛рк░ ркХрк╛ркврлЗрк▓рлА ркЬрлАркн, ркмрк╣рк░ ркХрк╛ркврлЗрк▓рлА ркЬрлАркн рк╕рк╛ркерлЗркирлЛ ркЪрк╣рлЗрк░рлЛ, ркЪрк╣рлЗрк░рлЛ
ЁЯШЬ => ЁЯШЬ, ркЬрлАркн ркмрк╣рк╛рк░, ркорк╛ркдрлНрк░ рк╣рлЗрк░рк╛рки ркХрк░рк╡рлБркВ, ркЖркВркЦ ркорк╛рк░рк╡рк╛ркирлА рк╕рк╛ркерлЗ ркЬрлАркн ркмрк╣рк╛рк░, ркоркЬрк╛ркХ, ркЪрк╣рлЗрк░рлЛ
ЁЯШЭ => ЁЯШЭ, ркпркХ, ркмркВркз ркЖркВркЦрлЛ рк╕рк╛ркерлЗ ркмрк╣рк╛рк░ ркХрк╛ркврлЗрк▓рлА ркЬрлАркн, ркнркпркВркХрк░, ркмрк╣рк╛рк░ ркХрк╛ркврлЗрк▓рлА ркЬрлАркн, ркмркВркз ркЖркВркЦрлЛ, ркЪрк╣рлЗрк░рлЛ, ркорлБркЦ
тШ╣ => тШ╣, ркЧркоркЧрлАрки, ркЪрк╣рлЗрк░рлЛ, ркорлБркЦ
ЁЯЩБ => ЁЯЩБ, ркЧркоркЧрлАрки, ркЪрк╣рлЗрк░рлЛ, ркорлБркЦ
ЁЯШТ => ЁЯШТ, ркирк╛ркЦрлБрк╢, ркжрлБркГркЦрлА, ркЪрк╣рлЗрк░рлЛ
ЁЯШУ => ЁЯШУ, ркаркВркбрлЛ рккрк░рк╕рлЗрк╡рлЛ, ркЪрк╣рлЗрк░рлЛ
ЁЯШФ => ЁЯШФ, ркирк╛рк╕рлАрккрк╛рк╕, рк╡рк┐ркЪрк╛рк░ркЧрлНрк░рк╕рлНркд, ркЪрк╣рлЗрк░рлЛ
ЁЯШХ => ЁЯШХ, ркорлВркВркЭрк╛ркпрлЗрк▓, ркЪрк╣рлЗрк░рлЛ
ЁЯШЦ => ЁЯШЦ, ркЖркХрлБрк│рк╡рлНркпрк╛ркХрлБрк│, ркЪрк╣рлЗрк░рлЛ
ЁЯЩГ => ЁЯЩГ, ркЪрк╣рлЗрк░рлЛ, ркорлБркЦ, ркКркВркзрлЛ
ЁЯШ╖ => ЁЯШ╖, ркаркВркбрлЛ, рк╣рк╡рк╛ркорк╛рки рк╣рлЗркарк│, ркдркмрлАркмрлА ркорк╛рк╕рлНркХ, ркорк╛рк╕рлНркХ, ркЪрк╣рлЗрк░рлЛ
ЁЯдТ => ЁЯдТ, ркерк░рлНркорлЛркорлАркЯрк░, ркЪрк╣рлЗрк░рлЛ, ркорлБркЦ, ркмрлАркорк╛рк░, ркорк╛ркВркжрлБркВ
ЁЯдХ => ЁЯдХ, рккркЯрлНркЯрлА, ркИркЬрк╛, ркЪрк╣рлЗрк░рлЛ, ркорлБркЦ, ркШрк╛
ЁЯдС => ЁЯдС, ркЪрк╣рлЗрк░рлЛ, ркорлБркЦ, ркирк╛ркгрк╛ркВ, ркзрки, рк░рлВрккрк┐ркпрк╛
ЁЯШ▓ => ЁЯШ▓, ркЖрк╢рлНркЪрк░рлНркпркЪркХрк┐ркд, ркПркХркжрко ркЖркШрк╛ркд рк▓рк╛ркЧрлЗрк▓, ркЖркШрк╛ркд рк▓рк╛ркЧрлЗрк▓, ркЪрк╣рлЗрк░рлЛ
ЁЯШЮ => ЁЯШЮ, ркирк┐рк░рк╛рк╢, ркирк┐рк░рк╛рк╢рк╛, ркЪрк╣рлЗрк░рлЛ
ЁЯШЯ => ЁЯШЯ, ркЪрк┐ркВркдрк╛ркЧрлНрк░рк╕рлНркд, ркЪрк╣рлЗрк░рлЛ
ЁЯШд => ЁЯШд, рк╡рк┐ркЬркпрлА ркжрлЗркЦрк╛рк╡, рк╣рлБркВ ркЬрлАркдрлНркпрлЛ, рк╡рк┐ркЬркп, ркЪрк╣рлЗрк░рлЛ
ЁЯШв => ЁЯШв, рк░ркбрк╡рлБркВ, ркжрлБркГркЦрлА, ркЖркВрк╕рлБркУ, ркЪрк╣рлЗрк░рлЛ
ЁЯШн => ЁЯШн, ркорлЛркЯрлЗркерлА рк░ркбрк╡рлБркВ, ркЕрк╢рлНрк░рлБ, рк░ркбрк╡рлБркВ, рк░рлБркжрки, ркЪрк╣рлЗрк░рлЛ
ЁЯШж => ЁЯШж, ркнрк╡рк╛ркВ ркЪркбрк╛рк╡ркдрлЛ ркЪрк╣рлЗрк░рлЛ, ркЦрлБрк▓рлНрк▓рк╛ркВ ркорлЛркВркврк╛ рк╕рк╛ркерлЗ ркнрк╡рк╛ркВ ркЪркбрк╛рк╡рк╡рк╛ркВ, ркнрк╡рк╛ркВ ркЪркбрк╛рк╡рк╡рк╛ркВ, ркЦрлБрк▓рлНрк▓рлБркВ ркорлЛркВркврлБркВ, ркЪрк╣рлЗрк░рлЛ
ЁЯШз => ЁЯШз, ркжрлБркГркЦрлА, рккрлАркбрк╛рк╡рк╡рлБркВ, ркЪрк╣рлЗрк░рлЛ
ЁЯШи => ЁЯШи, ркнркпркЧрлНрк░рк╕рлНркд, ркнркпркнрлАркд, ркЪрк╣рлЗрк░рлЛ
ЁЯШй => ЁЯШй, ркХркВркЯрк╛рк│рк╛ркЬркиркХ, ркерк╛ркХрлЗрк▓рлЛ, ркЪрк╣рлЗрк░рлЛ
ЁЯШм => ЁЯШм, ркЪрлЗркиркЪрк╛рк│рк╛, ркЪрлЗрк╖рлНркЯрк╛ ркХрк░рк╡рлА, ркЪрк╣рлЗрк░рлЛ
ЁЯШ░ => ЁЯШ░, ркзрк╕рлЗрк▓рлЛ ркЪрк╣рлЗрк░рлЛ, ркаркВркбрк╛ рккрк░рк╕рлЗрк╡рк╛ рк╕рк╛ркерлЗркирлЛ рк╡рк╛ркжрк│рлА ркЪрк╣рлЗрк░рлЛ, ркЦрлБрк▓рлНрк▓рлБркВ ркорлЛркврлБркВ, ркаркВркбрлЛ рккрк░рк╕рлЗрк╡рлЛ, ркЪрк╣рлЗрк░рлЛ
ЁЯШ▒ => ЁЯШ▒, ркнркпркЧрлНрк░рк╕рлНркд ркЪрк╣рлЗрк░рлЛ, ркнркпркорк╛ркВ ркЪрлАрк╕рлЛ рккрк╛ркбрк╡рлА, ркнркп, ркнркпркЧрлНрк░рк╕рлНркд, ркнркпркнрлАркд, ркЪрк╣рлЗрк░рлЛ
ЁЯШ│ => ЁЯШ│, рклрлНрк▓рк╢рлНркб, рклрлНрк▓рк╢рлНркб ркЪрк╣рлЗрк░рлЛ, рк╕рлНркдркмрлНркзркдрк╛ркорк╛ркВ, рк╕рлНркдркмрлНркз, ркЪрк╣рлЗрк░рлЛ
ЁЯШ╡ => ЁЯШ╡, ркЪркХрлНркХрк░, ркЪрк╣рлЗрк░рлЛ
ЁЯШб => ЁЯШб, рк░рк┐рк╕рк╛рк╡рлБркВ, ркЧрлБрк╕рлНрк╕рлЗрк▓, рккрк╛ркЧрк▓, рк▓рк╛рк▓ ркЪрк╣рлЗрк░рлЛ, ркЪрк╣рлЗрк░рлЛ
ЁЯШа => ЁЯШа, ркЧрлБрк╕рлНрк╕рлЗрк▓, рккрк╛ркЧрк▓, ркЪрк╣рлЗрк░рлЛ
ЁЯШИ => ЁЯШИ, рк╢рк┐ркВркЧркбрк╛ рк╕рк╛ркерлЗркирлБркВ рк╣рк╛рк╕рлНркп, рк╣рк╛рк╕рлНркп, рк╢рк┐ркВркЧркбрк╛, ркЪрк╣рлЗрк░рлЛ
ЁЯС┐ => ЁЯС┐, imp, ркирк╛ркирлЛ рк╢рлЗркдрк╛рки, ркЪрк╣рлЗрк░рлЛ
ЁЯС╣ => ЁЯС╣, рк░рк╛ркХрлНрк╖рк╕, ркУркирлА, рккрк░рлА ркХркерк╛, ркЬрк╛рккрк╛ркирлА ркжрлИркдрлНркп, ркЪрк╣рлЗрк░рлЛ
ЁЯС║ => ЁЯС║, рк░рк╛ркХрлНрк╖рк╕, ркЯрлЗркирлНркЧрлБ, рккрк░рлА ркХркерк╛, ркЬрк╛рккрк╛ркирлА рккрлНрк░рлЗркд, ркЪрк╣рлЗрк░рлЛ
ЁЯТА => ЁЯТА, рккрк░рлА ркХркерк╛, рк╢рк░рлАрк░, ркЪрк╣рлЗрк░рлЛ
тШа => тШа, ркорлГркдрлНркпрлБ, рк░рк╛ркХрлНрк╖рк╕, ркжрлИркдрлНркп, рк╢рк░рлАрк░, ркЪрк╣рлЗрк░рлЛ, ркорлБркЦ
ЁЯС╗ => ЁЯС╗, рккрк░рлА ркХркерк╛, ркЪрк╣рлЗрк░рлЛ
ЁЯС╜ => ЁЯС╜, рккрлГркерлНрк╡рлА ркмрк╣рк╛рк░ркирк╛ркВ, UFO, рккрк░рлА ркХркерк╛, ркЪрк╣рлЗрк░рлЛ
ЁЯС╛ => ЁЯС╛, рк░рк╛ркХрлНрк╖рк╕, UFO, рккрк░рлА ркХркерк╛, ркЪрк╣рлЗрк░рлЛ
ЁЯдЦ => ЁЯдЦ, ркорлБркЦ, ркЪрк╣рлЗрк░рлЛ, рк░рлЛркмрлЛркЯ, ркорк╢рлАркирлА ркорк╛ркирк╡
ЁЯТй => ЁЯТй, рккрлВркк, ркЦрлВркВркЯрлЛ
ЁЯШ║ => ЁЯШ║, рк╕рлНркорк┐ркд ркХрк░ркдрлА ркмрк┐рк▓рк╛ркбрлАркирлЛ ркЪрк╣рлЗрк░рлЛ, ркмрк┐рк▓рк╛ркбрлАркирлЛ ркЪрк╣рлЗрк░рлЛ, ркЦрлБрк▓рлНрк▓рлБркВ ркорлЛркВркврлБркВ, ркЦрлБрк▓рлНрк▓рлБркВ, ркорлЛркВркврлБркВ, ркмрк┐рк▓рк╛ркбрлА, ркЪрк╣рлЗрк░рлЛ
ЁЯШ╕ => ЁЯШ╕, рк╣рк╕ркдрлА ркмрк┐рк▓рк╛ркбрлАркирлЛ ркЪрк╣рлЗрк░рлЛ, рк╣рк╕ркдрлА, рк╣рк╕ркдрлА ркЖркВркЦрлЛ ркЕркирлЗ рк╣рк╕рк╡рк╛ рк╕рк╛ркерлЗркирлЛ ркмрк┐рк▓рк╛ркбрлАркирлЛ ркЪрк╣рлЗрк░рлЛ, ркмрк┐рк▓рк╛ркбрлАркирлЛ ркЪрк╣рлЗрк░рлЛ, ркмрк┐рк▓рк╛ркбрлА, ркЪрк╣рлЗрк░рлЛ
ЁЯШ╣ => ЁЯШ╣, ркЖркиркВркжрк╛рк╢рлНрк░рлБ, ркмрк┐рк▓рк╛ркбрлАркирлЛ ркЪрк╣рлЗрк░рлЛ, ркмрк┐рк▓рк╛ркбрлА, ркЪрк╣рлЗрк░рлЛ
ЁЯШ╗ => ЁЯШ╗, рк╕рлНркорк┐ркд ркХрк░ркдрлА ркмрк┐рк▓рк╛ркбрлАркирлЛ ркЪрк╣рлЗрк░рлЛ, рккрлНрк░рлЗркоркорк╛ркВ, рккрлНрк░рлЗрко, рк╣рлГркжркп, ркЖркВркЦрлЛ, ркмрк┐рк▓рк╛ркбрлАркирлЛ ркЪрк╣рлЗрк░рлЛ, ркмрк┐рк▓рк╛ркбрлА, ркЪрк╣рлЗрк░рлЛ
ЁЯШ╝ => ЁЯШ╝, рк╡рлНркпркВркЧрккрлВрк░рлНркг ркмрк┐рк▓рк╛ркбрлАркирлЛ ркЪрк╣рлЗрк░рлЛ, рк╡рлНркпркВркЧрккрлВрк░рлНркг, ркорк╛рк░рлНркорк┐ркХ рк╣рк╛рк╕рлНркп, ркмрк┐рк▓рк╛ркбрлАркирлЛ ркЪрк╣рлЗрк░рлЛ, ркмрк┐рк▓рк╛ркбрлА, ркЪрк╣рлЗрк░рлЛ
ЁЯШ╜ => ЁЯШ╜, ркЪрлБркВркмрки ркХрк░ркдрлА ркмрк┐рк▓рк╛ркбрлА, ркмркВркз ркЖркВркЦрлЛ, ркЪрлБркВркмрки ркХрк░ркдрлА, ркЪрлБркВркмрки, ркЖркВркЦрлЛ, ркмркВркз, ркмрк┐рк▓рк╛ркбрлА, ркЪрк╣рлЗрк░рлЛ
ЁЯЩА => ЁЯЩА, ркХркВркЯрк╛рк│рк╛ркЬркиркХ ркмрк┐рк▓рк╛ркбрлАркирлЛ ркЪрк╣рлЗрк░рлЛ, рк╣рлЗ ркнркЧрк╡рк╛рки, ркЦрк░рлЗркЦрк░ ркЖрк╢рлНркЪрк░рлНркпркЪркХрк┐ркд, ркмрк┐рк▓рк╛ркбрлА, ркЪрк╣рлЗрк░рлЛ
ЁЯШ┐ => ЁЯШ┐, рк░ркбрк╡рлБркВ, рк░рлБркжрки, ркмрк┐рк▓рк╛ркбрлАркирлЛ ркЪрк╣рлЗрк░рлЛ, ркмрк┐рк▓рк╛ркбрлА, ркЪрк╣рлЗрк░рлЛ
ЁЯШ╛ => ЁЯШ╛, рк░рк┐рк╕рк╛рк╡рлБркВ, ркмрк┐рк▓рк╛ркбрлАркирлЛ ркЪрк╣рлЗрк░рлЛ, ркмрк┐рк▓рк╛ркбрлА, ркЪрк╣рлЗрк░рлЛ
ЁЯЩИ => ЁЯЩИ, ркЦрк░рк╛ркм ркЬрлЛрк╢рлЛ ркирк╣рлАркВ ркмркдрк╛рк╡ркдрлЛ рк╡рк╛ркВркжрк░рлЛ, рк╡рк╛ркВркжрк░рлЛ
ЁЯЩЙ => ЁЯЩЙ, ркЦрк░рк╛ркм рк╕рк╛ркВркнрк│рк╢рлЛ ркирк╣рлАркВ ркмркдрк╛рк╡ркдрлЛ рк╡рк╛ркВркжрк░рлЛ, рк╡рк╛ркВркжрк░рлЛ
ЁЯЩК => ЁЯЩК, ркЦрк░рк╛ркм ркмрлЛрк▓рк╢рлЛ ркирк╣рлАркВ ркмркдрк╛рк╡ркдрлЛ рк╡рк╛ркВркжрк░рлЛ, рк╡рк╛ркВркжрк░рлЛ
ЁЯСж => ЁЯСж, рк▓рлЛркХрлЛ
ЁЯСз => ЁЯСз, рк▓рлЛркХрлЛ
ЁЯСи => ЁЯСи, рк▓рлЛркХрлЛ
ЁЯСитАНтЪХ => ЁЯСитАНтЪХ, ркбрлЙркХрлНркЯрк░, ркЖрк░рлЛркЧрлНркпрк╕ркВркнрк╛рк│, рккрлБрк░рлБрк╖, ркирк░рлНрк╕, ркЙрккркЪрк╛рк░ркХ
ЁЯСитАНЁЯОУ => ЁЯСитАНЁЯОУ, рк╡рк┐ркжрлНркпрк╛рк░рлНркерлА, рккрлБрк░рлБрк╖, рк╕рлНркирк╛ркдркХ
ЁЯСитАНЁЯМ╛ => ЁЯСитАНЁЯМ╛, ркЦрлЗркбрлВркд, ркорк╛рк▓рлА, рккрлБрк░рлБрк╖
ЁЯСитАНЁЯН│ => ЁЯСитАНЁЯН│, рк░рк╕рлЛркЗркпрлЛ, рк░рк╛ркВркзрк╡рлБркВ, рккрлБрк░рлБрк╖, ркорк╣рк╛рк░рк╛ркЬ
ЁЯСитАНЁЯПл => ЁЯСитАНЁЯПл, ркЕркзрлНркпрк╛рккркХ, рккрлБрк░рлБрк╖, рк╢рк┐ркХрлНрк╖ркХ, ркорк╛рк╕рлНркЯрк░
ЁЯСитАНЁЯПн => ЁЯСитАНЁЯПн, ркоркВркбрк▓рлА, рклрлЕркХрлНркЯрк░рлА, ркФркжрлНркпрлЛркЧрк┐ркХ, рккрлБрк░рлБрк╖, ркХрк╛рк░рлНркпркХрк░рлНркдрк╛
ЁЯСитАНЁЯОи => ЁЯСитАНЁЯОи, ркХрк▓рк╛ркХрк╛рк░, рккрлБрк░рлБрк╖, ркЪрк┐ркдрлНрк░ркХрк╛рк░
ЁЯСитАНЁЯЪТ => ЁЯСитАНЁЯЪТ, ркЕркЧркирк┐рк╢рк╛ркоркХ, рккрлБрк░рлБрк╖
ЁЯСитАНтЬИ => ЁЯСитАНтЬИ, рккрлБрк░рлБрк╖, рккрк╛ркЗрк▓ркЯ, рк╡рк┐ркорк╛рки
ЁЯСитАНЁЯЪА => ЁЯСитАНЁЯЪА, ркЕрк╡ркХрк╛рк╢ркпрк╛ркдрлНрк░рлА, рккрлБрк░рлБрк╖, рк░рлЙркХрлЗркЯ, ркЕрк╡ркХрк╛рк╢
ЁЯСитАНЁЯОд => ЁЯСитАНЁЯОд, ркЕркнрк┐ркирлЗркдрк╛, ркоркирлЛрк░ркВркЬркиркХрк░рлНркдрк╛, рккрлБрк░рлБрк╖, рк░рлЙркХ, ркЧрк╛ркпркХ, рк╕рлНркЯрк╛рк░
ЁЯСитАНЁЯТ╗ => ЁЯСитАНЁЯТ╗, ркХрлЛркбрк░, рк╡рк┐ркХрк╛рк╕ркХрк░рлНркдрк╛, рк╢рлЛркзркХ, рккрлБрк░рлБрк╖, рк╕рлЛрклрлНркЯрк╡рлЗрк░, ркЯрлЗркХрлНркирлЙрк▓рлЛркЬрк┐рк╕рлНркЯ
ЁЯСитАНЁЯФм => ЁЯСитАНЁЯФм, ркЬрлАрк╡рк╡рк┐ркЬрлНркЮрк╛ркирлА, рк░рк╕рк╛ркпркгрк╢рк╛рк╕рлНркдрлНрк░рлА, ркПркирлНркЬрк┐ркирк┐ркЕрк░, рккрлБрк░рлБрк╖, ркЧркгрк┐ркдрк╢рк╛рк╕рлНркдрлНрк░рлА, ркнрлМркдрк┐ркХрк╡рк┐ркЬрлНркЮрк╛ркирлА, рк╡рлИркЬрлНркЮрк╛ркирк┐ркХ
ЁЯСитАНЁЯТ╝ => ЁЯСитАНЁЯТ╝, ркЖрк░рлНркХрк┐ркЯрлЗркХрлНркЯ, рк╡рлНркпрк╡рк╕рк╛ркп, рккрлБрк░рлБрк╖, рк╕ркВркЪрк╛рк▓ркХ, ркСрклрк┐рк╕
ЁЯСитАНЁЯФз => ЁЯСитАНЁЯФз, ркЗрк▓рлЗркХрлНркЯрлНрк░рк┐рк╢рки, рккрлБрк░рлБрк╖, ркХрк╛рк░рлАркЧрк░, рккрлНрк▓ркорлНркмрк░
ЁЯСитАНтЪЦ => ЁЯСитАНтЪЦ, ркирлНркпрк╛ркп, рккрлБрк░рлБрк╖, ркдрк░рк╛ркЬрлБ
ЁЯСй => ЁЯСй, рк▓рлЛркХрлЛ
ЁЯСйтАНтЪХ => ЁЯСйтАНтЪХ, ркбрлЙркХрлНркЯрк░, ркЖрк░рлЛркЧрлНркпрк╕ркВркнрк╛рк│, рк╕рлНркдрлНрк░рлА, ркирк░рлНрк╕, ркЙрккркЪрк╛рк░ркХ
ЁЯСйтАНЁЯОУ => ЁЯСйтАНЁЯОУ, рк╡рк┐ркжрлНркпрк╛рк░рлНркерк┐ркирлА, рк╕рлНркирк╛ркдркХ, рк╕рлНркдрлНрк░рлА
ЁЯСйтАНЁЯМ╛ => ЁЯСйтАНЁЯМ╛, ркЦрлЗркбрлВркд, рк╕рлНркдрлНрк░рлА
ЁЯСйтАНЁЯН│ => ЁЯСйтАНЁЯН│, рк░рк╕рлЛркпркг, рк░рк╛ркВркзрк╡рлБркВ, рк╕рлНркдрлНрк░рлА
ЁЯСйтАНЁЯПл => ЁЯСйтАНЁЯПл, ркЕркзрлНркпрк╛рккркХ, рк╕рлНркдрлНрк░рлА, рк╢рк┐ркХрлНрк╖ркХ, ркорк╛рк╕рлНркЯрк░
ЁЯСйтАНЁЯПн => ЁЯСйтАНЁЯПн, ркоркВркбрк▓рлА, рклрлЕркХрлНркЯрк░рлА, ркФркжрлНркпрлЛркЧрк┐ркХ, рк╕рлНркдрлНрк░рлА, ркХрк╛рк░рлНркпркХрк░рлНркдрк╛
ЁЯСйтАНЁЯОи => ЁЯСйтАНЁЯОи, ркХрк▓рк╛ркХрк╛рк░, рк╕рлНркдрлНрк░рлА, ркЪрк┐ркдрлНрк░ркХрк╛рк░
ЁЯСйтАНЁЯЪТ => ЁЯСйтАНЁЯЪТ, ркЕркЧркирк┐рк╢рк╛ркоркХ, рк╕рлНркдрлНрк░рлА
ЁЯСйтАНтЬИ => ЁЯСйтАНтЬИ, рк╕рлНркдрлНрк░рлА, рккрк╛ркЗрк▓ркЯ, рк╡рк┐ркорк╛рки
ЁЯСйтАНЁЯЪА => ЁЯСйтАНЁЯЪА, ркЕрк╡ркХрк╛рк╢ркпрк╛ркдрлНрк░рлА, рк╕рлНркдрлНрк░рлА, рк░рлЙркХрлЗркЯ, ркЕрк╡ркХрк╛рк╢
ЁЯСйтАНЁЯОд => ЁЯСйтАНЁЯОд, ркЕркнрк┐ркирлЗркдрк╛, ркоркирлЛрк░ркВркЬркиркХрк░рлНркдрк╛, рк╕рлНркдрлНрк░рлА, рк░рлЙркХ, ркЧрк╛ркпрк┐ркХрк╛, рк╕рлНркЯрк╛рк░
ЁЯСйтАНЁЯТ╗ => ЁЯСйтАНЁЯТ╗, ркХрлЛркбрк░, рк╡рк┐ркХрк╛рк╕ркХрк░рлНркдрк╛, рк╢рлЛркзркХ, рк╕рлНркдрлНрк░рлА, рк╕рлЛрклрлНркЯрк╡рлЗрк░, ркЯрлЗркХрлНркирлЙрк▓рлЛркЬрк┐рк╕рлНркЯ
ЁЯСйтАНЁЯФм => ЁЯСйтАНЁЯФм, ркЬрлАрк╡рк╡рк┐ркЬрлНркЮрк╛ркирлА, рк░рк╕рк╛ркпркгрк╢рк╛рк╕рлНркдрлНрк░рлА, ркПркирлНркЬрк┐ркирк┐ркЕрк░, рк╕рлНркдрлНрк░рлА, ркЧркгрк┐ркдрк╢рк╛рк╕рлНркдрлНрк░рлА, ркнрлМркдрк┐ркХрк╡рк┐ркЬрлНркЮрк╛ркирлА, рк╡рлИркЬрлНркЮрк╛ркирк┐ркХ
ЁЯСйтАНЁЯТ╝ => ЁЯСйтАНЁЯТ╝, ркЖрк░рлНркХрк┐ркЯрлЗркХрлНркЯ, рк╡рлНркпрк╡рк╕рк╛ркп, рк╕рлНркдрлНрк░рлА, рк╕ркВркЪрк╛рк▓ркХ, ркСрклрк┐рк╕
ЁЯСйтАНЁЯФз => ЁЯСйтАНЁЯФз, ркЗрк▓рлЗркХрлНркЯрлНрк░рк┐рк╢рки, рк╕рлНркдрлНрк░рлА, ркорлЗркХрлЕркирк┐ркХ, рккрлНрк▓ркорлНркмрк░
ЁЯСйтАНтЪЦ => ЁЯСйтАНтЪЦ, ркирлНркпрк╛ркп, рк╕рлНркдрлНрк░рлА, ркдрк░рк╛ркЬрлБ
ЁЯС┤ => ЁЯС┤, ркШрк░ркбрлЛ рккрлБрк░рлБрк╖, рккрлБрк░рлБрк╖, ркШрк░ркбрлЛ, рк▓рлЛркХрлЛ
ЁЯС╡ => ЁЯС╡, ркШрк░ркбрлА рк╕рлНркдрлНрк░рлА, рк╕рлНркдрлНрк░рлА, ркШрк░ркбрлА, рк▓рлЛркХрлЛ
ЁЯС╢ => ЁЯС╢, рк▓рлЛркХрлЛ
ЁЯС▒ => ЁЯС▒, рк▓рлЛркХрлЛ
ЁЯС▒тАНтЩА => ЁЯС▒тАНтЩА, рк╕рлЛркирлЗрк░рлА рк╡рк╛рк│рк╡рк╛рк│рлБркВ, рк╕рлНркдрлНрк░рлА
ЁЯС▒тАНтЩВ => ЁЯС▒тАНтЩВ, рк╕рлЛркирлЗрк░рлА рк╡рк╛рк│рк╡рк╛рк│рлБркВ, рккрлБрк░рлБрк╖
ЁЯСо => ЁЯСо, рккрлЛрк▓рлАрк╕, ркЕркзрк┐ркХрк╛рк░рлА, рк▓рлЛркХрлЛ
ЁЯСотАНтЩА => ЁЯСотАНтЩА, рк╕рлНркдрлНрк░рлА, ркЕркзрк┐ркХрк╛рк░рлА, рккрлЛрк▓рлАрк╕
ЁЯСотАНтЩВ => ЁЯСотАНтЩВ, рккрлБрк░рлБрк╖, ркЕркзрк┐ркХрк╛рк░рлА, рккрлЛрк▓рлАрк╕
ЁЯС▓ => ЁЯС▓, рккрлБрк░рлБрк╖, ркЧрлБркЖ рккрлА ркорк╛ркУ рк╕рк╛ркерлЗркирлЛ рккрлБрк░рлБрк╖, ркЧрлБркЖ рккрлА ркорк╛ркУ, рк▓рлЛркХрлЛ
ЁЯС│ => ЁЯС│, рккрлБрк░рлБрк╖, рккрк╛ркШркбрлА, рк▓рлЛркХрлЛ
ЁЯС│тАНтЩА => ЁЯС│тАНтЩА, рккрк╛ркШркбрлА, рк╕рлНркдрлНрк░рлА
ЁЯС│тАНтЩВ => ЁЯС│тАНтЩВ, рккрк╛ркШркбрлА, рккрлБрк░рлБрк╖
ЁЯС╖ => ЁЯС╖, ркмрк╛ркВркзркХрк╛рко, ркХрк╛рк░рлАркЧрк░, рк▓рлЛркХрлЛ
ЁЯС╖тАНтЩА => ЁЯС╖тАНтЩА, ркХрк╛рк░рлАркЧрк░, ркмрк╛ркВркзркХрк╛рко, рк╕рлНркдрлНрк░рлА
ЁЯС╖тАНтЩВ => ЁЯС╖тАНтЩВ, ркХрк╛рк░рлАркЧрк░, ркмрк╛ркВркзркХрк╛рко, рккрлБрк░рлБрк╖
тЫС => тЫС, ркоркжркж, рк╕рк╣рк╛ркп, ркЯрлЛрккрлА, рк╣рлЗрк▓рлНркорлЗркЯ, ркЪрк╣рлЗрк░рлЛ, ркорлБркЦ, ркХрлНрк░рлЛрк╕
ЁЯС╕ => ЁЯС╕, рккрк░рлА ркХркерк╛, рк▓рлЛркХрлЛ
ЁЯТВ => ЁЯТВ, ркЪрлЛркХрлАркжрк╛рк░, рк▓рлЛркХрлЛ
ЁЯТВтАНтЩА => ЁЯТВтАНтЩА, ркЪрлЛркХрлАркжрк╛рк░, рк╕рлНркдрлНрк░рлА
ЁЯТВтАНтЩВ => ЁЯТВтАНтЩВ, ркЪрлЛркХрлАркжрк╛рк░, рккрлБрк░рлБрк╖
ЁЯХ╡ => ЁЯХ╡, ркЧрлБрккрлНркдркЪрк░, ркбрк┐ркЯрлЗркХрлНркЯрк┐рк╡, ркЫрлВрккрлА рккрлЛрк▓рлАрк╕ркирлЛ ркорк╛ркгрк╕
ЁЯХ╡тАНтЩА => ЁЯХ╡тАНтЩА, ркЬрк╛рк╕рлВрк╕, рк╕рлНркдрлНрк░рлА, ркЧрлБрккрлНркдркЪрк░
ЁЯХ╡тАНтЩВ => ЁЯХ╡тАНтЩВ, ркЬрк╛рк╕рлВрк╕, рккрлБрк░рлБрк╖, ркЧрлБрккрлНркдркЪрк░
ЁЯОЕ => ЁЯОЕ, рк╕рк╛ркВркдрк╛, рклрк╛ркзрк░ ркХрлНрк░рк┐рк╕ркорк╕, ркирк╛ркдрк╛рк▓, ркЙркЬрк╡ркгрлА
ЁЯС╝ => ЁЯС╝, ркжрлЗрк╡ркжрлВркд, рккрк░рлА ркХркерк╛, ркЪрк╣рлЗрк░рлЛ
ЁЯСп => ЁЯСп, рк╕рк╕рк▓рк╛ ркЬрлЗрк╡рлА рк▓рк╛ркЧркдрлА ркЫрлЛркХрк░рлА, рк╕рк╕рк▓рк╛ ркЬрлЗрк╡рк╛ ркХрк╛рки, ркЫрлЛркХрк░рлА, рк╕рлНркдрлНрк░рлА, ркирлГркдрлНркпрк╛ркВркЧркирк╛, рк▓рлЛркХрлЛ
ЁЯСптАНтЩА => ЁЯСптАНтЩА, ркирлГркдрлНркпрк╛ркВркЧркирк╛, рк╕рлНркдрлНрк░рлАркУ, рк╕рк╕рк▓рк╛ ркЬрлЗрк╡рк╛ ркХрк╛рки, ркбрк╛ркирлНрк╕рк░, рккрк╛рк░рлНркЯрлА
ЁЯСптАНтЩВ => ЁЯСптАНтЩВ, ркирлГркдрлНркпрк╛ркВркЧркирк╛, рккрлБрк░рлБрк╖рлЛ, рк╕рк╕рк▓рк╛ ркЬрлЗрк╡рк╛ ркХрк╛рки, ркбрк╛ркирлНрк╕рк░, рккрк╛рк░рлНркЯрлА
ЁЯТЖ => ЁЯТЖ, ркорк╕рк╛ркЬ, рк╕рк▓рлБрки
ЁЯТЖтАНтЩА => ЁЯТЖтАНтЩА, ркорк╕рк╛ркЬ, рк╕рлНркдрлНрк░рлА, ркЪрк╣рлЗрк░рлЛ
ЁЯТЖтАНтЩВ => ЁЯТЖтАНтЩВ, ркорк╕рк╛ркЬ, рккрлБрк░рлБрк╖, ркЪрк╣рлЗрк░рлЛ
ЁЯТЗ => ЁЯТЗ, ркмрлНркпрлБркЯрлАрккрк╛рк░рлНрк▓рк░, рк╕рлБркВркжрк░ркдрк╛, рккрк╛рк░рлНрк▓рк░
ЁЯТЗтАНтЩА => ЁЯТЗтАНтЩА, рк╣рлЗрк░ркХркЯ, рк╕рлНркдрлНрк░рлА
ЁЯТЗтАНтЩВ => ЁЯТЗтАНтЩВ, рк╣рлЗрк░ркХркЯ, рккрлБрк░рлБрк╖
ЁЯС░ => ЁЯС░, ркирк╡рк╡ркзрлБ, ркШрлВркВркШркЯ ркдрк╛ркгрлЗрк▓рлА ркирк╡рк╡ркзрлБ, ркШрлВркВркШркЯ, рк▓рлЛркХрлЛ
ЁЯЩН => ЁЯЩН, ркнрк╡рк╛ркВ ркЪркбрк╛рк╡рк╡рк╛ркВ, рк╡рлНркпркХрлНркдрк┐, рк╣рк╛рк╡ркнрк╛рк╡
ЁЯЩНтАНтЩА => ЁЯЩНтАНтЩА, ркнрк╡рк╛ркВ ркЪркбрк╛рк╡рк╡рк╛ркВ, рк╕рлНркдрлНрк░рлА, рк╣рк╛рк╡ркнрк╛рк╡
ЁЯЩНтАНтЩВ => ЁЯЩНтАНтЩВ, ркнрк╡рк╛ркВ ркЪркбрк╛рк╡рк╡рк╛ркВ, рккрлБрк░рлБрк╖, рк╣рк╛рк╡ркнрк╛рк╡
ЁЯЩО => ЁЯЩО, рк░рк┐рк╕рк╛рк╡рлБркВ, рк╡рлНркпркХрлНркдрк┐, рк╣рк╛рк╡ркнрк╛рк╡
ЁЯЩОтАНтЩА => ЁЯЩОтАНтЩА, рк░рк┐рк╕рк╛рк╡рлБркВ, рк╕рлНркдрлНрк░рлА, рк╣рк╛рк╡ркнрк╛рк╡
ЁЯЩОтАНтЩВ => ЁЯЩОтАНтЩВ, рк░рк┐рк╕рк╛рк╡рлБркВ, рккрлБрк░рлБрк╖, рк╣рк╛рк╡ркнрк╛рк╡
ЁЯЩЕ => ЁЯЩЕ, рк╕рк╛рк░рлБркВ ркиркерлА, ркирк╣рлАркВ, рккрлНрк░ркдрк┐ркмркВркзрк┐ркд, рк╣рк╛рк╡ркнрк╛рк╡, ркЪрк╣рлЗрк░рлЛ
ЁЯЩЕтАНтЩА => ЁЯЩЕтАНтЩА, ркЪрк╣рлЗрк░рлЛ, ркирк╣рлАркВ, рккрлНрк░ркдрк┐ркмркВркзрк┐ркд, рк╕рк╛рк░рлБркВ ркиркерлА, рк╣рк╛рк╡ркнрк╛рк╡, рк╕рлНркдрлНрк░рлА
ЁЯЩЕтАНтЩВ => ЁЯЩЕтАНтЩВ, ркЪрк╣рлЗрк░рлЛ, ркирк╣рлАркВ, рккрлНрк░ркдрк┐ркмркВркзрк┐ркд, рк╕рк╛рк░рлБркВ ркиркерлА, рк╣рк╛рк╡ркнрк╛рк╡, рккрлБрк░рлБрк╖
ЁЯЩЖ => ЁЯЩЖ, ркСркХрлЗ рк╣рк╛рк╡ркнрк╛рк╡, ркмркзрлБркВ ркмрк░рк╛ркмрк░ ркЫрлЗ, рк╣рк╛рк╡ркнрк╛рк╡, ркЪрк╣рлЗрк░рлЛ
ЁЯЩЖтАНтЩА => ЁЯЩЖтАНтЩА, ркСркХрлЗ рк╣рк╛рк╡ркнрк╛рк╡, ркЪрк╣рлЗрк░рлЛ, ркмркзрлБркВ ркмрк░рк╛ркмрк░ ркЫрлЗ, рк╕рлНркдрлНрк░рлА, рк╣рк╛рк╡ркнрк╛рк╡
ЁЯЩЖтАНтЩВ => ЁЯЩЖтАНтЩВ, ркСркХрлЗ рк╣рк╛рк╡ркнрк╛рк╡, ркЪрк╣рлЗрк░рлЛ, ркмркзрлБркВ ркмрк░рк╛ркмрк░ ркЫрлЗ, рккрлБрк░рлБрк╖, рк╣рк╛рк╡ркнрк╛рк╡
ЁЯТБ => ЁЯТБ, ркорк╛рк╣рк┐ркдрлА ркбрлЗрк╕рлНркХ, рк╕рк╣рк╛ркп, ркорк╛рк╣рк┐ркдрлА, рк▓рлЛркХрлЛ
ЁЯТБтАНтЩА => ЁЯТБтАНтЩА, ркорк╛рк╣рк┐ркдрлА, ркорк╛рк╣рк┐ркдрлА ркбрлЗрк╕рлНркХ, рк╕рлНркдрлНрк░рлА, рк╕рк╣рк╛ркп
ЁЯТБтАНтЩВ => ЁЯТБтАНтЩВ, ркорк╛рк╣рк┐ркдрлА, ркорк╛рк╣рк┐ркдрлА ркбрлЗрк╕рлНркХ, рккрлБрк░рлБрк╖, рк╕рк╣рк╛ркп
ЁЯЩЛ => ЁЯЩЛ, ркЦрлБрк╢ рк╡рлНркпркХрлНркдрк┐, ркЙрккрк░ рк╣рк╛рке ркЙркарк╛рк╡рк╡рлЛ, рк╣рк╛рке ркЙрккрк░ ркЙркарк╛рк╡рлЗрк▓ рк╡рлНркпркХрлНркдрк┐, ркЦрлБрк╢, рк╡рлНркпркХрлНркдрк┐, рк╣рк╛рк╡ркнрк╛рк╡
ЁЯЩЛтАНтЩА => ЁЯЩЛтАНтЩА, рк╣рк╛рк╡ркнрк╛рк╡, рк╕рлНркдрлНрк░рлА, ркЙрккрк░ рк╣рк╛рке ркЙркарк╛рк╡рк╡рлЛ
ЁЯЩЛтАНтЩВ => ЁЯЩЛтАНтЩВ, рк╣рк╛рк╡ркнрк╛рк╡, рккрлБрк░рлБрк╖, ркЙрккрк░ рк╣рк╛рке ркЙркарк╛рк╡рк╡рлЛ
ЁЯЩЗ => ЁЯЩЗ, ркоркирлЗ ркорк╛ркл ркХрк░рк╢рлЛ, ркКркВркбрлЗркерлА ркиркорлЗрк▓, ркорк╛ркл ркХрк░рк╢рлЛ, ркиркорк╡рлБркВ, рк╣рк╛рк╡ркнрк╛рк╡, рк╡рлНркпркХрлНркдрк┐
ЁЯЩЗтАНтЩА => ЁЯЩЗтАНтЩА, ркКркВркбрлЗркерлА ркиркорлЗрк▓, ркиркорк╡рлБркВ, ркоркирлЗ ркорк╛ркл ркХрк░рк╢рлЛ, ркорк╛ркл ркХрк░рк╢рлЛ, рк╕рлНркдрлНрк░рлА, рк╣рк╛рк╡ркнрк╛рк╡
ЁЯЩЗтАНтЩВ => ЁЯЩЗтАНтЩВ, ркКркВркбрлЗркерлА ркиркорлЗрк▓, ркиркорк╡рлБркВ, ркоркирлЗ ркорк╛ркл ркХрк░рк╢рлЛ, ркорк╛ркл ркХрк░рк╢рлЛ, рккрлБрк░рлБрк╖, рк╣рк╛рк╡ркнрк╛рк╡
ЁЯЩМ => ЁЯЩМ, рк╣рлБрк░рк░рлЗ, ркЙркЬрк╡ркгрлАркорк╛ркВ ркмркВркирлЗ рк╣рк╛рке ркЙркарк╛рк╡рк╡рк╛, ркмркВркирлЗ рк╣рк╛рке, ркЙркЬрк╡ркгрлА
ЁЯЩП => ЁЯЩП, ркЕркжркм рк╡рк╛рк│рлЗрк▓рк╛ рк╣рк╛рке, рккрлНрк░рк╛рк░рлНркеркирк╛, рккрлНрк░рк╛рк░рлНркеркирк╛ ркХрк░рк╡рлА, рк╣рк╛рке, рк╣рк╛рк╡ркнрк╛рк╡
ЁЯЧг => ЁЯЧг, ркорлБркЦ, ркорк╛ркерлБркВ, ркмрлЛрк▓рлЛ, ркмрлЛрк▓рк╡рлБркВ, рккрк╛рк░рлНрк╢рлНрк╡ ркЪрк┐ркдрлНрк░
ЁЯСд => ЁЯСд, рккрлЗркЯркерлА ркЙрккрк▓рлЛ ркнрк╛ркЧ, рккрк╛рк░рлНрк╢рлНрк╡ркЪрк┐ркдрлНрк░, рк▓рлЛркХрлЛ
ЁЯСе => ЁЯСе, рккрлЗркЯркерлА ркЙрккрк▓рк╛ ркнрк╛ркЧркирлБркВ рккрк╛рк░рлНрк╢рлНрк╡ркЪрк┐ркдрлНрк░, рккрлЗркЯркерлА ркЙрккрк▓рлЛ ркнрк╛ркЧ, рккрк╛рк░рлНрк╢рлНрк╡ркЪрк┐ркдрлНрк░, рк▓рлЛркХрлЛ
ЁЯЪ╢ => ЁЯЪ╢, рк░рк╛рк╣ркжрк╛рк░рлА
ЁЯЪ╢тАНтЩА => ЁЯЪ╢тАНтЩА, рк╣рк╛ркИркХ, рк╕рлНркдрлНрк░рлА, ркЪрк╛рк▓рк╡рлБркВ
ЁЯЪ╢тАНтЩВ => ЁЯЪ╢тАНтЩВ, рк╣рк╛ркИркХ, рккрлБрк░рлБрк╖, ркЪрк╛рк▓рк╡рлБркВ
ЁЯПГ => ЁЯПГ, ркжрлЛркб, ркорлЗрк░рк╛ркерлЛрки, ркЦрлЗрк▓ ркХрлВркж
ЁЯПГтАНтЩА => ЁЯПГтАНтЩА, рк╕рлНркдрлНрк░рлА, ркорлЗрк░рк╛ркерлЛрки, ркЦрлЗрк▓ ркХрлВркж, ркжрлЛркб
ЁЯПГтАНтЩВ => ЁЯПГтАНтЩВ, рккрлБрк░рлБрк╖, ркорлЗрк░рк╛ркерлЛрки, ркЦрлЗрк▓ ркХрлВркж, ркжрлЛркб
ЁЯТГ => ЁЯТГ, ркирлГркдрлНркп, рк▓рлЛркХрлЛ
ЁЯХ┤ => ЁЯХ┤, рк╡рлНркпрк╡рк╕рк╛ркп, ркмрк┐ркЭркирлЗрк╕, рк╡рлЗрккрк╛рк░, рккрлБрк░рлБрк╖, рк╕рлВркЯ
ЁЯТП => ЁЯТП, ркЪрлБркВркмрки ркХрк░ркдрк╛ркВ, рк▓рлЛркХрлЛ, рк░рлЛркорк╛ркВрк╕
ЁЯТС => ЁЯТС, ркпрлБркЧрк▓, ркжрк┐рк▓, рк▓рлЛркХрлЛ, рк░рлЛркорк╛ркВрк╕
ЁЯСк => ЁЯСк, рккрк┐ркдрк╛, ркорк╛ркдрк╛, ркмрк╛рк│ркХ, рк▓рлЛркХрлЛ
ЁЯСл => ЁЯСл, рккрлБрк░рлБрк╖ ркЕркирлЗ рк╕рлНркдрлНрк░рлА, ркпрлБркЧрк▓, рккрлБрк░рлБрк╖, рк╕рлНркдрлНрк░рлА, ркПркХркмрлАркЬрк╛ркирк╛ркВ рк╣рк╛рке рккркХркбрк╡рк╛, рк▓рлЛркХрлЛ
ЁЯСм => ЁЯСм, ркмрлЗ рккрлБрк░рлБрк╖, ркпрлБркЧрк▓, рккрлБрк░рлБрк╖, рк╣рк╛рке рккркХркбрк╡рк╛, рк▓рлЛркХрлЛ
ЁЯСн => ЁЯСн, ркмрлЗ рк╕рлНркдрлНрк░рлА, ркпрлБркЧрк▓, рк╕рлНркдрлНрк░рлА, рк╣рк╛рке рккркХркбрк╡рк╛, рк▓рлЛркХрлЛ
ЁЯП╗ => ЁЯП╗, ркдрлНрк╡ркЪрк╛, рк░ркВркЧ
ЁЯП╝ => ЁЯП╝, ркдрлНрк╡ркЪрк╛, рк░ркВркЧ
ЁЯП╜ => ЁЯП╜, ркдрлНрк╡ркЪрк╛, рк░ркВркЧ
ЁЯП╛ => ЁЯП╛, ркдрлНрк╡ркЪрк╛, рк░ркВркЧ
ЁЯП┐ => ЁЯП┐, ркдрлНрк╡ркЪрк╛, рк░ркВркЧ
ЁЯТк => ЁЯТк, рк╕рлНркирк╛ркпрлБ рклрк▓рлЗркХрлНрк╕, рк╕рлНркирк╛ркпрлБ, ркоркЬркмрлВркд, рклрк▓рлЗркХрлНрк╕, рк░ркорлВркЬрлА
ЁЯСИ => ЁЯСИ, ркбрк╛ркмрлА ркЖркВркЧрк│рлА, рккрк╣рлЗрк▓рлА ркЖркВркЧрк│рлА, рк╣рк╛ркеркирлЛ рккрк╛ркЫрк▓рлЛ ркнрк╛ркЧ, ркЖркВркЧрк│рлА
ЁЯСЙ => ЁЯСЙ, ркЬркоркгрлА ркЖркВркЧрк│рлА, рккрк╣рлЗрк▓рлА ркЖркВркЧрк│рлА, рк╣рк╛ркеркирлЛ рккрк╛ркЫрк▓рлЛ ркнрк╛ркЧ, ркЖркВркЧрк│рлА
тШЭ => тШЭ, рк╣рк╛рке, ркЖркВркЧрк│рлА, рк╢рк░рлАрк░, ркЙрккрк░, ркЪрлАркВркзркдрлА, рккрлНрк░ркерко ркЖркВркЧрк│рлА
ЁЯСЖ => ЁЯСЖ, ркЙрккрк░ ркЖркВркЧрк│рлА, ркЙрккрк░ркирлА ркмрк╛ркЬрлБ ркЪрлАркВркзрк╛ркпрлЗрк▓рлА ркЖркВркЧрк│рлА, рккрк╣рлЗрк▓рлА ркЖркВркЧрк│рлА, рк╣рк╛ркеркирлЛ рккрк╛ркЫрк▓рлЛ ркнрк╛ркЧ, ркЖркВркЧрк│рлА
ЁЯЦХ => ЁЯЦХ, рк╢рк░рлАрк░, ркЖркВркЧрк│рлА, рк╣рк╛рке, рк╡ркЪрлНркЪрлЗркирлА ркЖркВркЧрк│рлА, рк╡ркЪрк▓рлА ркЖркВркЧрк│рлА
ЁЯСЗ => ЁЯСЗ, ркирлАркЪрлА ркЖркВркЧрк│рлА, ркирлАркЪрлЗркирлА ркмрк╛ркЬрлБ ркЪрлАркВркзрк╛ркпрлЗрк▓рлА ркЖркВркЧрк│рлА, рккрк╣рлЗрк▓рлА ркЖркВркЧрк│рлА, рк╣рк╛ркеркирлЛ рккрк╛ркЫрк▓рлЛ ркнрк╛ркЧ, ркЖркВркЧрк│рлА
тЬМ => тЬМ, ркХрк╛ркдрк░, рк╡рк┐ркЬркпрлА рк╣рк╛рке, рк╡рк┐ркЬркп
ЁЯЦЦ => ЁЯЦЦ, рк╢рк░рлАрк░, ркЖркВркЧрк│рлА, рк╣рк╛рке, рк╕рлНрккрлЛркЕркХ, рк╡рк▓рлНркХрки
ЁЯдШ => ЁЯдШ, рк╢рк░рлАрк░, ркЖркВркЧрк│рлА, рк╣рк╛рке, рк╢рк┐ркВркЧркбрк╛ркВ, рк░рлЛркХ-ркСрки
ЁЯЦР => ЁЯЦР, рк╢рк░рлАрк░, ркЖркВркЧрк│рлА, рк╣рк╛рке, рклрлЗрк▓рк╛рк╡рлЗрк▓рлБркВ
тЬК => тЬК, ркорлБркарлНркарлА, рк╣рк╛рке
тЬЛ => тЬЛ, рк╣рк╛рке
ЁЯСК => ЁЯСК, ркорлБркарлНркарлА, рк╣рк╛рке
ЁЯСМ => ЁЯСМ, ркмрк░рк╛ркмрк░ рк╣рк╛рке ркЪрк┐рк╣рлНрки, ркмрк░рк╛ркмрк░, рк╣рк╛рке, ркЪрк┐рк╣рлНрки
ЁЯСН => ЁЯСН, ркЕркВркЧрлБркарлЛ, ркЙркВркЪрлЛ, рк╣рк╛рке, ркЪрк┐рк╣рлНрки
ЁЯСО => ЁЯСО, ркЕркВркЧрлБркарлЛ, ркирлАркЪрлЛ, рк╣рк╛рке, ркЪрк┐рк╣рлНрки
ЁЯСЛ => ЁЯСЛ, рк╣рк╛рке, рк╣рк▓рк╛рк╡рк╡рк╛
ЁЯСП => ЁЯСП, рк╣рк╛рке, ркдрк╛рк│рлА, ркЪрк┐рк╣рлНрки
ЁЯСР => ЁЯСР, ркЦрлБрк▓рлНрк▓рк╛ркВ рк╣рк╛ркеркирлБркВ ркЪрк┐рк╣рлНрки, рк╣рк╛рке, ркЦрлБрк▓рлНрк▓рк╛ркВ, ркЪрк┐рк╣рлНрки
тЬН => тЬН, рк╢рк░рлАрк░, рк╣рк╛рке, рк▓ркЦрк╛ркг, рк▓ркЦркдрлЛ, рк▓ркЦрк╡рлБркВ
ЁЯТЕ => ЁЯТЕ, ркиркЦркирлА рк╕ркВркнрк╛рк│, ркиркЦ, рк╣рк╛рке ркдркерк╛ ркиркЦркирлА рк╕рк╛ркЬрк╕ркВркнрк╛рк│, ркХрлЛрк╕рлНркорлЗркЯрк┐ркХрлНрк╕
ЁЯСВ => ЁЯСВ, рк╢рк░рлАрк░
ЁЯСГ => ЁЯСГ, ркЪрк╣рлЗрк░рлЛ, рк╢рк░рлАрк░
ЁЯСг => ЁЯСг, рккркЧ, ркирк┐рк╢рк╛рки, рк╢рк░рлАрк░
ЁЯСА => ЁЯСА, ркЪрк╣рлЗрк░рлЛ, рк╢рк░рлАрк░
ЁЯСБ => ЁЯСБ, рк╢рк░рлАрк░
ЁЯСБтАНЁЯЧи => ЁЯСБтАНЁЯЧи, ркЖркВркЦ, рк╕рлНрккрлАркЪ ркмркмрк▓, рк╕рк╛ркХрлНрк╖рлА
ЁЯСЕ => ЁЯСЕ, ркЪрк╣рлЗрк░рлЛ, рк╢рк░рлАрк░
ЁЯСД => ЁЯСД, рк╣рлЛрка, ркЪрк╣рлЗрк░рлЛ, рк╢рк░рлАрк░
ЁЯТЛ => ЁЯТЛ, рк╣рлЛрка, ркЪрлБркВркмрки, рк░рлЛркорк╛ркВрк╕
ЁЯТШ => ЁЯТШ, ркжрк┐рк▓ ркЕркирлЗ ркдрлАрк░, ркжрк┐рк▓, ркдрлАрк░, рккрлНрк░рлЗрко, рк▓рк╛ркЧркгрлА
тЭд => тЭд, рк▓рк╛рк▓, рк╣рлГркжркп
ЁЯТУ => ЁЯТУ, ркзркбркХркдрлБркВ, ркзркбркХрки, ркжрк┐рк▓, рккрлНрк░рлЗрко, рк▓рк╛ркЧркгрлА
ЁЯТФ => ЁЯТФ, рк╣рлГркжркп ркнркВркЧ, ркдрлЛркбрк╡рлБркВ, рк╣рлГркжркп, ркнркЧрлНрки, рк▓рк╛ркЧркгрлА
ЁЯТХ => ЁЯТХ, рккрлНрк░рлЗркорлАркУ, рккрлНрк░рлЗрко, рк▓рк╛ркЧркгрлА
ЁЯТЦ => ЁЯТЦ, рк░рлЛркорк╛ркВркЪрк┐ркд, ркЪрк│ркХркдрлБркВ, рккрлНрк░рлЗрко, рк▓рк╛ркЧркгрлА
ЁЯТЧ => ЁЯТЧ, ркорлВркВркЭрк╛ркпрлЗрк▓рлБркВ, рк░рлЛркорк╛ркВркЪрк┐ркд, ркжрк┐рк▓, рккрлНрк░рлЗрко, рк▓рк╛ркЧркгрлА
ЁЯТЩ => ЁЯТЩ, рк╡рк╛ркжрк│рлА, ркжрк┐рк▓, рк▓рк╛ркЧркгрлА
ЁЯТЪ => ЁЯТЪ, рк▓рлАрк▓рлБркВ, ркжрк┐рк▓, рк▓рк╛ркЧркгрлА
ЁЯТЫ => ЁЯТЫ, рккрлАрк│рлБркВ, ркжрк┐рк▓, рк▓рк╛ркЧркгрлА
ЁЯТЬ => ЁЯТЬ, ркЬрк╛ркВркмрк▓рлА, ркжрк┐рк▓, рк▓рк╛ркЧркгрлА
ЁЯТЭ => ЁЯТЭ, ркжрк┐рк▓, рк░рк┐ркмрки, рк╡рлЗрк▓рлЗркирлНркЯрк╛ркЗрки, рк▓рк╛ркЧркгрлА
ЁЯТЮ => ЁЯТЮ, ркжрк┐рк▓, ркнркоркдрк╛, рк╕рлБркВркжрк░, рккрлНрк░рлЗрко, ркЖрк░рк╛ркзрлНркп, рк▓рк╛ркЧркгрлА
ЁЯТЯ => ЁЯТЯ, ркжрк┐рк▓
тЭг => тЭг, ркЙркжрлНркЧрк╛рк░рк╡рк╛ркЪркХ, рк╣рлГркжркп, ркЪрк┐рк╣рлНрки, рк╡рк┐рк░рк╛ркоркЪрк┐рк╣рлНрки
ЁЯТМ => ЁЯТМ, ркжрк┐рк▓ рк╕рк╛ркерлЗркирлЛ ркорлЗркЗрк▓, рккркдрлНрк░, ркжрк┐рк▓, рк░рлЛркорк╛ркВрк╕
ЁЯТд => ЁЯТд, ркКркВркШрк░рлЗркЯрлА, ркКркВркШркдрлБркВ, рк░ркорлВркЬрлА, рк▓рк╛ркЧркгрлА
ЁЯТв => ЁЯТв, ркЧрлБрк╕рлНрк╕рлЛ, ркЧрлБрк╕рлНрк╕рлЗ ркеркпрлЗрк▓рлБркВ, ркХрлЛркорк┐ркХ, рк▓рк╛ркЧркгрлА
ЁЯТг => ЁЯТг, рк░ркорлВркЬрлА, рк▓рк╛ркЧркгрлА
ЁЯТе => ЁЯТе, ркЯркХрлНркХрк░ркирлБркВ рккрлНрк░ркдрлАркХ, рк░ркорлВркЬрлА, рк▓рк╛ркЧркгрлА
ЁЯТж => ЁЯТж, рккрк░рк╕рлЗрк╡рк╛ркирк╛ркВ ркЫрк╛ркВркЯрк╛, рккрк░рк╕рлЗрк╡рлЛ, рккрлНрк░рк╕рлНрк╡рлЗркжркпрлБркХрлНркд, рк░ркорлВркЬрлА, рк▓рк╛ркЧркгрлА
ЁЯТи => ЁЯТи, ркЪрк╛рк▓рлБ ркбрлЗрк╢, ркнрк╛ркЧрк╡рлБркВ, ркжрлЛркбрлЛ, рк░ркорлВркЬрлА, рк▓рк╛ркЧркгрлА
ЁЯТл => ЁЯТл, ркдрк╛рк░рк╛ ркЬрлЛрк╡рк╛, ркдрк╛рк░рк╛, рк░ркорлВркЬрлА, рк▓рк╛ркЧркгрлА
ЁЯТм => ЁЯТм, ркнрк╛рк╖ркг рккрк░рккрлЛркЯрлЛ, рк╕ркВрк╡рк╛ркж рккрк░рккрлЛркЯрлЛ, рклрлБркЧрлНркЧрлЛ, рккрк░рккрлЛркЯрлЛ, рк╕ркВрк╡рк╛ркж, рк░ркорлВркЬрлА
ЁЯЧи => ЁЯЧи, рк╕ркВрк╡рк╛ркж, рк╡рк╛ркгрлА, рк╕рлНрккрлАркЪ
ЁЯЧп => ЁЯЧп, ркХрлНрк░рлЛркз, ркмркмрк▓, рккрк░рккрлЛркЯрлЛ, рклрлБркЧрлНркЧрлЛ, рккрк╛ркЧрк▓
ЁЯТн => ЁЯТн, рк╡рк┐ркЪрк╛рк░ркирлЛ рккрк░рккрлЛркЯрлЛ, рк╡рк┐ркЪрк╛рк░, рккрк░рккрлЛркЯрлЛ, рк░ркорлВркЬрлА
ЁЯХ│ => ЁЯХ│, ркХрк╛ркгрлБркВ
ЁЯСУ => ЁЯСУ, ркЖркВркЦркирк╛ркВ ркЪрк╢рлНркорк╛, ркХрккркбрк╛ркВ
ЁЯХ╢ => ЁЯХ╢, ркЪрк╢рлНркорк╛ркВ, ркЖркВркЦ
ЁЯСФ => ЁЯСФ, ркЯрк╛ркЗ, ркХрккркбрк╛ркВ
ЁЯСХ => ЁЯСХ, рк╢рк░рлНркЯ, ркХрккркбрк╛ркВ
ЁЯСЦ => ЁЯСЦ, ркЯрлНрк░рк╛ркЙркЭрк░, рккрлЗркирлНркЯ, ркХрккркбрк╛ркВ
ЁЯСЧ => ЁЯСЧ, рк╡рки-рккрлАрк╕, ркХрккркбрк╛ркВ
ЁЯСШ => ЁЯСШ, ркбрлНрк░рлЗрк╕, ркХрккркбрк╛ркВ
ЁЯСЩ => ЁЯСЩ, ркирк╛рк╣рк╡рк╛ркирк╛ркВ ркХрккркбрк╛ркВ, ркХрккркбрк╛ркВ
ЁЯСЪ => ЁЯСЪ, ркХрккркбрк╛ркВ
ЁЯСЫ => ЁЯСЫ, рккрк╛ркХрлАркЯ, рккрлИрк╕рк╛ рк░рк╛ркЦрк╡рк╛ркирлБркВ рккрк╛ркХрлАркЯ, рк╕рк┐ркХрлНркХрлЛ, ркХрккркбрк╛ркВ
ЁЯСЬ => ЁЯСЬ, ркмрлЗркЧ, ркХрккркбрк╛ркВ
ЁЯСЭ => ЁЯСЭ, ркмрлЗркЧ, ркХрккркбрк╛ркВ
ЁЯЫН => ЁЯЫН, рк╣рлЛркЯрк▓, ркЦрк░рлАркжрлА, рк╢рлЛрккрк┐ркВркЧ
ЁЯОТ => ЁЯОТ, рк╕рлНркХрлВрк▓ ркмрлЗркЧ, рк╕рлНркХрлВрк▓ ркжрклркдрк░, ркжрклркдрк░, рк╕рлНркХрлВрк▓
ЁЯСЮ => ЁЯСЮ, ркЬрлВркдрк╛, ркХрккркбрк╛ркВ
ЁЯСЯ => ЁЯСЯ, рк╕рлНркирлАркХрк░, ркЬрлВркдрк╛, ркХрккркбрк╛ркВ
ЁЯСа => ЁЯСа, ркЙркВркЪрлА рк╣рк┐рк▓, ркЬрлВркдрк╛, ркХрккркбрк╛ркВ
ЁЯСб => ЁЯСб, рк╕рлЗркирлНркбрк▓, рк╕рлНркдрлНрк░рлА, ркХрккркбрк╛ркВ
ЁЯСв => ЁЯСв, ркмрлВркЯ, рк╕рлНркдрлНрк░рлА, ркХрккркбрк╛ркВ
ЁЯСС => ЁЯСС, ркХрккркбрк╛ркВ
ЁЯСТ => ЁЯСТ, рк╣рлЗркЯ, ркХрккркбрк╛ркВ
ЁЯОй => ЁЯОй, рк╣рлЗркЯ, ркоркирлЛрк░ркЬрки
ЁЯОУ => ЁЯОУ, ркЯрлЛрккрлА, рк╕рлНркирк╛ркдркХ, ркЙркЬрк╡ркгрлА
ЁЯУ┐ => ЁЯУ┐, ркоркгркХрк╛ркВ, ркорк╛рк│рк╛, рккрлНрк░рк╛рк░рлНркеркирк╛, ркЬрк╛ркк, ркзрк░рлНрко, ркзрк╛рк░рлНркорк┐ркХ
ЁЯТД => ЁЯТД, ркорлЗркХркЕркк, ркХрлЛрк╕рлНркорлЗркЯрк┐ркХрлНрк╕
ЁЯТН => ЁЯТН, рк░рлЛркорк╛ркВрк╕
ЁЯТО => ЁЯТО, рк░ркдрлНрки рккркерлНркерк░, ркбрк╛ркпркоркВркб, рк░рлЛркорк╛ркВрк╕
ЁЯР╡ => ЁЯР╡, рк╡рк╛ркВркжрк░рлЛ, ркЪрк╣рлЗрк░рлЛ, рккрлНрк░рк╛ркгрлА
ЁЯРТ => ЁЯРТ, рккрлНрк░рк╛ркгрлА
ЁЯР╢ => ЁЯР╢, рк╢рлНрк╡рк╛рки, ркЪрк╣рлЗрк░рлЛ, рккрлНрк░рк╛ркгрлА
ЁЯРХ => ЁЯРХ, ркЧрк▓рлВркбрк┐ркпрлБркВ, рккрлНрк░рк╛ркгрлА
ЁЯРй => ЁЯРй, ркХрлБркдрк░рлЛ, рккрлНрк░рк╛ркгрлА
ЁЯР║ => ЁЯР║, рк╡рк░рлБ, ркЪрк╣рлЗрк░рлЛ, рккрлНрк░рк╛ркгрлА
ЁЯР▒ => ЁЯР▒, ркмрк┐рк▓рк╛ркбрлА, ркЪрк╣рлЗрк░рлЛ, рккрлНрк░рк╛ркгрлА
ЁЯРИ => ЁЯРИ, рккрлНрк░рк╛ркгрлА
ЁЯжБ => ЁЯжБ, рк╕рк┐ркВрк╣, рк░рк╛рк╢рк┐ ркЪрк┐рк╣рлНрки
ЁЯРп => ЁЯРп, рк╡рк╛ркШ, рккрлНрк░рк╛ркгрлА
ЁЯРЕ => ЁЯРЕ, рккрлНрк░рк╛ркгрлА
ЁЯРЖ => ЁЯРЖ, рккрлНрк░рк╛ркгрлА
ЁЯР┤ => ЁЯР┤, ркШрлЛркбрлЛ, ркЪрк╣рлЗрк░рлЛ, рккрлНрк░рк╛ркгрлА
ЁЯРО => ЁЯРО, рккрлНрк░рк╛ркгрлА
ЁЯжД => ЁЯжД, ркЪрк╣рлЗрк░рлЛ, ркпрлБркирк┐ркХрлЛрк░рлНрки, ркорлБркЦ, ркПркХ рк╢рк┐ркВркЧркбрк╛рк╡рк╛рк│рлЛ ркХрк╛рк▓рлНрккркирк┐ркХ ркШрлЛркбрлЛ
ЁЯРо => ЁЯРо, ркЧрк╛ркп, ркЪрк╣рлЗрк░рлЛ, рккрлНрк░рк╛ркгрлА
ЁЯРВ => ЁЯРВ, рккрлНрк░рк╛ркгрлА
ЁЯРГ => ЁЯРГ, рккрк╛ркгрлА, рккрлНрк░рк╛ркгрлА
ЁЯРД => ЁЯРД, рккрлНрк░рк╛ркгрлА
ЁЯР╖ => ЁЯР╖, ркбрлБркХрлНркХрк░, ркЪрк╣рлЗрк░рлЛ, рккрлНрк░рк╛ркгрлА
ЁЯРЦ => ЁЯРЦ, рккрлНрк░рк╛ркгрлА
ЁЯРЧ => ЁЯРЧ, рккрлНрк░рк╛ркгрлА
ЁЯР╜ => ЁЯР╜, ркирк╛ркХ, ркЪрк╣рлЗрк░рлЛ, рккрлНрк░рк╛ркгрлА
ЁЯРП => ЁЯРП, рккрлНрк░рк╛ркгрлА, ркорлЗрк╖ рк░рк╛рк╢рк┐ ркЪрк┐рк╣рлНрки
ЁЯРС => ЁЯРС, рккрлНрк░рк╛ркгрлА
ЁЯРР => ЁЯРР, рккрлНрк░рк╛ркгрлА, ркоркХрк░ рк░рк╛рк╢рк┐ ркЪрк┐рк╣рлНрки
ЁЯРк => ЁЯРк, ркПркХ ркЦрлВркВркзрк╡рк╛рк│рлБркВ ркКркВркЯ, ркЦрлВркВркз, ркбрлНрк░рлЛркорлЗркбрк░рлА, рккрлНрк░рк╛ркгрлА
ЁЯРл => ЁЯРл, ркЦрлВркВркз, ркКркВркЯ, ркмрлЗркХрлНркЯрлНрк░рк┐ркпрки, рккрлНрк░рк╛ркгрлА
ЁЯРШ => ЁЯРШ, рккрлНрк░рк╛ркгрлА
ЁЯРн => ЁЯРн, ркЙркВркжрк░, ркЪрк╣рлЗрк░рлЛ, рккрлНрк░рк╛ркгрлА
ЁЯРБ => ЁЯРБ, рккрлНрк░рк╛ркгрлА
ЁЯРА => ЁЯРА, рккрлНрк░рк╛ркгрлА
ЁЯР╣ => ЁЯР╣, рк╣рлЗркорлНрк╕рлНркЯрк░, ркЪрк╣рлЗрк░рлЛ, рккрлНрк░рк╛ркгрлА
ЁЯР░ => ЁЯР░, рк╕рк╕рк▓рлБркВ, ркЪрк╣рлЗрк░рлЛ, рккрлНрк░рк╛ркгрлА
ЁЯРЗ => ЁЯРЗ, рк╕рк╕рк▓рлБркВ, рккрлНрк░рк╛ркгрлА
ЁЯР┐ => ЁЯР┐, ркЪрк┐рккркоркВркХ
ЁЯР╗ => ЁЯР╗, рк░рлАркВркЫ, ркЪрк╣рлЗрк░рлЛ, рккрлНрк░рк╛ркгрлА
ЁЯРи => ЁЯРи, ркХрлЛркЖрк▓рк╛ рк░рлАркВркЫ, рккрлНрк░рк╛ркгрлА
ЁЯР╝ => ЁЯР╝, рккрк╛ркирлНркбрк╛, ркЪрк╣рлЗрк░рлЛ, рккрлНрк░рк╛ркгрлА
ЁЯР╛ => ЁЯР╛, рккркВркЬрлЛ, ркирк┐рк╢рк╛рки, рккрлНрк░рк╛ркгрлА
ЁЯжГ => ЁЯжГ, ркЯрк░рлНркХрлА
ЁЯРФ => ЁЯРФ, ркорк░ркШрлАркирлБркВ ркмркЪрлНркЪрлБркВ, рккрлНрк░рк╛ркгрлА
ЁЯРУ => ЁЯРУ, рккрлНрк░рк╛ркгрлА
ЁЯРг => ЁЯРг, рккркХрлНрк╖рлАркирлБркВ ркмркЪрлНркЪрлБркВ, рк╕рлЗрк╡рк╡рлБркВ, ркмркЪрлНркЪрлБркВ, ркорк░ркШрлАркирлБркВ ркмркЪрлНркЪрлБркВ, рккрлНрк░рк╛ркгрлА
ЁЯРд => ЁЯРд, рккркХрлНрк╖рлАркирлБркВ ркмркЪрлНркЪрлБркВ, ркмркЪрлНркЪрлБркВ, рккрлНрк░рк╛ркгрлА
ЁЯРе => ЁЯРе, рккркХрлНрк╖рлАркирлБркВ ркмркЪрлНркЪрлБркВ, ркЖркЧрк│ ркдрк░ркл ркЬрлЛркдрлБркВ рккркХрлНрк╖рлАркирлБркВ ркмркЪрлНркЪрлБркВ, ркмркЪрлНркЪрлБркВ, ркорк░ркШрлАркирлБркВ ркмркЪрлНркЪрлБркВ, рккрлНрк░рк╛ркгрлА
ЁЯРж => ЁЯРж, рккрлНрк░рк╛ркгрлА
ЁЯРз => ЁЯРз, рккрлНрк░рк╛ркгрлА
ЁЯХК => ЁЯХК, рккркХрлНрк╖рлА, рк╢рк╛ркВркдрк┐
ЁЯР╕ => ЁЯР╕, ркжрлЗркбркХрлЛ, ркЪрк╣рлЗрк░рлЛ, рккрлНрк░рк╛ркгрлА
ЁЯРК => ЁЯРК, рккрлНрк░рк╛ркгрлА
ЁЯРв => ЁЯРв, рккрлНрк░рк╛ркгрлА
ЁЯРН => ЁЯРН, рккрлНрк░рк╛ркгрлА
ЁЯР▓ => ЁЯР▓, ркжрлИркдрлНркп, ркЪрк╣рлЗрк░рлЛ, рккрлНрк░рк╛ркгрлА
ЁЯРЙ => ЁЯРЙ, рккрлНрк░рк╛ркгрлА
ЁЯР│ => ЁЯР│, рккрк╛ркгрлА ркЙркЫрк╛рк│рк╡рлБркВ, рк╡рлНрк╣рлЗрк▓, рккрлНрк░рк╛ркгрлА
ЁЯРЛ => ЁЯРЛ, рккрлНрк░рк╛ркгрлА
ЁЯРм => ЁЯРм, рккрлНрк░рк╛ркгрлА
ЁЯРЯ => ЁЯРЯ, рккрлНрк░рк╛ркгрлА
ЁЯРа => ЁЯРа, ркорк╛ркЫрк▓рлА, рккрлНрк░рк╛ркгрлА
ЁЯРб => ЁЯРб, ркмрлНрк▓рлЛрклрлАрк╢, ркорк╛ркЫрк▓рлА, рккрлНрк░рк╛ркгрлА
ЁЯРЩ => ЁЯРЩ, рккрлНрк░рк╛ркгрлА
ЁЯРЪ => ЁЯРЪ, рк╢рлЗрк▓, рккрлНрк░рк╛ркгрлА
ЁЯжА => ЁЯжА, ркХрк░рлНркХ, рк░рк╛рк╢рк┐
ЁЯРМ => ЁЯРМ, рккрлНрк░рк╛ркгрлА
ЁЯРЫ => ЁЯРЫ, ркХрк╛ркиркЦркЬрлВрк░рлЛ, ркЗркпрк│, рккрлНрк░рк╛ркгрлА
ЁЯРЬ => ЁЯРЬ, рккрлНрк░рк╛ркгрлА
ЁЯРЭ => ЁЯРЭ, ркоркзрлБркоркХрлНрк╖рк┐ркХрк╛, рккрлНрк░рк╛ркгрлА
ЁЯРЮ => ЁЯРЮ, ркорк╛ркжрк╛ ркорк╛ркВркХркб, ркорк╛ркжрк╛, ркнркорк░рлЛ, рккрлНрк░рк╛ркгрлА
ЁЯХ╖ => ЁЯХ╖, ркЬркВркдрлБ
ЁЯХ╕ => ЁЯХ╕, ркХрк░рлЛрк│рк┐ркпрлЛ, ркЬрк╛рк│рлБркВ
ЁЯжВ => ЁЯжВ, рк╕рлНркХрлЛрк░рлНрккрк┐ркпрлЛ, рк░рк╛рк╢рк┐
ЁЯТР => ЁЯТР, рккрлБрк╖рлНркк, рк░рлЛркорк╛ркВрк╕
ЁЯМ╕ => ЁЯМ╕, ркЪрлЗрк░рлА рккрлБрк╖рлНркк, ркЪрлЗрк░рлА, рккрлБрк╖рлНркк ркЬрлЛрк╡рлБркВ, рккрлБрк╖рлНркк
ЁЯТо => ЁЯТо, рклрлВрк▓ркирлЛ рк╕рк┐ркХрлНркХрлЛ, рк╕рк░рк╕ ркХрк░рлНркпрлБркВркирлЛ рк╕рк┐ркХрлНркХрлЛ, рклрлВрк▓, рк╕рк┐ркХрлНркХрлЛ
ЁЯП╡ => ЁЯП╡, ркЫрлЛркб
ЁЯМ╣ => ЁЯМ╣, рклрлВрк▓
ЁЯМ║ => ЁЯМ║, рклрлВрк▓
ЁЯМ╗ => ЁЯМ╗, рклрлВрк▓
ЁЯМ╝ => ЁЯМ╝, рккрлБрк╖рлНркк
ЁЯМ╖ => ЁЯМ╖, рклрлВрк▓
тШШ => тШШ, ркЫрлЛркб, ркдрлНрк░ркг рккрк░рлНркг
ЁЯМ▒ => ЁЯМ▒, ркирк╛ркирлЛ, ркмрлАркЬ
ЁЯМ▓ => ЁЯМ▓, рк╕ркжрк╛ркмрк╣рк╛рк░, рк╡рлГркХрлНрк╖
ЁЯМ│ => ЁЯМ│, рккрк░рлНркг ркЦрк░рк╡рк╛, ркЦрк░рк╛ркЙ, рк╡рлГркХрлНрк╖
ЁЯМ┤ => ЁЯМ┤, ркдрк╛ркб, рк╡рлГркХрлНрк╖
ЁЯМ╡ => ЁЯМ╡, ркЫрлЛркб
ЁЯМ╛ => ЁЯМ╛, ркбрлВркВркбрлБ, ркЪрлЛркЦрк╛
ЁЯМ┐ => ЁЯМ┐, рккрк░рлНркг
ЁЯНА => ЁЯНА, ркЪрк╛рк░, рккрк░рлНркг, ркдрлНрк░рк┐ркжрк▓, ркирк╕рлАркмркжрк╛рк░
ЁЯНБ => ЁЯНБ, ркЦрк░рлА рккркбрлЗрк▓рлБркВ рккрк░рлНркг, рккрк░рлНркг
ЁЯНВ => ЁЯНВ, ркЦрк░рлЗрк▓рлА рккрк╛ркВркжркбрлАркУ, ркЦрк░ркдрлА, ркЦрк░рлЗрк▓рлА, рккрк╛ркВркжркбрлА, рккрк╛ркВркжркбрлАркУ
ЁЯНГ => ЁЯНГ, рклрлВркВркХрк╛ркдрлЛ рккрк╡рки, рккрк░рлНркг, рккрк╡рки, рклрлВркВркХрк╛рк╡рлБркВ
ЁЯНЗ => ЁЯНЗ, рклрк│
ЁЯНИ => ЁЯНИ, ркдрк░ркмрлВркЪ, рклрк│
ЁЯНЙ => ЁЯНЙ, рклрк│
ЁЯНК => ЁЯНК, ркирк╛рк░ркВркЧрлА, рклрк│
ЁЯНЛ => ЁЯНЛ, ркЦрк╛ркЯрлБркВ, рклрк│
ЁЯНМ => ЁЯНМ, рклрк│
ЁЯНН => ЁЯНН, рклрк│
ЁЯНО => ЁЯНО, рк╕рклрк░ркЬрки, рк▓рк╛рк▓, рклрк│
ЁЯНП => ЁЯНП, рк╕рклрк░ркЬрки, рк▓рлАрк▓рлБркВ, рклрк│
ЁЯНР => ЁЯНР, рклрк│
ЁЯНС => ЁЯНС, рклрк│
ЁЯНТ => ЁЯНТ, ркЪрлЗрк░рлА рклрк│
ЁЯНУ => ЁЯНУ, ркмрлЗрк░рлА, рклрк│
ЁЯНЕ => ЁЯНЕ, рк╢рк╛ркХ
ЁЯНЖ => ЁЯНЖ, рк╡рлЗркВркЧркг, рк░рлАркВркЧркг, рк╢рк╛ркХ
ЁЯМ╜ => ЁЯМ╜, ркбрлЛркбрлЛ
ЁЯМ╢ => ЁЯМ╢, ркдрлАркЦрлБркВ, ркорк░ркЪрлБркВ, ркЫрлЛркб
ЁЯНД => ЁЯНД, ркЭрк╛ркб
ЁЯМ░ => ЁЯМ░, ркЭрк╛ркб, ркмркжрк╛рко
ЁЯНЮ => ЁЯНЮ, ркмрлНрк░рлЗркбркирлЛ рк░рлЛркЯрк▓рлЛ, рк░рлЗрк╕рлНркЯрлЛрк░ркирлНркЯ
ЁЯзА => ЁЯзА, ркЪрлАркЭ, ркЯрлБркХркбрлЛ
ЁЯНЦ => ЁЯНЦ, ркорк╛ркВрк╕, рк░рлЗрк╕рлНркЯрлЛрк░ркирлНркЯ
ЁЯНЧ => ЁЯНЧ, рккрлЛрк▓рлНркЯрлНрк░рлА, ркЯркВркЧркбрлА, рк░рлЗрк╕рлНркЯрлЛрк░ркирлНркЯ
ЁЯНФ => ЁЯНФ, ркмрк░рлНркЧрк░, рк░рлЗрк╕рлНркЯрлЛрк░ркирлНркЯ
ЁЯНЯ => ЁЯНЯ, рклрлНрк░рк╛ркЗрк╕, рк░рлЗрк╕рлНркЯрлЛрк░ркирлНркЯ
ЁЯНХ => ЁЯНХ, рккрк┐ркЭрк╛ рк╕рлНрк▓рк╛ркЗрк╕, рк╕рлНрк▓рк╛ркЗрк╕, рк░рлЗрк╕рлНркЯрлЛрк░ркирлНркЯ
ЁЯМн => ЁЯМн, рклрлНрк░рлЗркВркХрклрк░рлНркЯрк░, рк╕рлЛрк╕рлЗркЬ
ЁЯМо => ЁЯМо, ркорлЗркХрлНрк╕рк┐ркХрки рк╡рк╛ркиркЧрлА, ркорлЗркХрлНрк╕рк┐ркХрки
ЁЯМп => ЁЯМп, ркорлЗркХрлНрк╕рк┐ркХрки рк╡рк╛ркиркЧрлА, ркорлЗркХрлНрк╕рк┐ркХрки
ЁЯН┐ => ЁЯН┐, ркоркХрк╛ркИркирк╛ рк╢рлЗркХрлЗрк▓рк╛ ркжрк╛ркгрк╛
ЁЯН▓ => ЁЯН▓, рк╕рлНркЯрлНркпрлВ, рк╡рк╛рк╕ркгркорк╛ркВркирлЛ ркЦрлЛрк░рк╛ркХ, рк░рлЗрк╕рлНркЯрлЛрк░ркирлНркЯ
ЁЯН▒ => ЁЯН▒, ркмрлЗркирлНркЯрлЛ, ркмрлЛркХрлНрк╕, рк░рлЗрк╕рлНркЯрлЛрк░ркирлНркЯ
ЁЯНШ => ЁЯНШ, ркЪрлЛркЦрк╛ркирлА┬аркХркХрк░рлА ркмрк┐рк╕рлНркХрлАркЯ, ркЪрлЛркЦрк╛
ЁЯНЩ => ЁЯНЩ, ркУркирк┐ркЧрк┐рк░рлА, рк░рлЗрк╕рлНркЯрлЛрк░ркирлНркЯ
ЁЯНЪ => ЁЯНЪ, ркЪрлЛркЦрк╛, рк░рлЗрк╕рлНркЯрлЛрк░рлЗркирлНркЯ
ЁЯНЫ => ЁЯНЫ, ркХркврлА, ркнрк╛ркд, рк░рлЗрк╕рлНркЯрлЛрк░рлЗркирлНркЯ
ЁЯНЬ => ЁЯНЬ, рк░ркорлЗрки, ркирлБркбрк▓рлНрк╕ркирлЛ рк╡рк╛ркЯркХрлЛ, ркирлБркбрк▓, рк╡рк░рк╛рк│ ркирлАркХрк│ркдрк╛ркВ, рк╡рк╛ркЯркХрлЛ, ркирлБркбрк▓рлНрк╕, рк░рлЗрк╕рлНркЯрлЛрк░ркирлНркЯ
ЁЯНЭ => ЁЯНЭ, рккрк╛рк╕рлНркдрк╛, рк░рлЗрк╕рлНркЯрлЛрк░ркирлНркЯ
ЁЯНа => ЁЯНа, рк╢рлЗркХрлЗрк▓рк╛ркВ ркмркЯрк╛ркХрк╛, рк╢ркХрлНркХрк░рк┐ркпрлБркВ, ркЧрк│рлНркпрлБркВ, рк╢рлЗркХрлЗрк▓рлБркВ, рк░рлЗрк╕рлНркЯрлЛрк░ркирлНркЯ
ЁЯНв => ЁЯНв, рк╕рлНркЯрлАркХ рккрк░ рк╕рлА рклрлВркб, рк╕рлА рклрлВркб, рк╕рлНркЯрлАркХ, рк░рлЗрк╕рлНркЯрлЛрк░ркирлНркЯ
ЁЯНг => ЁЯНг, рк░рлЗрк╕рлНркЯрлЛрк░ркирлНркЯ
ЁЯНд => ЁЯНд, ркЭрлАркВркЧрк╛, рк░рлЗрк╕рлНркЯрлЛрк░ркирлНркЯ
ЁЯНе => ЁЯНе, рклрлАрк╢ ркХрлЗркХ, рк╡ркорк│рк╡рк╛рк│рлА рклрлАрк╢ ркХрлЗркХ, ркорк╛ркЫрк▓рлА, рк░рлЗрк╕рлНркЯрлЛрк░ркирлНркЯ
ЁЯНб => ЁЯНб, ркорлЛркЪрлА, ркорлЛркЪрлА ркмрлЛрк▓рлНрк╕, рк▓рк╛ркХркбрлА рккрк░ ркорлЛркЪрлА ркмрлЛрк▓рлНрк╕, рк░рлЗрк╕рлНркЯрлЛрк░ркирлНркЯ
ЁЯНж => ЁЯНж, ркЖркЗрк╕ ркХрлНрк░рлАрко, рк╕рлЛрклрлНркЯ рк╕рк░рлНрк╡, ркХрлНрк░рлАрко, рк░рлЗрк╕рлНркЯрлЛрк░ркирлНркЯ
ЁЯНз => ЁЯНз, ркЖркЗрк╕, рк╢рлЗрк╡рлНркб, рк░рлЗрк╕рлНркЯрлЛрк░ркирлНркЯ
ЁЯНи => ЁЯНи, ркЖркЗрк╕, ркХрлНрк░рлАрко, рк░рлЗрк╕рлНркЯрлЛрк░ркирлНркЯ
ЁЯНй => ЁЯНй, ркорлАркарк╛ркИ, рк░рлЗрк╕рлНркЯрлЛрк░ркирлНркЯ
ЁЯНк => ЁЯНк, рк░рлЗрк╕рлНркЯрлЛрк░ркирлНркЯ
ЁЯОВ => ЁЯОВ, ркЬркирлНркоркжрк┐рк╡рк╕ ркХрлЗркХ, ркЬркирлНркоркжрк┐рк╡рк╕, ркХрлЗркХ, ркЙркЬрк╡ркгрлА
ЁЯН░ => ЁЯН░, ркХрк╛рккрлЗрк▓рлА ркХрлЗркХ, ркХрлЗркХ, рк░рлЗрк╕рлНркЯрлЛрк░ркирлНркЯ
ЁЯНл => ЁЯНл, ркЪрлЛркХрк▓рлЗркЯ, ркмрк╛рк░, рк░рлЗрк╕рлНркЯрлЛрк░ркирлНркЯ
ЁЯНм => ЁЯНм, рк░рлЗрк╕рлНркЯрлЛрк░ркирлНркЯ
ЁЯНн => ЁЯНн, ркХрлЗркирлНркбрлА, рк░рлЗрк╕рлНркЯрлЛрк░ркирлНркЯ
ЁЯНо => ЁЯНо, рккрлБркбрк┐ркВркЧ, рк░рлЗрк╕рлНркЯрлЛрк░ркирлНркЯ
ЁЯНп => ЁЯНп, ркоркз, рк╡рк╛рк╕ркг, рк░рлЗрк╕рлНркЯрлЛрк░ркирлНркЯ
ЁЯН╝ => ЁЯН╝, рк╢рк┐рк╢рлБ ркмрлЛркЯрк▓, ркжрлВркз, ркмрлЛркЯрк▓, рккрлАркгрлБркВ
тШХ => тШХ, ркХрлЙрклрлА, рккрлЗркп, ркЧрк░рко, ркЙркХрк│ркдрлБркВ, ркЪрк╛
ЁЯН╡ => ЁЯН╡, ркЪрк╛ ркорк╛ркЯрлЗркирлЛ ркХркк, ркЪрк╛ркирлЛ ркХркк, ркЪрк╛, рккрлАркгрлБркВ
ЁЯН╢ => ЁЯН╢, ркЪрлЛркЦрк╛ркирлЛ ркжрк╛рк░рлВ, ркЪрлЛркЦрк╛ркирк╛ркВ ркжрк╛рк░рлБркирлА ркмрлЛркЯрк▓ ркЕркирлЗ ркХркк, ркХркк, ркмрлЛркЯрк▓, рккрлАркгрлБркВ, рк░рлЗрк╕рлНркЯрлЛрк░ркирлНркЯ, ркмрк╛рк░
ЁЯН╛ => ЁЯН╛, ркмрк╛рк░, ркмрк╛ркЯрк▓рлА, ркХрлЙрк░рлНркХ, ркЦрлБрк▓ркдрлА, ркбрлНрк░рк┐ркВркХ
ЁЯН╖ => ЁЯН╖, рк╡рк╛ркЗрки, рк╡рк╛ркЗрки ркорк╛ркЯрлЗркирлЛ ркЧрлНрк▓рк╛рк╕, ркЧрлНрк▓рк╛рк╕, рккрлАркгрлБркВ, рк░рлЗрк╕рлНркЯрлЛрк░ркирлНркЯ, ркмрк╛рк░
ЁЯН╕ => ЁЯН╕, ркХрлЛркХркЯрлЗркЗрк▓, рк░рлЗрк╕рлНркЯрлЛрк░ркирлНркЯ, ркмрк╛рк░
ЁЯН╣ => ЁЯН╣, ркЙрк╖рлНркгркХркЯрк┐ркмркВркзрлАркп, рккрлАркгрлБркВ, рк░рлЗрк╕рлНркЯрлЛрк░ркирлНркЯ, ркмрк╛рк░
ЁЯН║ => ЁЯН║, ркмрлАркЕрк░, ркоркЧ, рк░рлЗрк╕рлНркЯрлЛрк░ркирлНркЯ, ркмрк╛рк░
ЁЯН╗ => ЁЯН╗, ркмрлАркЕрк░ ркоркЧ, ркмрлАркЕрк░, ркоркЧрлНрк╕, ркоркЧ, рк░рлЗрк╕рлНркЯрлЛрк░ркирлНркЯ, ркмрк╛рк░
ЁЯН╜ => ЁЯН╜, рк░рк╕рлЛркИ, ркХрк╛ркВркЯрлНркк, ркЫрк░рлА, рккрлНрк▓рлЗркЯ, ркерк╛рк│рлА
ЁЯН┤ => ЁЯН┤, ркХрк╛ркВркЯрлЛ, ркЫрк░рлА, рк░рлЗрк╕рлНркЯрлЛрк░ркирлНркЯ
ЁЯН│ => ЁЯН│, ркХркбрк╛ркИ, рк░рлЗрк╕рлНркЯрлЛрк░ркирлНркЯ
ЁЯП║ => ЁЯП║, ркХрлБркВркн, рк░рк╕рлЛркИ, ркбрлНрк░рк┐ркВркХ, рккрлАркгрлБркВ, ркЬркЧ, рк╣ркерк┐ркпрк╛рк░, рк░рк╛рк╢рк┐
ЁЯМН => ЁЯМН, ркЧрлНрк▓рлЛркм, рккрлГркерлНрк╡рлА, ркпрлБрк░рлЛркк, ркЖрклрлНрк░рк┐ркХрк╛
ЁЯМО => ЁЯМО, ркЧрлНрк▓рлЛркм, рккрлГркерлНрк╡рлА, ркЕркорлЗрк░рк┐ркХрк╛
ЁЯМП => ЁЯМП, ркЧрлНрк▓рлЛркм, рккрлГркерлНрк╡рлА, ркПрк╢рк┐ркпрк╛, ркУрк╕рлНркЯрлНрк░рлЗрк▓рк┐ркпрк╛
ЁЯМР => ЁЯМР, ркЧрлНрк▓рлЛркм, ркпрк╛ркорлНркпрлЛркдрлНркдрк░ рк╡рлГркдрлНркд
ЁЯЧ║ => ЁЯЧ║, ркиркХрк╢рлЛ, рк╡рк┐рк╢рлНрк╡
ЁЯПФ => ЁЯПФ, ркмрк░ркл, рккрк╣рк╛ркб, рк╣рк┐рко
тЫ░ => тЫ░, рккрк╣рк╛ркб
ЁЯМЛ => ЁЯМЛ, ркЬрлНрк╡рк╛рк│рк╛ркорлБркЦрлА рк╡рк┐рк╕рлНрклрлЛркЯ
ЁЯЧ╗ => ЁЯЧ╗, ркорк╛. рклрлБркЬрлА, рккрк░рлНрк╡ркд
ЁЯПХ => ЁЯПХ, ркдркВркмрлБ рк▓ркЧрк╛рк╡рк╡рлЛ
ЁЯПЦ => ЁЯПЦ, ркЫркдрлНрк░рлА
ЁЯПЬ => ЁЯПЬ, рк░ркгрккрлНрк░ркжрлЗрк╢
ЁЯПЭ => ЁЯПЭ, ркжрлНрк╡рк┐ркк, ркЖркЗрк▓рлЗркирлНркб
ЁЯПЮ => ЁЯПЮ, рккрк╛рк░рлНркХ, ркмркЧрлАркЪрлЛ
ЁЯПЯ => ЁЯПЯ, рк╕рлНркЯрлЗркбрк┐ркпрко
ЁЯПЫ => ЁЯПЫ, ркЬрлВркирлА, ркИркорк╛рк░ркд
ЁЯПЧ => ЁЯПЧ, ркирк┐рк░рлНркорк╛ркг, ркИркорк╛рк░ркд, ркмрк┐рк▓рлНркбрк┐ркВркЧ
ЁЯПШ => ЁЯПШ, ркШрк░, ркИркорк╛рк░ркд, ркмрк┐рк▓рлНркбрк┐ркВркЧ
ЁЯПЩ => ЁЯПЩ, рк╢рк╣рлЗрк░
ЁЯПЪ => ЁЯПЪ, рк╡рлЗрк░рк╛рки, ркШрк░
ЁЯПа => ЁЯПа, ркШрк░, ркИркорк╛рк░ркд, ркЧрлГрк╣, ркмрк┐рк▓рлНркбрк┐ркВркЧ
ЁЯПб => ЁЯПб, ркШрк░, ркЧрлГрк╣, ркмрк╛ркЧ, ркИркорк╛рк░ркд
тЫк => тЫк, ркнрк╡рки
ЁЯХЛ => ЁЯХЛ, ркЗрк╕рлНрк▓рк╛рко, ркорлБрк╕рлНрк▓рк┐рко, ркзрк░рлНрко
ЁЯХМ => ЁЯХМ, ркЗрк╕рлНрк▓рк╛рко, ркорлБрк╕рлНрк▓рк┐рко, ркзрк░рлНрко
ЁЯХН => ЁЯХН, ркзрк░рлНрко, ркоркВркжрк┐рк░
тЫй => тЫй, ркзрк░рлНрко, ркЬрк╛рккрк╛ркирлА ркзрк░рлНркорк╕рлНркерк│
ЁЯПв => ЁЯПв, ркХрк╛рк░рлНркпрк╛рк▓ркп, ркИркорк╛рк░ркд
ЁЯПг => ЁЯПг, рккрлЛрк╕рлНркЯ ркСрклрк┐рк╕, ркЬрк╛рккрк╛ркирлА, рккрлЛрк╕рлНркЯ, ркИркорк╛рк░ркд
ЁЯПд => ЁЯПд, ркпрлБрк░рлЛрккрк┐ркпрки рккрлЛрк╕рлНркЯ ркСрклрк┐рк╕, ркЬрк╛рккрк╛ркирлА, рккрлЛрк╕рлНркЯ, ркИркорк╛рк░ркд
ЁЯПе => ЁЯПе, ркИркорк╛рк░ркд
ЁЯПж => ЁЯПж, ркИркорк╛рк░ркд
ЁЯПи => ЁЯПи, ркИркорк╛рк░ркд
ЁЯПй => ЁЯПй, рккрлНрк░рлЗрко, рк╣рлЛркЯрк▓, ркИркорк╛рк░ркд
ЁЯПк => ЁЯПк, рк╕рлБрк╡рк┐ркзрк╛, рк╕рлНркЯрлЛрк░, ркИркорк╛рк░ркд
ЁЯПл => ЁЯПл, рк╢рк╛рк│рк╛ркирлА ркИркорк╛рк░ркд, ркИркорк╛рк░ркд
ЁЯПм => ЁЯПм, ркбрлАрккрк╛рк░рлНркЯркорлЗркирлНркЯ, рк╕рлНркЯрлЛрк░
ЁЯПн => ЁЯПн, ркИркорк╛рк░ркд
ЁЯПп => ЁЯПп, ркХрк┐рк▓рлНрк▓рлЛ, ркИркорк╛рк░ркд
ЁЯП░ => ЁЯП░, ркЬрк╛рккрк╛ркирлА ркХрк┐рк▓рлНрк▓рлЛ, ркИркорк╛рк░ркд
ЁЯТТ => ЁЯТТ, рк▓ркЧрлНрки ркорк╛ркЯрлЗркирлА ркжрлЗрк╡ркХрлБрк▓рк┐ркХрк╛, ркжрлЗрк╡ркХрлБрк▓рк┐ркХрк╛, рк░рлЛркорк╛ркВрк╕
ЁЯЧ╝ => ЁЯЧ╝, ркЯрлЛркХрлНркпрлЛ, ркЯрк╛рк╡рк░
ЁЯЧ╜ => ЁЯЧ╜, рккрлНрк░ркдрк┐ркорк╛, рк╕рлНрк╡ркдркВркдрлНрк░ркдрк╛
ЁЯЧ╛ => ЁЯЧ╛, ркиркХрк╢рлЛ, ркЬрк╛рккрк╛рки
тЫ▓ => тЫ▓, рклрлБрк╡рк╛рк░рлЛ
тЫ║ => тЫ║, ркХрлЗркорлНрккрк┐ркВркЧ
ЁЯМБ => ЁЯМБ, ркзрлБркорлНркорк╕
ЁЯМГ => ЁЯМГ, рк░рк╛ркдркирк╛ ркдрк╛рк░рк╛, ркдрк╛рк░рк╛, рк░рк╛ркд
ЁЯМД => ЁЯМД, рк╕рлВрк░рлНркпрлЛркжркп, рк╕рк╡рк╛рк░ркирлЛ рк╕рлВрк░рлНркп, рккрк░рлНрк╡ркд
ЁЯМЕ => ЁЯМЕ, рк╕рк╡рк╛рк░ркирлЛ рк╕рлВрк░рлНркп
ЁЯМЖ => ЁЯМЖ, рк╕ркорлАрк╕рк╛ркВркЬ, рк╕рк╛ркВркЬ, рк╕рлВрк░рлНркпрк╛рк╕рлНркд, рк╢рк╣рлЗрк░, ркоркХрк╛рки, рк▓рлЗркирлНркбрк╕рлНркХрлЗркк
ЁЯМЗ => ЁЯМЗ, рк╕ркорлАрк╕рк╛ркВркЬ, ркИркорк╛рк░ркдрлЛ рккрк░ рк╕рлВрк░рлНркпрк╛рк╕рлНркд, ркИркорк╛рк░ркд
ЁЯМЙ => ЁЯМЙ, ркирк╛ркЗркЯ ркмрлНрк░рк┐ркЬ, рк░рк╛ркдрлНрк░рлЗ рккрлБрк▓, рк░рк╛ркд
тЩи => тЩи, ркЧрк░рко, ркЭрк░рк╛, ркЙркХрк│ркдрк╛ркВ, рк╡рк░рк╛рк│ ркирлАркХрк│ркдрк╛ркВ
ЁЯММ => ЁЯММ, ркжрлВркзрк┐ркпрлБркВ
ЁЯОа => ЁЯОа, ркЪркХркбрлЛрк│, ркШрлЛркбрлЛ, ркоркирлЛрк░ркВркЬрки
ЁЯОб => ЁЯОб, ркЪркЧркбрлЛрк│, рклрлЗрк░рлАрк╕, рккрлИркбрлБркВ, ркПркорлНркпрлБркЭркорлЗркирлНркЯ рккрк╛рк░рлНркХ, ркоркирлЛрк░ркВркЬрки
ЁЯОв => ЁЯОв, рк░рлЛрк▓рк░, ркХрлЛрк╕рлНркЯрк░, ркПркорлНркпрлБркЭркорлЗркирлНркЯ рккрк╛рк░рлНркХ, ркоркирлЛрк░ркВркЬрки
ЁЯТИ => ЁЯТИ, рк╡рк╛рк│ркВркжркирлЛ ркерк╛ркВркнрк▓рлЛ, рк╡рк╛рк│ркВркж, ркерк╛ркВркнрк▓рлЛ
ЁЯОк => ЁЯОк, рк╕рк░рлНркХрк╕, рк╕рк░рлНркХрк╕ ркдркВркмрлБ, ркдркВркмрлБ, ркоркирлЛрк░ркВркЬрки
ЁЯОн => ЁЯОн, рк▓рк▓рк┐ркд ркХрк│рк╛, ркХрк│рк╛, ркоркирлЛрк░ркВркЬрки, рк▓рк▓рк┐ркд
ЁЯЦ╝ => ЁЯЦ╝, ркХрк▓рк╛, рклрлНрк░рлЗрко, рк╕ркВркЧрлНрк░рк╣рк╛рк▓ркп, ркЪрк┐ркдрлНрк░, ркХрк▓рк╛ркХрлГркдрк┐
ЁЯОи => ЁЯОи, рккрлЗркЗркирлНркЯ рккрлЗрк▓рлЗркЯ, рккрлЗрк▓рлЗркЯ, ркЖрк░рлНркЯрк┐рк╕рлНркЯ, рккрлЗркИркирлНркЯ, ркХрк│рк╛
ЁЯО░ => ЁЯО░, рк╕рлНрк▓рлЛркЯ, рк░ркоркд
ЁЯЪВ => ЁЯЪВ, ркПркирлНркЬрк┐рки, ркЯрлНрк░рлЗрки, рк╡рк╛рк╣рки
ЁЯЪГ => ЁЯЪГ, ркЯрлНрк░рлЗрки, ркЗрк▓рлЗркХрлНркЯрлНрк░рк┐ркХ ркЯрлНрк░рлЗрки, ркЗрк▓рлЗркХрлНркЯрлНрк░рк┐ркХ, рк░рлЗрк▓рлНрк╡рлЗ, ркЯрлНрк░рк╛рко, рк╡рк╛рк╣рки
ЁЯЪД => ЁЯЪД, рк╣рк╛ркЗ-рк╕рлНрккрлАркб ркЯрлНрк░рлЗрки, рк╢рк┐ркВркХркирк╕рлЗрки, ркЯрлНрк░рлЗрки, рк╡рк╛рк╣рки
ЁЯЪЕ => ЁЯЪЕ, рк╣рк╛ркЗ-рк╕рлНрккрлАркб ркЯрлНрк░рлЗрки, ркмрлБрк▓рлЗркЯ ркирлЛркЭ, ркмрлБрк▓рлЗркЯ ркирлЛркЭ рк╕рк╛ркерлЗркирлБркВ рк╢рк┐ркВркХркирк╕рлЗрки, рк╢рк┐ркВркХркирк╕рлЗрки, ркЯрлНрк░рлЗрки, рк╡рк╛рк╣рки
ЁЯЪЖ => ЁЯЪЖ, рк░рлЗрк▓рлНрк╡рлЗ, рк╡рк╛рк╣рки
ЁЯЪЗ => ЁЯЪЗ, ркорлЗркЯрлНрк░рлЛ, рк╡рк╛рк╣рки
ЁЯЪИ => ЁЯЪИ, рк▓рк╛ркЗркЯ, рк░рлЗрк▓, рк╡рк╛рк╣рки
ЁЯЪЙ => ЁЯЪЙ, ркЯрлНрк░рлЗрки, рк╕рлНркЯрлЗрк╢рки
ЁЯЪК => ЁЯЪК, рк╡рк╛рк╣рки
ЁЯЪЭ => ЁЯЪЭ, рк╡рк╛рк╣рки
ЁЯЪЮ => ЁЯЪЮ, рккрк░рлНрк╡ркдрлЛркирлА ркХрлЕркмрк▓ ркХрк╛рк░, рккрк░рлНрк╡ркд, рк░рлЗрк▓рлНрк╡рлЗ, ркХрк╛рк░, рк╡рк╛рк╣рки
ЁЯЪЛ => ЁЯЪЛ, ркЯрлНрк░рк╛рко, ркХрк╛рк░, рк╡рк╛рк╣рки
ЁЯЪМ => ЁЯЪМ, рк╡рк╛рк╣рки
ЁЯЪН => ЁЯЪН, ркЖрк╡ркирк╛рк░рлА ркмрк╕, ркмрк╕, ркЖрк╡ркирк╛рк░рлА, рк╡рк╛рк╣рки
ЁЯЪО => ЁЯЪО, ркмрк╕, ркЯрлНрк░рлЛрк▓рлА, рк╡рк╛рк╣рки
ЁЯЪП => ЁЯЪП, рк╕рлНркЯрлЛркк, ркмрк╕
ЁЯЪР => ЁЯЪР, ркмрк╕, рк╡рк╛рк╣рки
ЁЯЪС => ЁЯЪС, рк╡рк╛рк╣рки
ЁЯЪТ => ЁЯЪТ, рклрк╛ркпрк░ ркЯрлНрк░ркХ, рклрк╛ркпрк░, ркПркирлНркЬрк┐рки, рк╡рк╛рк╣рки
ЁЯЪУ => ЁЯЪУ, рккрлЛрк▓рлАрк╕ ркХрк╛рк░, рккрлЗркЯрлНрк░рлЛрк▓ ркХрк╛рк░, рккрлЛрк▓рлАрк╕, рк╡рк╛рк╣рки
ЁЯЪФ => ЁЯЪФ, ркЖрк╡ркирк╛рк░рлА рккрлЛрк▓рлАрк╕ ркХрк╛рк░, рккрлЛрк▓рлАрк╕ ркХрк╛рк░, рккрлЛрк▓рлАрк╕, рк╡рк╛рк╣рки
ЁЯЪХ => ЁЯЪХ, рк╡рк╛рк╣рки
ЁЯЪЦ => ЁЯЪЦ, ркЖрк╡ркирк╛рк░рлА ркЯрлЕркХрлНрк╕рлА, ркЯрлЕркХрлНрк╕рлА, рк╡рк╛рк╣рки
ЁЯЪЧ => ЁЯЪЧ, ркХрк╛рк░, рк╡рк╛рк╣рки
ЁЯЪШ => ЁЯЪШ, ркЖрк╡ркирк╛рк░рлА ркХрк╛рк░, ркЖрк╡ркирк╛рк░ ркСркЯрлЛркорлЛркмрк╛ркЗрк▓, ркХрк╛рк░, ркСркЯрлЛркорлЛркмрк╛ркЗрк▓, ркЖрк╡ркирк╛рк░, рк╡рк╛рк╣рки
ЁЯЪЩ => ЁЯЪЩ, RV, ркХрк╛рк░, рк╡рк╛рк╣рки
ЁЯЪЪ => ЁЯЪЪ, ркЯрлНрк░ркХ, рк╡рк╛рк╣рки
ЁЯЪЫ => ЁЯЪЫ, рк╕рлЗркорлА, ркХрк▓рк╛ркдрлНркоркХ ркЦркЯрк╛рк░рлЛ, ркЯрлНрк░ркХ, ркЯрлНрк░рлЗрк▓рк░, рк╡рк╛рк╣рки
ЁЯЪЬ => ЁЯЪЬ, рк╡рк╛рк╣рки
ЁЯЪ▓ => ЁЯЪ▓, ркмрк╛ркЗркХ, рк╕рк╛ркЗркХрк▓, рк╡рк╛рк╣рки
тЫ╜ => тЫ╜, ркЧрлЗрк╕ рк╕рлНркЯрлЗрк╢рки, рклрлНркпрлБркЕрк▓, ркЧрлЗрк╕, рк╕рлНркЯрлЗрк╢рки
ЁЯЫг => ЁЯЫг, рк╣рк╛ркЗрк╡рлЗ, ркзрлЛрк░рлАркорк╛рк░рлНркЧ, рк░рлЛркб, ркорк╛рк░рлНркЧ, рк░рк╕рлНркдрлЛ
ЁЯЫд => ЁЯЫд, рк░рлЗрк▓рк╡рлЗ, ркЯрлНрк░рлЗрки
ЁЯЪи => ЁЯЪи, рклрк░ркдрлА рк▓рк╛ркЗркЯ, рккрлЛрк▓рлАрк╕ рк▓рк╛ркЗркЯ, рккрлЛрк▓рлАрк╕ ркмрлАркХрки, рккрлЛрк▓рлАрк╕ ркХрк╛рк░
ЁЯЪе => ЁЯЪе, ркЯрлНрк░рк╛рклрк┐ркХ рк▓рк╛ркЗркЯрлНрк╕, ркЯрлНрк░рк╛рклрк┐ркХ рк╕рк┐ркЧрлНркирк▓рлНрк╕, рк▓рк╛ркЗркЯ, ркЯрлНрк░рк╛рклрк┐ркХ
ЁЯЪж => ЁЯЪж, ркЯрлНрк░рк╛рклрк┐ркХ рк▓рк╛ркЗркЯрлНрк╕, ркЯрлНрк░рк╛рклрк┐ркХ рк╕рк┐ркЧрлНркирк▓рлНрк╕, рк▓рк╛ркЗркЯ, ркЯрлНрк░рк╛рклрк┐ркХ
ЁЯЪз => ЁЯЪз, ркмрк╛ркВркзркХрк╛рко рк╣рлЗркарк│ ркЫрлЗ, ркмрк╛ркВркзркХрк╛ркоркирлБркВ ркЪрк┐рк╣рлНрки, ркЪрк┐рк╣рлНрки
тЪУ => тЪУ, ркЪрк┐рк╣рлНрки
тЫ╡ => тЫ╡, рк╣рлЛркбрлА, ркпрк╛ркЪ, рк╕ркорлБркжрлНрк░рлА рк░рк┐рк╕рлЙрк░рлНркЯ, рк░рк┐рк╕рлЙрк░рлНркЯ
ЁЯЪг => ЁЯЪг, ркирк╛рк╡ркбрлА, рк╡рк╛рк╣рки
ЁЯЪгтАНтЩА => ЁЯЪгтАНтЩА, рк╣рлЛркбрлА, рк╕рлНркдрлНрк░рлА
ЁЯЪгтАНтЩВ => ЁЯЪгтАНтЩВ, рк╣рлЛркбрлА, рккрлБрк░рлБрк╖
ЁЯЪд => ЁЯЪд, рк╣рлЛркбрлА, рк╡рк╛рк╣рки
ЁЯЫ│ => ЁЯЫ│, ркпрк╛ркдрлНрк░рлА, рк╡рк╣рк╛ркг, рк╡рк╛рк╣рки
тЫ┤ => тЫ┤, ркмрлЛркЯ, рк╣рлЛркбрлА, ркирк╛рк╡ркбрлА
ЁЯЫе => ЁЯЫе, ркмрлЛркЯ, рк╡рк╛рк╣рки
ЁЯЪв => ЁЯЪв, ркЬрк╣рк╛ркЬ, рк╡рк╛рк╣рки
тЬИ => тЬИ, рк╡рк┐ркорк╛рки, рк╣рк╡рк╛ркИ рк╡рк╛рк╣рки
ЁЯЫй => ЁЯЫй, рк╡рк┐ркорк╛рки
ЁЯЫл => ЁЯЫл, ркЪрлЗркХ-ркЗрки, рккрлНрк░рк╕рлНркерк╛рки, рк╡рк╛рк╣рки
ЁЯЫм => ЁЯЫм, рк▓рлЗркирлНркбрк┐ркВркЧ, ркЖрк╡рлА рк░рк╣рлНркпрлБркВ ркЫрлЗ, рк╡рк╛рк╣рки
ЁЯТ║ => ЁЯТ║, ркмрлЗркаркХ, ркЦрлБрк░рк╢рлА
ЁЯЪБ => ЁЯЪБ, рк╡рк╛рк╣рки
ЁЯЪЯ => ЁЯЪЯ, рк░рлЗрк▓рлНрк╡рлЗ, рк╕рк╕рлНрккрлЗркирлНрк╢рки, рк╡рк╛рк╣рки
ЁЯЪа => ЁЯЪа, рккрк░рлНрк╡ркдрлЛркирлА ркХрлЕркмрк▓ ркХрк╛рк░, ркХрлЕркмрк▓, ркХрк╛рк░, рккрк░рлНрк╡ркд, рк╡рк╛рк╣рки
ЁЯЪб => ЁЯЪб, ркХрлЕркмрк▓ ркХрк╛рк░, рк░рлЛрккрк╡рлЗ, рк╣рк╡рк╛ркИ, ркЯрлНрк░рк╛ркорк╡рлЗ, ркЧркВркбрлЛрк▓рк╛, рк╡рк╛рк╣рки
ЁЯЪА => ЁЯЪА, рк╡рк╛рк╣рки
ЁЯЫ░ => ЁЯЫ░, ркЕрк╡ркХрк╛рк╢, рк╡рк╛рк╣рки
ЁЯЫО => ЁЯЫО, ркШркВркЯркбрлА, ркШркВркЯрлА, рк╣рлЛркЯрк▓
ЁЯЪк => ЁЯЪк, ркжрк░рк╡рк╛ркЬрлЛ
ЁЯЫМ => ЁЯЫМ, рк╣рлЛркЯрк▓, ркКркВркШ, ркирк┐ркВркжрлНрк░рк╛
ЁЯЫП => ЁЯЫП, рк╣рлЛркЯрк▓, ркКркВркШ, ркирк┐ркВркжрлНрк░рк╛
ЁЯЫЛ => ЁЯЫЛ, рк╕рлЛрклрлЛ, ркХрк╛ркЙркЪ, рк╣рлЛркЯрк▓, рк▓рлЗркорлНркк
ЁЯЪ╜ => ЁЯЪ╜, ркЯрлЙркЗрк▓рлЗркЯ
ЁЯЪ┐ => ЁЯЪ┐, рк╢рлЙрк╡рк░
ЁЯЫА => ЁЯЫА, рк╕рлНркирк╛рки
ЁЯЫБ => ЁЯЫБ, ркмрк╛рке, ркирк╛рк╣рк╡рлБркВ
тМЫ => тМЫ, рк░рлЗркдрлА, рк╕ркоркп
тП│ => тП│, рк╕рлЗркирлНркб ркЯрк╛ркЗркорк░, рк░рлЗркдркШркбрлА, ркЕрк╡рк░ркЧрлНрк▓рк╛рк╕, ркЯрк╛ркЗркорк░, рк╕ркоркп
тМЪ => тМЪ, ркХрк╛ркВркбрк╛ ркШркбрк┐ркпрк╛рк│, рк╕ркоркп
тП░ => тП░, ркПрк▓рк╛рк░рлНрко, ркШркбрк┐ркпрк╛рк│, рк╕ркоркп
тП▒ => тП▒, ркШркбрк┐ркпрк╛рк│, рк╕ркоркп
тП▓ => тП▓, ркШркбрк┐ркпрк╛рк│, ркЯрк╛ркЗркорк░, рк╕ркоркп
ЁЯХ░ => ЁЯХ░, ркШркбрк┐ркпрк╛рк│, рк╕ркоркп
ЁЯХЫ => ЁЯХЫ, 12 рк╡рк╛ркЧрлНркпрлЗ, ркШркбрк┐ркпрк╛рк│, ркмрк╛рк░, 12:00
ЁЯХз => ЁЯХз, ркШркбрк┐ркпрк╛рк│, 12:30
ЁЯХР => ЁЯХР, 1 рк╡рк╛ркЧрлНркпрлЗ, ркШркбрк┐ркпрк╛рк│, ркПркХ, 1:00
ЁЯХЬ => ЁЯХЬ, ркШркбрк┐ркпрк╛рк│, 1:30
ЁЯХС => ЁЯХС, 2 рк╡рк╛ркЧрлНркпрлЗ, ркШркбрк┐ркпрк╛рк│, ркмрлЗ, 2:00
ЁЯХЭ => ЁЯХЭ, ркШркбрк┐ркпрк╛рк│, 2:30
ЁЯХТ => ЁЯХТ, 3 рк╡рк╛ркЧрлНркпрлЗ, ркШркбрк┐ркпрк╛рк│, ркдрлНрк░ркг, 3:00
ЁЯХЮ => ЁЯХЮ, ркШркбрк┐ркпрк╛рк│, 3:30
ЁЯХУ => ЁЯХУ, 4 рк╡рк╛ркЧрлНркпрлЗ, ркШркбрк┐ркпрк╛рк│, ркЪрк╛рк░, 4:00
ЁЯХЯ => ЁЯХЯ, ркШркбрк┐ркпрк╛рк│, 4:30
ЁЯХФ => ЁЯХФ, 5 рк╡рк╛ркЧрлНркпрлЗ, ркШркбрк┐ркпрк╛рк│, рккрк╛ркВркЪ, 5:00
ЁЯХа => ЁЯХа, ркШркбрк┐ркпрк╛рк│, 5:30
ЁЯХХ => ЁЯХХ, 6 рк╡рк╛ркЧрлНркпрлЗ, ркШркбрк┐ркпрк╛рк│, ркЫ, 6:00
ЁЯХб => ЁЯХб, ркШркбрк┐ркпрк╛рк│, 6:30
ЁЯХЦ => ЁЯХЦ, 7 рк╡рк╛ркЧрлНркпрлЗ, ркШркбрк┐ркпрк╛рк│, рк╕рк╛ркд, 7:00
ЁЯХв => ЁЯХв, ркШркбрк┐ркпрк╛рк│, 7:30
ЁЯХЧ => ЁЯХЧ, 8 рк╡рк╛ркЧрлНркпрлЗ, ркШркбрк┐ркпрк╛рк│, ркЖрка, 8:00
ЁЯХг => ЁЯХг, ркШркбрк┐ркпрк╛рк│, 8:30
ЁЯХШ => ЁЯХШ, 9 рк╡рк╛ркЧрлНркпрлЗ, ркШркбрк┐ркпрк╛рк│, ркирк╡, 9:00
ЁЯХд => ЁЯХд, ркШркбрк┐ркпрк╛рк│, 9:30
ЁЯХЩ => ЁЯХЩ, 10 рк╡рк╛ркЧрлНркпрлЗ, ркШркбрк┐ркпрк╛рк│, ркжрк╕, 10:00
ЁЯХе => ЁЯХе, ркШркбрк┐ркпрк╛рк│, 10:30
ЁЯХЪ => ЁЯХЪ, 11 рк╡рк╛ркЧрлНркпрлЗ, ркШркбрк┐ркпрк╛рк│, ркЕркЧрк┐ркпрк╛рк░, 11:00
ЁЯХж => ЁЯХж, ркШркбрк┐ркпрк╛рк│, 11:30
ЁЯМС => ЁЯМС, ркЕркорк╛рк╕, ркбрк╛рк░рлНркХ, ркирк╡рлЛ, ркЪркВркжрлНрк░
ЁЯМТ => ЁЯМТ, ркмрлАркЬ, рк╡ркзркдрлЛ ркЪркВркжрлНрк░, рк╡ркзркдрлЛ, ркЪркВркжрлНрк░
ЁЯМУ => ЁЯМУ, ркдрлНрк░рк┐ркорк╛рк╕рлА ркЪркВркжрлНрк░, рккрлНрк░ркерко ркдрлНрк░рк┐ркорк╛рк╕рлА ркЪркВркжрлНрк░, ркЪркВркжрлНрк░, ркдрлНрк░рк┐ркорк╛рк╕рлА
ЁЯМФ => ЁЯМФ, рк╡ркзркдрлЛ, ркЕрк░рлНркз ркЪркВркжрлНрк░, ркмрк╣рк┐рк░рлНркЧрлЛрк│, ркЪркВркжрлНрк░
ЁЯМХ => ЁЯМХ, рккрлВрк░рлНркг, ркдрлЗркЬрк╕рлНрк╡рлА ркЪркВркжрлНрк░, ркдрлЗркЬрк╕рлНрк╡рлА, ркЪркВркжрлНрк░
ЁЯМЦ => ЁЯМЦ, ркШркЯркдрлЛ, ркЕрк░рлНркз ркЪркВркжрлНрк░, ркмрк╣рк┐рк░рлНркЧрлЛрк│, ркЪркВркжрлНрк░
ЁЯМЧ => ЁЯМЧ, ркдрлНрк░рк┐ркорк╛рк╕рлА ркЪркВркжрлНрк░, ркдрлНрк░рк┐ркорк╛рк╕рлА, ркЕркВркдрк┐рко ркдрлНрк░рк┐ркорк╛рк╕рлА ркЪркВркжрлНрк░, ркЪркВркжрлНрк░
ЁЯМШ => ЁЯМШ, ркмрлАркЬркирлЛ ркЪркВркжрлНрк░, ркЕрк░рлНркзркЪркВркжрлНрк░рк╛ркХрк╛рк░, ркШркЯркдрлЛ ркЪркВркжрлНрк░, ркШркЯркдрлЛ, ркЪркВркжрлНрк░
ЁЯМЩ => ЁЯМЩ, ркмрлАркЬркирлЛ ркЪркВркжрлНрк░, ркЕрк░рлНркзркЪркВркжрлНрк░рк╛ркХрк╛рк░, ркЪркВркжрлНрк░
ЁЯМЪ => ЁЯМЪ, рккрлНрк░ркдрк┐рккркжрк╛ркирлЛ ркЪркВркжрлНрк░, ркЪрк╣рлЗрк░рк╛ рк╕рк╛ркерлЗркирлЛ рккрлНрк░ркдрк┐рккркжрк╛ркирлЛ ркЪркВркжрлНрк░, ркЪркВркжрлНрк░, ркЪрк╣рлЗрк░рлЛ
ЁЯМЫ => ЁЯМЫ, ркЕрк░рлНркз ркЪркВркжрлНрк░ркирлЛ ркЪрк╣рлЗрк░рлЛ, ркЪрк╣рлЗрк░рк╛ рк╕рк╛ркерлЗркирлЛ ркЕрк░рлНркз ркЪркВркжрлНрк░, ркЪрк╣рлЗрк░рк╛ рк╕рк╛ркерлЗркирлЛ ркЪркВркжрлНрк░, рк╢рлБркХрлНрк▓ рккркХрлНрк╖ркирлЛ ркЪркВркжрлНрк░, ркЕрк░рлНркз ркЪркВркжрлНрк░, ркЪркВркжрлНрк░, ркЪрк╣рлЗрк░рлЛ
ЁЯМЬ => ЁЯМЬ, ркЕрк░рлНркз ркЪркВркжрлНрк░ркирлЛ ркЪрк╣рлЗрк░рлЛ, ркЪрк╣рлЗрк░рк╛ рк╕рк╛ркерлЗркирлЛ ркЕрк░рлНркз ркЪркВркжрлНрк░, ркЪрк╣рлЗрк░рк╛ рк╕рк╛ркерлЗркирлЛ ркЪркВркжрлНрк░, ркХрлГрк╖рлНркг рккркХрлНрк╖ркирлЛ ркЪркВркжрлНрк░, ркЕрк░рлНркз ркЪркВркжрлНрк░, ркЪркВркжрлНрк░, ркЪрк╣рлЗрк░рлЛ
ЁЯМб => ЁЯМб, рк╣рк╡рк╛ркорк╛рки
тША => тША, ркХрк┐рк░ркгрлЛ, ркЕрк╡ркХрк╛рк╢, рк╣рк╡рк╛ркорк╛рки, рк╕рлВрк░рлНркпрккрлНрк░ркХрк╛рк╢
ЁЯМЭ => ЁЯМЭ, рккрлВркиркоркирк╛ ркЪркВркжрлНрк░рк╡рк╛рк│рлЛ ркЪрк╣рлЗрк░рлЛ, ркЪрк╣рлЗрк░рк╛рк╡рк╛рк│рлЛ ркЪркВркжрлНрк░, рккрлВркиркоркирлЛ ркЪркВркжрлНрк░, рккрлВрк░рлНркг, ркЪркВркжрлНрк░, ркЪрк╣рлЗрк░рлЛ
ЁЯМЮ => ЁЯМЮ, рк╕рлВрк░рлНркп, ркЪрк╣рлЗрк░рлЛ
тнР => тнР, ркдрк╛рк░рлЛ, рк╕рлНркЯрк╛рк░
ЁЯМЯ => ЁЯМЯ, ркЪркоркХркдрлЛ, ркЪркоркХркжрк╛рк░, ркЪркоркХркирк╛рк░, ркЪрк│ркХрк╡рлБркВ, ркдрк╛рк░рлЛ
ЁЯМа => ЁЯМа, ркЦрк░ркдрлЛ, ркдрк╛рк░рлЛ
тШБ => тШБ, рк╣рк╡рк╛ркорк╛рки
тЫЕ => тЫЕ, рк╡рк╛ркжрк│ рккрк╛ркЫрк│ркирлЛ рк╕рлВрк░рлНркп, рк╡рк╛ркжрк│рлЛ рк╕рк╛ркерлЗ рк╕рлВрк░рлНркп, рк╕рлВрк░рлНркп, рк╡рк╛ркжрк│
тЫИ => тЫИ, рк╡рк╛ркжрк│, рк╣рк╡рк╛ркорк╛рки, рк╡рк░рк╕рк╛ркж, ркорлЗркШркЧрк░рлНркЬркирк╛, рк╡рлАркЬрк│рлАркирлЛ ркХркбрк╛ркХрлЛ
ЁЯМд => ЁЯМд, рк╕рлВрк░рлНркп, рк╣рк╡рк╛ркорк╛рки
ЁЯМе => ЁЯМе, рк╕рлВрк░рлНркп, рк╣рк╡рк╛ркорк╛рки
ЁЯМж => ЁЯМж, рк╡рк░рк╕рк╛ркж, рк╕рлВрк░рлНркп, рк╣рк╡рк╛ркорк╛рки
ЁЯМз => ЁЯМз, рк╡рк░рк╕рк╛ркж, рк╡рк░рлНрк╖рк╛, рк╣рк╡рк╛ркорк╛рки
ЁЯМи => ЁЯМи, рк╣рк┐ркорк╡рк░рлНрк╖рк╛, рк╣рк╡рк╛ркорк╛рки, ркаркВркбрлБркВ, рк╢рлАркд
ЁЯМй => ЁЯМй, рк╣рк╡рк╛ркорк╛рки, рк╡рлАркЬрк│рлАркирлЛ ркЪркоркХрк╛рк░рлЛ
ЁЯМк => ЁЯМк, рк╡рк╛ркжрк│, рк╣рк╡рк╛ркорк╛рки, рк╡рк╛рк╡ркВркЯрлЛрк│, ркЪркХрлНрк░рк╡рк╛ркд
ЁЯМл => ЁЯМл, рк╡рк╛ркжрк│, рк╣рк╡рк╛ркорк╛рки
ЁЯМм => ЁЯМм, рк╡рк╛ркжрк│, рк╣рк╡рк╛ркорк╛рки, рк╡рк╛ркпрлБ, рк╣рк╡рк╛, ркЪрк╣рлЗрк░рлЛ, ркорлБркЦ
ЁЯМА => ЁЯМА, рк╡рк╛рк╡рк╛ркЭрлЛркбрлБ, рккрлНрк░ркЪркВркб ркдрлЛрклрк╛рки, ркЯрлНрк╡рк┐рк╕рлНркЯрк░, рк╡ркВркЯрлЛрк│рк┐ркпрлЛ
ЁЯМИ => ЁЯМИ, рк╡рк░рк╕рк╛ркж, рк╣рк╡рк╛ркорк╛рки
ЁЯМВ => ЁЯМВ, ркЫркдрлНрк░рлА, рк╡рк░рк╕рк╛ркж, рк╡рк░рк╕рк╛ркжрлА
тШВ => тШВ, рк╡рк░рк╕рк╛ркж, рк╣рк╡рк╛ркорк╛рки
тШФ => тШФ, рк╡рк░рк╕рк╛ркж, ркЫркдрлНрк░рлА, рк╣рк╡рк╛ркорк╛рки
тЫ▒ => тЫ▒, рк╕рлВрк░рлНркп, ркЫркдрлНрк░рлА, рк╣рк╡рк╛ркорк╛рки
тЪб => тЪб, рк╣рк╛ркЗ рк╡рлЙрк▓рлНркЯрлЗркЬ ркЬрлЛркЦрко, рк╣рк╛ркЗ рк╡рлЙрк▓рлНркЯрлЗркЬркирлБркВ ркЪрк┐рк╣рлНрки, ркнркп, рк╡рлЙрк▓рлНркЯрлЗркЬ, ркЪрк┐рк╣рлНрки
тЭД => тЭД, рк╕рлНркирлЛ рклрлНрк▓рлЕркХ, ркдрлБрк╖рк╛рк░, рк╢рлАркд, ркаркВркбрлБркВ, ркмрк░ркл, рк╣рк┐рко, рк╣рк╡рк╛ркорк╛рки
тШГ => тШГ, рк╣рк╡рк╛ркорк╛рки, ркмрк░ркл, рк╣рк┐рко
тЫД => тЫД, рк╣рк┐ркоркорк╛ркирк╡, рк╣рк┐рко рк╡рк┐ркирк╛ркирлЛ рк╣рк┐ркоркорк╛ркирк╡, рк╣рк┐рко
тШД => тШД, рккрлВркВркЫркбрк┐ркпрлЛ ркдрк╛рк░рлЛ, ркЕрк╡ркХрк╛рк╢, рк╕рлНрккрлЗрк╕
ЁЯФе => ЁЯФе, ркЖркЧ, ркЬрлНркпрлЛркд
ЁЯТз => ЁЯТз, ркаркВркбрлЛ рккрк░рк╕рлЗрк╡рлЛ, рккрк░рк╕рлЗрк╡рлЛ, рккрлНрк░рк╕рлНрк╡рлЗркжркпрлБркХрлНркд, рк░ркорлВркЬрлА
ЁЯМК => ЁЯМК, ркдрк░ркВркЧ, рк╕ркорлБркжрлНрк░ркирлА рк▓рк╣рлЗрк░, ркжрк░рк┐ркпрк╛ркирлБ ркорлЛркЬрлБркВ
ЁЯОГ => ЁЯОГ, ркЬрлЗркХ, рк▓рлЗркирлНркЯрк░рлНрки, рк╣рлЗрк▓рлЛрк╡рк┐рки, ркХрлЛрк│рлБркВ, ркЙркЬрк╡ркгрлА
ЁЯОД => ЁЯОД, рк╡рлГркХрлНрк╖, ркЙркЬрк╡ркгрлА
ЁЯОЖ => ЁЯОЖ, ркЙркЬрк╡ркгрлА
ЁЯОЗ => ЁЯОЗ, рк╕рлНрккрк╛рк░рлНркХрк▓рк░, рклркЯрк╛ркХркбрк╛, рклркЯрк╛ркХркбрк╛ рк╕рлНрккрк╛рк░рлНркХрк▓рк░, ркЙркЬрк╡ркгрлА
тЬи => тЬи, ркЪрк│ркХрк╛ркЯ, рк╣рлАрк░рлЛ, ркдрк╛рк░рк╛
ЁЯОИ => ЁЯОИ, ркЙркЬрк╡ркгрлА
ЁЯОЙ => ЁЯОЙ, рккрк╛рк░рлНркЯрлА, рккрлЛрккрк░, ркЙркЬрк╡ркгрлА
ЁЯОК => ЁЯОК, ркХрк╛ркЧрк│ркирк╛ркВ ркЯрлБркХркбрк╛, ркжркбрлЛ, ркЙркЬрк╡ркгрлА
ЁЯОЛ => ЁЯОЛ, ркЭрк╛ркб ркЕркирлЗ ркХрк╛ркЧрк│ рк╕рлНркЯрлНрк░рлАрккрлНрк╕, ркдрк╛рк░рк╛ ркЙркдрлНрк╕рк╡, ркЭрк╛ркб, ркХрк╛ркЧрк│ рк╕рлНркЯрлНрк░рлАрккрлНрк╕, ркЙркЬрк╡ркгрлА
ЁЯОМ => ЁЯОМ, ркЪрлЛркХркбрлАрк╡рк╛рк│рлЛ ркзрлНрк╡ркЬ, ркЬрк╛рккрк╛ркиркирлЛ ркЪрлЛркХркбрлАрк╡рк╛рк│рлЛ ркзрлНрк╡ркЬ, ркЪрлЛркХркбрлАрк╡рк╛рк│рлЛ, ркзрлНрк╡ркЬ, ркЙркЬрк╡ркгрлА
ЁЯОН => ЁЯОН, ркирлВркдрки рк╡рк░рлНрк╖, ркЬрк╛рккрк╛ркирлА, рккрк╛ркЗрки, ркЙркЬрк╡ркгрлА
ЁЯОО => ЁЯОО, ркврлАркВркЧрк▓рлАркУ, ркврлАркВркЧрк▓рлА ркЙркдрлНрк╕рк╡, ркЙркдрлНрк╕рк╡, ркЬрк╛рккрк╛ркирлА
ЁЯОП => ЁЯОП, рк╕рлНркЯрлНрк░рлАркорк░, ркЙркЬрк╡ркгрлА
ЁЯОР => ЁЯОР, ркЪрк╛ркЗрко
ЁЯОС => ЁЯОС, ркЪркВркжрлНрк░ ркжрк░рлНрк╢рки, ркЪркВркжрлНрк░, ркжрк░рлНрк╢рки, ркЙркЬрк╡ркгрлА
ЁЯОА => ЁЯОА, ркЙркЬрк╡ркгрлА
ЁЯОБ => ЁЯОБ, рк╕рлЛркЧрк╛ркж, ркнрлЗркЯ, рк╡рлАркВркЯрлЗрк▓рлА, ркЙркЬрк╡ркгрлА
ЁЯОЦ => ЁЯОЦ, ркорк┐рк▓рк┐ркЯрлНрк░рлА, ркорлЗркбрк▓, ркЙркЬрк╡ркгрлА
ЁЯОЧ => ЁЯОЧ, ркЙркЬрк╡ркгрлА, рк░рк┐ркмрки, рк░рк┐ркорк╛ркЗркирлНркбрк░
ЁЯОЮ => ЁЯОЮ, рк╕рк┐ркирлЗркорк╛, ркорлВрк╡рлА, рклрк┐рк▓рлНрко, рклрлНрк░рлЗркорлНрк╕
ЁЯОЯ => ЁЯОЯ, рккрлНрк░рк╡рлЗрк╢, ркЯрк┐ркХрк┐ркЯ
ЁЯОл => ЁЯОл, ркоркирлЛрк░ркВркЬрки
ЁЯП╖ => ЁЯП╖, рк▓рлЗркмрк▓
тЪ╜ => тЪ╜, рк╕рлЙркХрк░, ркмрлЙрк▓
тЪ╛ => тЪ╛, ркмрлЗрк╕ркмрлЙрк▓
ЁЯПА => ЁЯПА, ркмрк╛рк╕рлНркХрлЗркЯркмрлЛрк▓ рк╣рлВркк, ркмрлЛрк▓, рк╣рлВркк, ркЦрлЗрк▓ ркХрлВркж
ЁЯПИ => ЁЯПИ, ркЕркорлЗрк░рк┐ркХрки, ркмрлЛрк▓, ркЦрлЗрк▓ ркХрлВркж
ЁЯПЙ => ЁЯПЙ, рк╕рлЙркХрк░, рк╕рлЙркХрк░ ркмрлЛрк▓, ркмрлЛрк▓, ркЦрлЗрк▓ ркХрлВркж
ЁЯО╛ => ЁЯО╛, ркЯрлЗркирк┐рк╕ ркмрлЛрк▓, ркЯрлЗркирк┐рк╕ рк░рлЗркХрлЗркЯ ркЕркирлЗ ркмрлЛрк▓, ркмрлЛрк▓, ркЦрлЗрк▓ ркХрлВркж
ЁЯО▒ => ЁЯО▒, ркЖрка ркмрлЛрк▓, рк░ркоркд
ЁЯО│ => ЁЯО│, ркЧрлЛрк▓ркВркжрк╛ркЬрлАркирлЛ ркжркбрлЛ, ркжркбрлЛ, рк░ркоркд
тЫ│ => тЫ│, ркЧрлЛрк▓рлНркл, ркЧрлЛрк▓рлНркл ркзрлНрк╡ркЬ, ркЦрк╛ркбрлЛ
ЁЯПМ => ЁЯПМ, ркЧрлЛрк▓рлНрклрк░, ркмрлЛрк▓
ЁЯПМтАНтЩА => ЁЯПМтАНтЩА, ркЧрлЛрк▓рлНркл, рк╕рлНркдрлНрк░рлА
ЁЯПМтАНтЩВ => ЁЯПМтАНтЩВ, ркЧрлЛрк▓рлНркл, рккрлБрк░рлБрк╖
тЫ╕ => тЫ╕, ркмрк░ркл рккрк░ рк╕рлНркХрлЗркЯрк┐ркВркЧ, рк╕рлНркХрлЗркЯ
ЁЯОг => ЁЯОг, ркорк╛ркЫрк▓рлА рккркХркбрк╡рлА, ркорк╛ркЫрк▓рлА рккркХркбрк╡рк╛ркирлЛ ркХрк╛ркВркЯрлЛ ркЕркирлЗ ркорк╛ркЫрк▓рлА, ркорк╛ркЫрк▓рлА, ркХрк╛ркВркЯрлЛ, ркЖркиркВркжрккрлНрк░ркорлЛркж, ркоркирлЛрк░ркВркЬрки
ЁЯО╜ => ЁЯО╜, ркЦрлЗрк╕ рк╕рк╛ркерлЗркирлЛ рк░ркирк┐ркВркЧ рк╢рк░рлНркЯ, ркжрлЛркб, рк╢рк░рлНркЯ, ркЦрлЗрк╕, ркЦрлЗрк▓ ркХрлВркж
ЁЯО┐ => ЁЯО┐, рк╕рлНркХрлА ркЕркирлЗ ркмрлВркЯ, ркмрлВркЯ, ркЦрлЗрк▓ ркХрлВркж
тЫ╖ => тЫ╖, рк╕рлНркХрлА, ркмрк░ркл
ЁЯПВ => ЁЯПВ, рк╕рлНркирлЛркмрлЛрк░рлНркбрк┐ркВркЧ, рк╕рлНркирлЛркмрлЛрк░рлНркб, ркЦрлЗрк▓ ркХрлВркж
ЁЯПД => ЁЯПД, рк╕рк░рлНрклрк░, ркЦрлЗрк▓ ркХрлВркж
ЁЯПДтАНтЩА => ЁЯПДтАНтЩА, рк╕рлНркдрлНрк░рлА, рк╕рк░рлНрклрк┐ркВркЧ
ЁЯПДтАНтЩВ => ЁЯПДтАНтЩВ, рккрлБрк░рлБрк╖, рк╕рк░рлНрклрк┐ркВркЧ
ЁЯПЗ => ЁЯПЗ, рк░рлЗрк╕ркирлЛ ркШрлЛркбрлЛ, ркЬрлЛркХрлА, ркжрлЛркб, ркШрлЛркбрлЛ, ркЦрлЗрк▓ ркХрлВркж
ЁЯПК => ЁЯПК, ркдрк░ркг, ркдрк░рк╡рлБркВ, ркЦрлЗрк▓ ркХрлВркж
ЁЯПКтАНтЩА => ЁЯПКтАНтЩА, рк╕рлНркдрлНрк░рлА, рк╕рлНрк╡рк┐рко
ЁЯПКтАНтЩВ => ЁЯПКтАНтЩВ, рккрлБрк░рлБрк╖, рк╕рлНрк╡рк┐рко
тЫ╣ => тЫ╣, ркмрлЛрк▓, ркжркбрлЛ
тЫ╣тАНтЩА => тЫ╣тАНтЩА, ркмрлЛрк▓, рк╕рлНркдрлНрк░рлА
тЫ╣тАНтЩВ => тЫ╣тАНтЩВ, ркмрлЛрк▓, рккрлБрк░рлБрк╖
ЁЯПЛ => ЁЯПЛ, рк▓рк┐рклрлНркЯрк░, рк╡ркЬрки
ЁЯПЛтАНтЩА => ЁЯПЛтАНтЩА, рк╕рлНркдрлНрк░рлА, рк╡рлЗркЯ рк▓рк┐рклрлНркЯрк░
ЁЯПЛтАНтЩВ => ЁЯПЛтАНтЩВ, рккрлБрк░рлБрк╖, рк╡рлЗркЯ рк▓рк┐рклрлНркЯрк░
ЁЯЪ┤ => ЁЯЪ┤, рк╕рк╛ркЗркХрк▓ рк╕рк╡рк╛рк░, ркмрк╛ркЗркХ
ЁЯЪ┤тАНтЩА => ЁЯЪ┤тАНтЩА, ркмрк╛ркЗрк╕рк┐ркХрк▓, ркмрк╛ркЗркХрк┐ркВркЧ, рк╕рк╛ркЗркХрлНрк▓рк┐рк╕рлНркЯ, рк╕рлНркдрлНрк░рлА
ЁЯЪ┤тАНтЩВ => ЁЯЪ┤тАНтЩВ, ркмрк╛ркЗрк╕рк┐ркХрк▓, ркмрк╛ркЗркХрк┐ркВркЧ, рк╕рк╛ркЗркХрлНрк▓рк┐рк╕рлНркЯ, рккрлБрк░рлБрк╖
ЁЯЪ╡ => ЁЯЪ╡, ркмрк╛ркЗркХ, рк╕рк╛ркЗркХрк▓ рк╕рк╡рк╛рк░, рккрк░рлНрк╡ркд
ЁЯЪ╡тАНтЩА => ЁЯЪ╡тАНтЩА, ркмрк╛ркЗрк╕рк┐ркХрк▓, ркмрк╛ркЗркХрк┐, рк╕рк╛ркЗркХрлНрк▓рк┐рк╕рлНркЯ, рк╕рлНркдрлНрк░рлА, рккрк░рлНрк╡ркд
ЁЯЪ╡тАНтЩВ => ЁЯЪ╡тАНтЩВ, ркмрк╛ркЗрк╕рк┐ркХрк▓, ркмрк╛ркЗркХрк┐, рк╕рк╛ркЗркХрлНрк▓рк┐рк╕рлНркЯ, рккрлБрк░рлБрк╖, рккрк░рлНрк╡ркд
ЁЯПО => ЁЯПО, ркХрк╛рк░, рк░рлЗрк╕рк┐ркВркЧ
ЁЯПН => ЁЯПН, рк░рлЗрк╕рк┐ркВркЧ
ЁЯПЕ => ЁЯПЕ, ркорлЗркбрк▓
ЁЯПЖ => ЁЯПЖ, ркИркирк╛рко
ЁЯПП => ЁЯПП, ркмрлЛрк▓, ркмрлЗркЯ, рк░ркоркд
ЁЯПР => ЁЯПР, ркмрлЛрк▓, рк░ркоркд
ЁЯПС => ЁЯПС, ркмрлЛрк▓, рклрлАрк▓рлНркб, ркорлЗркжрк╛ркирлА, рк╣рлЙркХрлА, рк╕рлНркЯрк┐ркХ
ЁЯПТ => ЁЯПТ, рк░ркоркд, рк╣рлЙркХрлА, ркЖркЗрк╕, рккркХ, рк╕рлНркЯрк┐ркХ
ЁЯПУ => ЁЯПУ, ркмрлЛрк▓, ркмрлЗркЯ, рк░ркоркд, рккрлЗркбрк▓, ркЯрлЗркмрк▓ ркЯрлЗркирк┐рк╕
ЁЯП╕ => ЁЯП╕, рк░ркоркд, ркмрк░рлНркбрлА, рк░рлЗркХрлЗркЯ, рк╢ркЯрк▓ркХрлЙркХ
ЁЯОп => ЁЯОп, ркмрк│ркжркирлА ркЖркВркЦ, рк▓ркХрлНрк╖рлНркп рккрк░ ркЬ, рк▓ркХрлНрк╖рлНркп, рк╣рк┐ркЯ, рк░ркоркд
ЁЯОо => ЁЯОо, ркЧрлЗрко ркирк┐ркпркВркдрлНрк░ркХ, ркирк┐ркпркВркдрлНрк░ркХ, ркЧрлЗрко
ЁЯХ╣ => ЁЯХ╣, рк░ркоркд, рк╡рк┐ркбрк┐ркУ ркЧрлЗрко
ЁЯО▓ => ЁЯО▓, рккрк╛рк╕рк╛ркирлА рк░ркоркд, рккрк╛рк╕рлЛ, рккрк╛рк╕рк╛, рк░ркоркд
тЩа => тЩа, ркХрк╛рк│рлА, рк░ркоркд, рккркдрлНркдрлБркВ, ркХрк╛рк░рлНркб
тЩе => тЩе, рк▓рк╛рк▓, рк░ркоркд, рккркдрлНркдрлБркВ, ркХрк╛рк░рлНркб
тЩж => тЩж, ркЪрлЛркХркЯ, рк░ркоркд, рккркдрлНркдрлБркВ, ркХрк╛рк░рлНркб
тЩг => тЩг, рклрлБрк▓рлЗрк╡рк░, рк░ркоркд, ркХрк╛рк░рлНркб
ЁЯГП => ЁЯГП, ркЬрлЛркХрк░ркирлБркВ рккркдрлНркдрлБркВ, ркЧркВркЬрлАрклрк╛ркирлБркВ рккркдрлНркдрлБркВ, рккркдрлНркдрк╛ркВ, ркЧркВркЬрлАрклрлЛ
ЁЯАД => ЁЯАД, ркорк╛рк╣ркЬрлЛркВркЧ ркЯрк╛ркЗрк▓, рк▓рк╛рк▓ ркбрлНрк░рлЗркЧрки, ркбрлНрк░рлЗркЧрки, ркорк╛рк╣ркЬрлЛркВркЧ, ркЯрк╛ркЗрк▓
ЁЯО┤ => ЁЯО┤, рккркдрлНркдрлБркВ, рклрлВрк▓, рккркдрлНркдрк╛ркирлА рк░ркоркд, рк░ркоркд, рк╣ркирк╛рклрлВркбрк╛
ЁЯФЗ => ЁЯФЗ, ркмрлЛрк▓рк╢рлЛ ркирк╣рлАркВ, ркХрлГрккрк╛ ркХрк░рлА рк╢рк╛ркВркд рк░рк╣рлЛ, рк╢рк╛ркВркд, рк░ркж ркХрк░рлЗрк▓рк╛ ркЪрк┐рк╣рлНрки рк╕рк╛ркерлЗркирлБркВ рк╕рлНрккрлАркХрк░
ЁЯФИ => ЁЯФИ, рк▓рк╛ркЙркбрк╕рлНрккрлАркХрк░
ЁЯФЙ => ЁЯФЙ, рк╕рлНрккрлАркХрк░, ркУркЫрлБркВ рк╡рлЙрк▓рлНркпрлВрко, ркУркЫрлБркВ, ркУркЫрк╛ рк╡рлЙрк▓рлНркпрлВрко рк╕рк╛ркерлЗркирлБркВ рк╕рлНрккрлАркХрк░
ЁЯФК => ЁЯФК, рк╕рлНрккрлАркХрк░, рк╡ркзрлБ рк╡рлЙрк▓рлНркпрлВрко, рк╡ркзрлБ, рк╡ркзрлБ рк╡рлЙрк▓рлНркпрлВрко рк╕рк╛ркерлЗркирлБркВ рк╕рлНрккрлАркХрк░
ЁЯУв => ЁЯУв, ркЬрк╛рк╣рлЗрк░ рк╕ркВркмрлЛркзрки, рк╣рлЗркирлНркб рк╕рлНрккрлАркХрк░, рк╕ркВркЪрк╛рк░
ЁЯУг => ЁЯУг, ркорлЗркЧрк╛рклрлЛрки, рк╕ркВркЪрк╛рк░
ЁЯУп => ЁЯУп, рккрлЛрк╕рлНркЯрк▓ рк╣рлЛрк░рлНрки, рккрлЛрк╕рлНркЯрк▓
ЁЯФФ => ЁЯФФ, ркжрлЗрк╡рк╛рк▓ркп
ЁЯФХ => ЁЯФХ, ркШркВркЯ ркирк╣рлАркВ, ркЕрк╡рк╛ркЬ ркирк╣рлАркВ, рк░ркж ркХрк░рлЗрк▓рк╛ ркЪрк┐рк╣рлНрки рк╕рк╛ркерлЗркирлЛ ркШркВркЯ, ркШркВркЯ
ЁЯО╝ => ЁЯО╝, рк╕ркВркЧрлАркд, рк▓ркЦрк╛ркг
ЁЯО╡ => ЁЯО╡, рк╕ркВркЧрлАркд, ркирлЛркЯ
ЁЯО╢ => ЁЯО╢, рк╕ркВркЧрлАркд, ркирлЛркЯ, ркирлЛркЯрлНрк╕
ЁЯОЩ => ЁЯОЩ, ркорк╛ркЗркХ, ркорк╛ркЗркХрлНрк░рлЛрклрлЛрки, рк╕рлНркЯрлВркбрк┐ркпрлЛ, рк╕ркВркЧрлАркд, ркорлНркпрлБркЭрк┐ркХ
ЁЯОЪ => ЁЯОЪ, рк╕ркВркЧрлАркд, рк╕рлНрк▓рк╛ркЗркбрк░, ркорлНркпрлБркЭрк┐ркХ
ЁЯОЫ => ЁЯОЫ, ркХркирлНркЯрлНрк░рлЛрк▓, ркирлЛркмрлНрк╕, рк╕ркВркЧрлАркд, ркорлНркпрлБркЭрк┐ркХ
ЁЯОд => ЁЯОд, ркорк╛ркЗркХ, ркХрк╛рк░рк╛ркУркХ, ркоркирлЛрк░ркВркЬрки
ЁЯОз => ЁЯОз, ркоркирлЛрк░ркВркЬрки
ЁЯО╖ => ЁЯО╖, рк╕рлЗркХрлНрк╕, рк╕ркВркЧрлАркд рк╡рк╛ркжрлНркп, рк╕ркВркЧрлАркд, рк╡рк╛ркжрлНркп
ЁЯО╕ => ЁЯО╕, рк╕ркВркЧрлАркд рк╡рк╛ркжрлНркп, рк╕ркВркЧрлАркд, рк╡рк╛ркжрлНркп
ЁЯО╣ => ЁЯО╣, рккрк┐ркЖркирлЛ, рк╕ркВркЧрлАркд ркХрлА ркмрлЛрк░рлНркб, ркХрлА ркмрлЛрк░рлНркб, рк╕ркВркЧрлАркд рк╡рк╛ркжрлНркп, рк╕ркВркЧрлАркд, рк╡рк╛ркжрлНркп
ЁЯО║ => ЁЯО║, рк╕ркВркЧрлАркд рк╡рк╛ркжрлНркп, рк╕ркВркЧрлАркд, рк╡рк╛ркжрлНркп
ЁЯО╗ => ЁЯО╗, рк╕ркВркЧрлАркд рк╡рк╛ркжрлНркп, рк╕ркВркЧрлАркд, рк╡рк╛ркжрлНркп
ЁЯУ╗ => ЁЯУ╗, рк╡рк┐ркбрк┐ркУ
ЁЯУ▒ => ЁЯУ▒, рк╕рлЗрк▓ рклрлЛрки, рклрлЛрки
ЁЯУ▓ => ЁЯУ▓, ркдрлАрк░ рк╕рк╛ркерлЗркирлЛ рк╕рлЗрк▓ рклрлЛрки, ркПркХ ркХрлЙрк▓ ркХрк░рлЛ, ркорлЛркмрк╛ркЗрк▓ рклрлЛрки, рклрлЛрки
тШО => тШО, рклрлЛрки
ЁЯУЮ => ЁЯУЮ, рклрлЛрки, ркЯрлЗрк▓рк┐рклрлЛрки, рклрлЛркиркирлБркВ рк░рлАрк╕рк┐рк╡рк░, рк╕ркВркЪрк╛рк░
ЁЯУЯ => ЁЯУЯ, рк╕ркВркЪрк╛рк░
ЁЯУа => ЁЯУа, рклрлЕркХрлНрк╕, рк╕ркВркЪрк╛рк░
ЁЯФЛ => ЁЯФЛ, ркмрлЕркЯрк░рлА
ЁЯФМ => ЁЯФМ, ркЗрк▓рлЗркХрлНркЯрлНрк░рк┐ркХ
ЁЯТ╗ => ЁЯТ╗, PC, рккрк░рлНрк╕ркирк▓ ркХркорлНрккрлНркпрлБркЯрк░, ркХркорлНрккрлНркпрлБркЯрк░, рк╡рлНркпркХрлНркдрк┐ркЧркд
ЁЯЦе => ЁЯЦе, ркбрлЗрк╕рлНркХркЯрлЙркк, ркХркорлНрккрлНркпрлБркЯрк░
ЁЯЦи => ЁЯЦи, ркХркорлНрккрлНркпрлБркЯрк░
тМи => тМи, ркХркорлНрккрлНркпрлБркЯрк░
ЁЯЦ▒ => ЁЯЦ▒, ркХркорлНрккрлНркпрлБркЯрк░, ркорк╛ркЙрк╕, ркдрлНрк░ркг, 3, ркмркЯрки
ЁЯЦ▓ => ЁЯЦ▓, ркХркорлНрккрлНркпрлБркЯрк░
ЁЯТ╜ => ЁЯТ╜, MD, ркбрк┐рк╕рлНркХ
ЁЯТ╛ => ЁЯТ╛, рклрлНрк▓рлЛрккрлА, ркбрк┐рк╕рлНркХ
ЁЯТ┐ => ЁЯТ┐, ркмрлНрк▓рлБ-рк░рлЗ, DVD, CD, ркбрк┐рк╕рлНркХ
ЁЯУА => ЁЯУА, DVD, DVD ркбрк┐рк╕рлНркХ, ркбрк┐рк╕рлНркХ
ЁЯОе => ЁЯОе, ркорлВрк╡рлА ркХрлЕркорлЗрк░рк╛, ркорлВрк╡рлА, рк╕рк┐ркирлЗркорк╛, ркоркирлЛрк░ркВркЬрки
ЁЯОм => ЁЯОм, ркХрлНрк▓рлЗрккрк░ркмрлЛрк░рлНркб, ркХрлНрк▓рлЗрккрк░, ркорлВрк╡рлА, ркоркирлЛрк░ркВркЬрки
ЁЯУ╜ => ЁЯУ╜, рк╕рк┐ркирлЗркорк╛, ркорлВрк╡рлА, рккрлНрк░рлЛркЬрлЗркХрлНркЯрк░, рк╡рк┐ркбрк┐ркУ
ЁЯУ║ => ЁЯУ║, ркЯрлАрк╡рлА
ЁЯУ╖ => ЁЯУ╖, рк╡рк┐ркбрк┐ркУ
ЁЯУ╕ => ЁЯУ╕, рк╡рк┐ркбрк┐ркУ, рклрлНрк▓рлЗрк╢, ркХркорлЗрк░рлЛ
ЁЯУ╣ => ЁЯУ╣, рк╡рк┐ркбрк┐ркУ ркХрлЕрко, ркХрлЕркорлЗрк░рлЛ, рк╡рк┐ркбрк┐ркУ
ЁЯУ╝ => ЁЯУ╝, рк╡рк┐ркбрк┐ркУ ркЯрлЗркк, рк╡рк┐ркбрк┐ркУ, ркЯрлЗркк
ЁЯФН => ЁЯФН, ркмрлГрк╣ркжркжрк░рлНрк╢ркХ ркХрк╛ркЪ, рк╢рлЛркзрлЛ, ркбрк╛ркмрлА ркдрк░рклркирлЛ, ркХрк╛ркЪ
ЁЯФО => ЁЯФО, ркмрлГрк╣ркжркжрк░рлНрк╢ркХ ркХрк╛ркЪ, рк╢рлЛркзрлЛ, ркЬркоркгрлА ркдрк░рклркирлЛ, ркХрк╛ркЪ
ЁЯФм => ЁЯФм, ркЯрлВрк▓
ЁЯФн => ЁЯФн, ркЯрлВрк▓
ЁЯУб => ЁЯУб, рк╕рлЗркЯрлЗрк▓рк╛ркЗркЯ ркбрк┐рк╢, ркПркирлНркЯрлЗркирк╛, ркбрк┐рк╢, рк╕рлЗркЯрлЗрк▓рк╛ркЗркЯ, рк╕ркВркЪрк╛рк░
ЁЯХп => ЁЯХп, рк▓рк╛ркЗркЯ
ЁЯТб => ЁЯТб, рк╡рлАркЬрк│рлАркирлЛ ркЧрлЛрк│рлЛ, рк╡рк┐ркЪрк╛рк░ ркЖрк╡рлНркпрлЛ, рк╡рлАркЬ, рк╡рлАркЬрк│рлА, ркЧрлЛрк│рлЛ, ркХрлЛркорк┐ркХ
ЁЯФж => ЁЯФж, рккрлНрк░ркХрк╛рк╢, ркЯрлЛрк░рлНркЪ, ркЗрк▓рлЗркХрлНркЯрлНрк░рк┐ркХ
ЁЯПо => ЁЯПо, рк▓рк╛рк▓, рклрк╛ркирк╕, ркЗркЭрк╛ркХрлНркпрк╛, ркмрк╛рк░, рк░рлЗрк╕рлНркЯрлЛрк░ркирлНркЯ
ЁЯУФ => ЁЯУФ, рк╕рлБрк╢рлЛркнрк┐ркд ркирлЛркЯркмрлБркХ, рк╕рлБрк╢рлЛркнркирк╡рк╛рк│рлА ркирлЛркЯркмрлБркХ, ркирлЛркЯркмрлБркХ, ркХрк╡рк░
ЁЯУХ => ЁЯУХ, рккрлБрк╕рлНркдркХ
ЁЯУЦ => ЁЯУЦ, рккрлБрк╕рлНркдркХ
ЁЯУЧ => ЁЯУЧ, рккрлБрк╕рлНркдркХ
ЁЯУШ => ЁЯУШ, рккрлБрк╕рлНркдркХ
ЁЯУЩ => ЁЯУЩ, рккрлБрк╕рлНркдркХ
ЁЯУЪ => ЁЯУЪ, рккрлБрк╕рлНркдркХ
ЁЯУУ => ЁЯУУ, ркирлЛркЯркмрлБркХ
ЁЯУТ => ЁЯУТ, ркирлЛркЯркмрлБркХ
ЁЯУГ => ЁЯУГ, ркжрк╕рлНркдрк╛рк╡рлЗркЬ, рккрлГрк╖рлНрка
ЁЯУЬ => ЁЯУЬ, рккрлЗрккрк░ рк╕рлНркХрлНрк░рлЛрк▓
ЁЯУД => ЁЯУД, ркжрк╕рлНркдрк╛рк╡рлЗркЬ, ркЪркдрлНркдрлБ, рккрлГрк╖рлНрка
ЁЯУ░ => ЁЯУ░, рк╕ркорк╛ркЪрк╛рк░рккркдрлНрк░, рк╕ркорк╛ркЪрк╛рк░, ркХрк╛ркЧрк│
ЁЯЧЮ => ЁЯЧЮ, рк╕ркорк╛ркЪрк╛рк░рккркдрлНрк░
ЁЯУС => ЁЯУС, ркорк╛рк░рлНркХрк░, ркЯрлЗркмрлНрк╕, ркмрлБркХркорк╛рк░рлНркХ
ЁЯФЦ => ЁЯФЦ, ркорк╛рк░рлНркХ
ЁЯТ░ => ЁЯТ░, ркбрлЙрк▓рк░ ркмрлЕркЧ, рккрлИрк╕рк╛, ркмрлЕркЧ
ЁЯТ┤ => ЁЯТ┤, ркпрлЗрки ркирлЛркЯ. ркмрлЗркВркХ ркирлЛркЯ, ркмрлЗркВркХркирлЛркЯ, ркпрлЗрки. рккрлИрк╕рк╛, ркмрк┐рк▓, ркирлЛркЯ
ЁЯТ╡ => ЁЯТ╡, ркмрлЗркВркХркирлЛркЯ, ркбрлЙрк▓рк░, рккрлИрк╕рк╛, ркмрк┐рк▓, ркирлЛркЯ
ЁЯТ╢ => ЁЯТ╢, ркпрлБрк░рлЛ, ркмрлЗркВркХркирлЛркЯ, рккрлИрк╕рк╛, ркмрк┐рк▓, ркирлЛркЯ
ЁЯТ╖ => ЁЯТ╖, рккрк╛ркЙркирлНркб, ркмрлЗркВркХркирлЛркЯ, рккрлИрк╕рк╛
ЁЯТ╕ => ЁЯТ╕, ркКркбркдрк╛ рккрлИрк╕рк╛, ркКркбркдрлА ркмрлЗркВркХркирлЛркЯ, ркмрлЗркВркХ, ркирлЛркЯ, рккрлИрк╕рк╛
ЁЯТ│ => ЁЯТ│, ркХрк╛рк░рлНркб, ркХрлНрк░рлЗркбрк┐ркЯ
ЁЯТ╣ => ЁЯТ╣, ркКркаркдрлБркВ ркмркЬрк╛рк░, ркКркВркЪрлЗ ркЬркдрлЛ ркЖрк▓рлЗркЦ, ркЙрккрк░ркирлА ркдрк░ркл, ркЖрк▓рлЗркЦ, ркмркЬрк╛рк░
тЬЙ => тЬЙ, ркЗркорлЗркЗрк▓
ЁЯУз => ЁЯУз, ркорлЗркЗрк▓, рккркдрлНрк░, рк╕ркВркЪрк╛рк░
ЁЯУи => ЁЯУи, рккрлНрк░рк╛рккрлНркд ркорлЗркЗрк▓, ркЖрк╡ркирк╛рк░рлА, ркЗркорлЗркЗрк▓, ркорлЗркЗрк▓, рккркдрлНрк░, рккрк░ркмрлАркбрк┐ркпрлБркВ, рк╕ркВркЪрк╛рк░
ЁЯУй => ЁЯУй, ркорлЛркХрк▓рлЗрк▓ ркорлЗркЗрк▓, ркмрк╣рк╛рк░ ркЬркдрлА, ркЗркорлЗркЗрк▓, ркорлЗркЗрк▓, рккркдрлНрк░, рккрк░ркмрлАркбрк┐ркпрлБркВ, рк╕ркВркЪрк╛рк░
ЁЯУд => ЁЯУд, ркорлЛркХрк▓рлЗрк▓ ркорлЗркЗрк▓, ркорлЛркХрк▓рлЗрк▓ ркмрлЛркХрлНрк╕, ркорлЗркЗрк▓, ркорлЛркХрк▓рлЗрк▓, ркмрлЛркХрлНрк╕, ркЖркЙркЯркмрлЛркХрлНрк╕, ркЯрлНрк░рлЗ, рк╕ркВркЪрк╛рк░
ЁЯУе => ЁЯУе, ркЗркиркмрлЛркХрлНрк╕, рккрлНрк░рк╛рккрлНркд ркорлЗркЗрк▓, ркорлЗркЗрк▓, рккрлНрк░рк╛рккрлНркд, ркмрлЛркХрлНрк╕, ркЯрлНрк░рлЗ, рк╕ркВркЪрк╛рк░
ЁЯУж => ЁЯУж, рккрк╛рк░рлНрк╕рк▓, ркмрлЛркХрлНрк╕
ЁЯУл => ЁЯУл, ркорлЗркЗрк▓ркмрлЛркХрлНрк╕, ркмркВркз, ркорлЗркЗрк▓, ркзрлНрк╡ркЬ
ЁЯУк => ЁЯУк, ркорлЗркЗрк▓ркмрлЛркХрлНрк╕, ркмркВркз, ркорлЗркЗрк▓, ркзрлНрк╡ркЬ
ЁЯУм => ЁЯУм, ркорлЗркЗрк▓ркмрлЛркХрлНрк╕, ркЦрлБрк▓рлНрк▓рлБркВ, ркорлЗркЗрк▓, ркзрлНрк╡ркЬ
ЁЯУн => ЁЯУн, ркорлЗркЗрк▓ркмрлЛркХрлНрк╕, ркЦрлБрк▓рлНрк▓рлБркВ, ркорлЗркЗрк▓, ркзрлНрк╡ркЬ
ЁЯУо => ЁЯУо, ркорлЗркЗрк▓, ркорлЗркЗрк▓ркмрлЙркХрлНрк╕
ЁЯЧ│ => ЁЯЧ│, ркмрлЙркХрлНрк╕, ркоркдркжрк╛рки
тЬП => тЬП, рккрлЕркирлНрк╕рк┐рк▓
тЬТ => тЬТ, ркирк┐ркм, рккрлЕрки
ЁЯЦЛ => ЁЯЦЛ, рклрк╛ркЙркирлНркЯрки, рккрлЕрки
ЁЯЦК => ЁЯЦК, ркмрлЛрк▓рккрлЙркЗркирлНркЯ
ЁЯЦМ => ЁЯЦМ, ркЪрк┐ркдрлНрк░ркХрк│рк╛
ЁЯЦН => ЁЯЦН, ркХрлНрк░рлЗркпрлЛрки
ЁЯУЭ => ЁЯУЭ, ркорлЗркорлЛ рккрлБрк╕рлНркдркХ, рк╕ркВркЪрк╛рк░
ЁЯУБ => ЁЯУБ, рклрк╛ркЗрк▓
ЁЯУВ => ЁЯУВ, ркЦрлБрк▓рлНрк▓рлБркВ рклрлЛрк▓рлНркбрк░, ркЦрлБрк▓рлНрк▓рлБркВ, рклрк╛ркЗрк▓, рклрлЛрк▓рлНркбрк░
ЁЯЧВ => ЁЯЧВ, ркХрк╛рк░рлНркб, ркЗркирлНркбрлЗркХрлНрк╕, ркбрк┐рк╡рк╛ркЗркбрк░рлНрк╕
ЁЯУЕ => ЁЯУЕ, ркХрлЗрк▓рлЗркирлНркбрк░
ЁЯУЖ => ЁЯУЖ, ркХрлЗрк▓рлЗркирлНркбрк░
ЁЯЧТ => ЁЯЧТ, рк╕рлНрккрк╛ркЗрк░рк▓, ркирлЛркЯ, рккрлЗркб
ЁЯЧУ => ЁЯЧУ, рк╕рлНрккрк╛ркЗрк░рк▓, ркХрлЕрк▓рлЗркирлНркбрк░, рккрлЗркб
ЁЯУЗ => ЁЯУЗ, рк░рлЛрк▓рлЛркбрлЗркХрлНрк╕, ркЗркирлНркбрлЗркХрлНрк╕
ЁЯУИ => ЁЯУИ, ркЙркВркЪрлЗркирлБркВ рк╡рк▓ркг, ркЙркВркЪрлЗркирк╛ рк╡рк▓ркгркирлЛ ркЪрк╛рк░рлНркЯ, ркЪрк╛рк░рлНркЯ, ркЖрк▓рлЗркЦ, ркЙрккрк░ркирлА ркдрк░ркл
ЁЯУЙ => ЁЯУЙ, ркирлАркЪрлЗркирлБркВ рк╡рк▓ркг, ркЙркВркЪрлЗркирк╛ рк╡рк▓ркгркирлЛ ркЪрк╛рк░рлНркЯ, ркЪрк╛рк░рлНркЯ, ркЖрк▓рлЗркЦ, ркирлАркЪрлЗркирлА ркдрк░ркл
ЁЯУК => ЁЯУК, рк╕рлНркдркВркн ркЖрк▓рлЗркЦ, ркЪрк╛рк░рлНркЯ
ЁЯУЛ => ЁЯУЛ, ркХрлНрк▓рк┐рккркмрлЙрк░рлНркб
ЁЯУМ => ЁЯУМ, рккрк┐рки
ЁЯУН => ЁЯУН, рккрлБрк╢рккрк┐рки, рккрк┐рки
ЁЯУО => ЁЯУО, ркХрлНрк▓рк┐ркк
ЁЯЦЗ => ЁЯЦЗ, рккрлЗрккрк░ркХрлНрк▓рк┐ркк
ЁЯУП => ЁЯУП, ркЖркВркХркгрлА
ЁЯУР => ЁЯУР, ркдрлНрк░рк┐ркХрлЛркг ркЖркВркХркгрлА, ркдрлНрк░рк┐ркХрлЛркг, ркЖркВркХркгрлА
тЬВ => тЬВ, рк╕рк╛ркзрки
ЁЯЧГ => ЁЯЧГ, рклрк╛ркЗрк▓
ЁЯЧД => ЁЯЧД, рклрк╛ркЗрк▓, ркХрлЕркмрк┐ркирлЗркЯ
ЁЯЧС => ЁЯЧС, ркХркЪрк░рк╛рккрлЗркЯрлА
ЁЯФТ => ЁЯФТ, ркмркВркз ркдрк╛рк│рлБркВ
ЁЯФУ => ЁЯФУ, ркдрк╛рк│рлБркВ
ЁЯФП => ЁЯФП, рк▓рлЙркХ ркХрк░рлЛ, ркЧрлЛрккркирлАркпркдрк╛, ркЗркВркХ рккрлЗрки рк╕рк╛ркерлЗ рк▓рлЙркХ, ркЗркВркХ рккрлЗрки
ЁЯФР => ЁЯФР, ркмркВркз ркдрк╛рк│рлБркВ, ркЪрк╛рк╡рлА рк╕рк╛ркерлЗ ркдрк╛рк│рлБркВ, рк╕рлБрк░ркХрлНрк╖рк┐ркд
ЁЯФС => ЁЯФС, ркХрлА, рккрк╛рк╕рк╡рк░рлНркб
ЁЯЧЭ => ЁЯЧЭ, ркдрк╛рк│рлБркВ, ркХрк│
ЁЯФи => ЁЯФи, рк╕рк╛ркзрки
тЫП => тЫП, ркЦркирки, рк╕рк╛ркзрки
тЪТ => тЪТ, рк╣ркерлЛркбрлА, ркдрк┐ркХрко, рк╕рк╛ркзрки
ЁЯЫа => ЁЯЫа, рк╕рк╛ркзрки
ЁЯФз => ЁЯФз, рк░рлЗркВркЪ, рк╕рк╛ркзрки
ЁЯФй => ЁЯФй, ркиркЯ, ркмрлЛрк▓рлНркЯ, рк╕рк╛ркзрки
тЪЩ => тЪЩ, рк╕рк╛ркзрки
ЁЯЧЬ => ЁЯЧЬ, рк╕рк╛ркзрки
тЪЧ => тЪЧ, рк╡рк░рк╛рк│ ркарк╛рк░рлАркирлЗ рккрлНрк░рк╡рк╛рк╣рлА рк╢рлБркжрлНркз ркХрк░рк╡рк╛ркирлБркВ рк╕рк╛ркзрки
тЪЦ => тЪЦ, ркирлНркпрк╛ркп, ркдрлБрк▓рк╛, ркорк╛ркк, рк╡ркЬрки, рк░рк╛рк╢рк┐
ЁЯФЧ => ЁЯФЧ, рк▓рк┐ркВркХркирлБркВ ркЪрк┐рк╣рлНрки, рк▓рк┐ркВркХрлНрк╕, ркмрлЗ рк░рк┐ркВркЧрлНрк╕
тЫУ => тЫУ, рк╕рк╛ркВркХрк│
ЁЯТЙ => ЁЯТЙ, рк╢рлЛркЯ, рк╕рлЛркп, ркжрк╡рк╛, ркбрлЛркХрлНркЯрк░
ЁЯТК => ЁЯТК, ркЧрлЛрк│рлА, ркжрк╡рк╛, ркбрлЛркХрлНркЯрк░
ЁЯЧб => ЁЯЧб, ркЪрк╛ркХрлБ, рк╣ркерк┐ркпрк╛рк░
ЁЯФк => ЁЯФк, ркЪрк╛ркХрлБ
тЪФ => тЪФ, рк╣ркерк┐ркпрк╛рк░
ЁЯФл => ЁЯФл, ркЧрки, рк░рлАрк╡рлЛрк▓рлНрк╡рк░
ЁЯЫб => ЁЯЫб, рк╣ркерк┐ркпрк╛рк░
ЁЯП╣ => ЁЯП╣, ркдрлАрк░ркВркжрк╛ркЬ, рк╣ркерк┐ркпрк╛рк░, рк░рк╛рк╢рк┐, рк╕рк╛ркзрки
ЁЯПБ => ЁЯПБ, ркзрлНрк╡ркЬ, ркЪрлЛркХркбрлАрк╡рк╛рк│рлЛ, рк╣рк░рлАрклрк╛ркИ, ркЦрлЗрк▓ ркХрлВркж
ЁЯП│ => ЁЯП│, рк▓рк╣рлЗрк░рк╡рлБркВ
ЁЯП│тАНЁЯМИ => ЁЯП│тАНЁЯМИ, рк╕рккрлНркдрк░ркВркЧрлА, ркЭркВркбрлЛ
ЁЯП┤ => ЁЯП┤, рк▓рк╣рлЗрк░рк╡рлБркВ
ЁЯЪй => ЁЯЪй, рк╕рлНркерк╛рки ркзрлНрк╡ркЬ, рк╕рлНркерк╛рки ркорк╛рк╣рк┐ркдрлАркирлЛ ркзрлНрк╡ркЬ, ркдрлНрк░рк┐ркХрлЛркг рк╕рлНркерк╛рки ркзрлНрк╡ркЬ, ркдрлНрк░рк┐ркХрлЛркг ркзрлНрк╡ркЬ, ркзрлНрк╡ркЬ, рк╕рлНркерк╛рки
ЁЯЪм => ЁЯЪм, ркзрлВркорлНрк░рккрк╛ркиркирлБркВ ркЪрк┐рк╣рлНрки, ркзрлВркорлНрк░рккрк╛ркиркирлА ркЕркирлБркоркдрк┐, ркЪрк┐рк╣рлНрки
тЪ░ => тЪ░, ркорлГркдрлНркпрлБ
тЪ▒ => тЪ▒, ркЕркВркдрк┐ркоркпрк╛ркдрлНрк░рк╛
ЁЯЧ┐ => ЁЯЧ┐, ркорлЛркпрк╛ркИркирлА рккрлНрк░ркдрк┐ркорк╛, рккрлНрк░ркдрк┐ркорк╛
ЁЯЫв => ЁЯЫв, ркЯрк╛ркВркХрлА, ркдрлЗрк▓
ЁЯФо => ЁЯФо, ркнрк╛ркЧрлНркп ркХркерки, рк╕рлНрклркЯрк┐ркХ, ркжркбрлЛ, ркнрк╛ркЧрлНркп
ЁЯПз => ЁЯПз, ркСркЯрлЛркорлЗркЯрлЗркб ркЯрлЗрк▓рк░, ркСркЯрлЛркорлЗркЯрлЗркб, ркЯрлЗрк▓рк░
ЁЯЪо => ЁЯЪо, ркХркЪрк░рк╛рккрлЗркЯрлАркирлБркВ ркЪрк┐рк╣рлНрки, ркХркЪрк░рк╛ркирлЗ ркдрлЗркирк╛ рк╕рлНркерк╛ркирлЗ ркирк╛ркВркЦрлЛ, ркХркЪрк░рк╛ рккрлЗркЯрлА, ркЪрк┐рк╣рлНрки
ЁЯЪ░ => ЁЯЪ░, рккрлАрк╡рк╛ ркорк╛ркЯрлЗркирлБркВ рккрк╛ркгрлА, рккрлАрк╡рк╛ркирк╛ркВ рккрк╛ркгрлАркирлБркВ ркЪрк┐рк╣рлНрки
тЩ┐ => тЩ┐, рк╡рлНрк╣рлАрк▓ркЪрлЗрк░ ркЕтАНрлЕркХрлНрк╕рлЗрк╕, ркЕтАНрлЕркХрлНрк╕рлЗрк╕, рк╡рлНрк╣рлАрк▓ркЪрлЗрк░ркирлБркВ рккрлНрк░ркдрлАркХ, ркЪрк┐рк╣рлНрки
ЁЯЪ╣ => ЁЯЪ╣, рккрлБрк░рлБрк╖рлЛркирлБркВ ркЪрк┐рк╣рлНрки, рккрлБрк░рлБрк╖рлЛркирлЛ ркЦркВркб, рккрлБрк░рлБрк╖рлЛркирлБркВ рккрлНрк░ркдрлАркХ, ркЪрк┐рк╣рлНрки
ЁЯЪ║ => ЁЯЪ║, ркорк╣рк┐рк▓рк╛ркУркирлБркВ ркЪрк┐рк╣рлНрки, ркорк╣рк┐рк▓рк╛ркУркирлЛ ркЦркВркб, ркорк╣рк┐рк▓рк╛ркУркирлБркВ рккрлНрк░ркдрлАркХ, ркЪрк┐рк╣рлНрки
ЁЯЪ╗ => ЁЯЪ╗, рк░рлЗрк╕рлНркЯрк░рлВрко ркЪрк┐рк╣рлНрки, рк░рлЗрк╕рлНркЯрк░рлВрко, wc
ЁЯЪ╝ => ЁЯЪ╝, ркЕркВркжрк░ ркмрк╛рк│ркХ ркЫрлЗ, ркмрк╛рк│ркХркирк╛ рк╡рк╕рлНркдрлНрк░ ркмркжрк▓рк╡рк╛ркирлБркВ рк╕рлНркерк╛рки, ркмрк╛рк│ркХ
ЁЯЪ╛ => ЁЯЪ╛, WC, рк░рлЗрк╕рлНркЯрк░рлВрко, рк╢рлМркЪрк╛рк▓ркп
ЁЯЫВ => ЁЯЫВ, рккрк╛рк╕рккрлЛрк░рлНркЯ, ркХркирлНркЯрлНрк░рлЛрк▓
ЁЯЫГ => ЁЯЫГ, ркХрк╕рлНркЯркорлНрк╕
ЁЯЫД => ЁЯЫД, ркмрлЕркЧрлЗркЬ ркжрк╛рк╡рлЛ, ркмрлЕркЧрлЗркЬ
ЁЯЫЕ => ЁЯЫЕ, ркмрлЕркЧрлЗркЬ рк╕рлЗрк╡рк╛, рк╕рк╛ркорк╛рки, ркмрлЕркЧрлЗркЬ
тЪа => тЪа, ркЪрлЗркдрк╡ркгрлА, ркЪрк┐рк╣рлНрки
ЁЯЪ╕ => ЁЯЪ╕, ркмрк╛рк│ркХрлЛ ркорк╛ркЯрлЗркирлБркВ ркХрлНрк░рлЛрк╕рк┐ркВркЧ, ркмрк╛рк│ркХрлЛ, ркХрлНрк░рлЛрк╕рк┐ркВркЧ, ркЪрк┐рк╣рлНрки
тЫФ => тЫФ, рккрлНрк░рк╡рлЗрк╢ ркирк┐рк╖рлЗркзркирлБркВ ркЪрк┐рк╣рлНрки, ркирк┐рк╖рлЗркз, ркирк╣рлАркВ, ркЪрк┐рк╣рлНрки
ЁЯЪл => ЁЯЪл, рккрлНрк░рк╡рлЗрк╢ ркирк┐рк╖рлЗркз ркЪрк┐рк╣рлНрки, рккрлНрк░рк╡рлЗрк╢ ркирк┐рк╖рлЗркз, ркЪрк┐рк╣рлНрки
ЁЯЪ│ => ЁЯЪ│, ркмрк╛ркЗркХ ркирк╣рлАркВ, рк╕рк╛ркЗркХрк▓ркирлЗ ркоркВркЬрлВрк░рлА ркиркерлА, ркмрк╛ркЗркХ, рк╡рк╛рк╣рки
ЁЯЪн => ЁЯЪн, ркзрлВркорлНрк░рккрк╛рки ркирк┐рк╖рлЗркз, ркЪрк┐рк╣рлНрки
ЁЯЪп => ЁЯЪп, ркХркЪрк░рлЛ ркХрк░рк╢рлЛ ркирк╣рлАркВ, ркХркЪрк░рлЛ рклрлЗркВркХрк╡рлЛ ркирк╣рлАркВ, ркЪрк┐рк╣рлНрки
ЁЯЪ▒ => ЁЯЪ▒, рккрлАрк╡рк╛ ркпрлЛркЧрлНркп рккрк╛ркгрлА ркиркерлА, рккрк╛ркгрлА, рккрлЗркп ркирк╣рлАркВ
ЁЯЪ╖ => ЁЯЪ╖, рккркжркпрк╛ркдрлНрк░рлАркУркирлЗ ркоркВркЬрлВрк░рлА ркиркерлА, рккркжркпрк╛ркдрлНрк░рлА, рк░рк╛рк╣ркжрк╛рк░рлА, ркЪрк┐рк╣рлНрки
тШв => тШв, рк░рлЗркбрк┐ркУркНркХрлНркЯрк┐рк╡, рк╕ркВркХрлЗркд
тШг => тШг, ркмрк╛ркпрлЛрк╣ркЭрк╛рк░рлНркб, рк╕ркВркХрлЗркд
тмЖ => тмЖ, ркжрк┐рк╢рк╛, ркдрлАрк░, ркЙркдрлНркдрк░
тЖЧ => тЖЧ, ркЙркдрлНркдрк░рккрлВрк░рлНрк╡, ркжрк┐рк╢рк╛, ркдрлАрк░
тЮб => тЮб, ркжрк┐рк╢рк╛, рккрлВрк░рлНрк╡, ркдрлАрк░
тЖШ => тЖШ, ркдрлАрк░, ркжрк┐рк╢рк╛, ркжркХрлНрк╖рк┐ркгрккрлВрк░рлНрк╡
тмЗ => тмЗ, ркжрк┐рк╢рк╛, ркдрлАрк░, ркирлАркЪрлЗ, ркжркХрлНрк╖рк┐ркг
тЖЩ => тЖЩ, ркдрлАрк░, ркжркХрлНрк╖рк┐ркгрккрк╢рлНркЪрк┐рко
тмЕ => тмЕ, ркжрк┐рк╢рк╛, рккрк╢рлНркЪрк┐рко
тЖЦ => тЖЦ, рккрлВрк░рлНрк╡рккрк╢рлНркЪрк┐рко
тЖХ => тЖХ, ркдрлАрк░
тЖФ => тЖФ, ркдрлАрк░
тЖй => тЖй, ркдрлАрк░
тЖк => тЖк, ркдрлАрк░
тд┤ => тд┤, ркдрлАрк░
тд╡ => тд╡, ркдрлАрк░
ЁЯФГ => ЁЯФГ, рклрк░рлАркерлА рк▓рлЛркб ркХрк░рлЛ, рклрк░рлАркерлА рк▓рлЛркб ркХрк░рлЛркирлБркВ ркЪрк┐рк╣рлНрки, ркдрлАрк░
ЁЯФД => ЁЯФД, рк╡рк╛ркорк╛рк╡рк░рлНркдрлА ркдрлАрк░, рк╡рк╛ркорк╛рк╡рк░рлНркдрлА, ркдрлАрк░
ЁЯФЩ => ЁЯФЩ, рккрк╛ркЫрк│, ркбрк╛ркмрк╛ ркдрлАрк░ рк╕рк╛ркерлЗ рккрк╛ркЫрк│, ркбрк╛ркмрлБркВ ркдрлАрк░, ркдрлАрк░
ЁЯФЪ => ЁЯФЪ, рк╕ркорк╛рккрлНркдрк┐, ркбрк╛ркмрк╛ ркдрлАрк░ рк╕рк╛ркерлЗ рк╕ркорк╛рккрлНркдрк┐, ркбрк╛ркмрлБркВ ркдрлАрк░, ркдрлАрк░
ЁЯФЫ => ЁЯФЫ, ркЪрк╛рк▓рлБ ркдрлАрк░, ркЙркжрлНркЧрк╛рк░рк╡рк╛ркЪркХ ркЪрк┐рк╣рлНрки ркЕркирлЗ ркдрлАрк░ рк╕рк╛ркерлЗ ркЪрк╛рк▓рлБ, ркдрлАрк░, ркЙркжрлНркЧрк╛рк░рк╡рк╛ркЪркХ ркЪрк┐рк╣рлНрки, ркЙркжрлНркЧрк╛рк░рк╡рк╛ркЪркХ
ЁЯФЬ => ЁЯФЬ, ркЬрк▓рлНркжрлАркирлБркВ ркЪрк┐рк╣рлНрки, ркЬрк▓рлНркжрлА, ркЬркоркгрк╛ркВ ркдрлАрк░ рк╕рк╛ркерлЗ ркЬрк▓рлНркжрлА, ркдрлАрк░
ЁЯФЭ => ЁЯФЭ, ркЯрлЛркЪ, ркЙрккрк░ркирк╛ркВ ркдрлАрк░ рк╕рк╛ркерлЗ ркЯрлЛркЪ, ркЙрккрк░ ркдрлАрк░, ркЙрккрк░
ЁЯЫР => ЁЯЫР, ркзрк░рлНрко, рккрлНрк░рк╛рк░рлНркеркирк╛
тЪЫ => тЪЫ, ркЕркгрлБркВ
ЁЯХЙ => ЁЯХЙ, рк╣рк┐ркирлНркжрлБ, ркзрк░рлНрко
тЬб => тЬб, ркпрк╣рлЛркжрлА, ркзрк░рлНрко, ркдрк╛рк░рлЛ, ркбрлЗрк╡рк┐ркб
тШ╕ => тШ╕, ркЪркХрлНрк░, ркзрк░рлНрко, ркмрлМркжрлНркз
тШп => тШп, ркзрк░рлНрко, ркдрк╛ркУ, ркпрк╛ркВркЧ, ркпрк┐рки
тЬЭ => тЬЭ, ркЦрлНрк░рк┐рк╕рлНркдрлА, ркХрлНрк░рлЛрк╕, ркзрк░рлНрко
тШж => тШж, ркХрлНрк░рлЛрк╕, ркзрк░рлНрко
тШк => тШк, ркЗрк╕рлНрк▓рк╛рко, ркорлБрк╕рлНрк▓рк┐рко, ркзрк░рлНрко
тШо => тШо, рк╢рк╛ркВркдрк┐
ЁЯХО => ЁЯХО, ркзрк░рлНрко, ркХрлЗркирлНркбрк▓рк╕рлНркЯрк┐ркХ
ЁЯФп => ЁЯФп, ркнрк╛ркЧрлНркп ркХркерки, ркЫ-рккрлЛркЗркВркЯрк╡рк╛рк│рлЛ, ркдрк╛рк░рлЛ, ркнрк╛ркЧрлНркп
тЩ╗ => тЩ╗, ркиркХрлНркХрк░ рк╕рк╛рк░рлНрк╡ркдрлНрк░рк┐ркХ рк░рк┐рк╕рк╛ркпркХрлНрк▓рк┐ркВркЧркирлБркВ рккрлНрк░ркдрлАркХ, рк░рк┐рк╕рк╛ркпркХрлНрк▓рк┐ркВркЧ, рк╕рк╛рк░рлНрк╡ркдрлНрк░рк┐ркХ, ркЪрк┐рк╣рлНрки
ЁЯУЫ => ЁЯУЫ, ркмрлЗркЬ, ркирк╛рко
тЪЬ => тЪЬ, рклрлНрк▓рлЗркЙрк░-ркжрлЗ-рк▓рк┐рк╕
ЁЯФ░ => ЁЯФ░, рк▓рлАрк▓рлБркВ ркЕркирлЗ рккрлАрк│рлБркВ рккрк╛ркВркжркбрлБ, рк▓рлАрк▓рлБркВ ркЕркирлЗ рккрлАрк│рлБркВ, рккрлНрк░рк╛рк░ркВркнркХрк░рлНркдрк╛, ркЬрк╛рккрк╛ркирлАркЭ
ЁЯФ▒ => ЁЯФ▒, ркПркВркХрк░, ркдрлНрк░рк┐рк╢рлВрк│, рк╕ркВркЬрлНркЮрк╛
тнХ => тнХ, o
тЬЕ => тЬЕ, ркЪрлЗркХ ркорк╛рк░рлНркХ, ркЪрлЗркХ, рк╣рлЗрк╡рлА ркЪрлЗркХ ркорк╛рк░рлНркХ
тШС => тШС, ркоркд, рккрлЗркЯрк╛, ркмрлЛркХрлНрк╕, ркЪрлЗркХ
тЬФ => тЬФ, ркЪрлЗркХ, ркЪрк┐рк╣рлНрки
тЬЦ => тЬЦ, ркЧрлБркгрк╛ркХрк╛рк░, рк░ркж ркХрк░рлЛ
тЭМ => тЭМ, ркХрлНрк░рлЛрк╕ркирлБркВ ркЪрк┐рк╣рлНрки, тАЬXтАЭ
тЭО => тЭО, ркХрлНрк░рлЛрк╕ркирлБркВ ркЪрк┐рк╣рлНрки, ркЪрлЛрк░рк╕ркорк╛ркВ тАЬXтАЭ
тЮХ => тЮХ, рк╡ркдрлНркдрк╛, ркнрк╛рк░рлЗ рк╡ркдрлНркдрк╛ркирлБркВ ркЪрк┐рк╣рлНрки, рк╡ркдрлНркдрк╛ркирлБркВ ркЪрк┐рк╣рлНрки, ркЪрк┐рк╣рлНрки
тЮЦ => тЮЦ, ркмрк╛ркжркмрк╛ркХрлА, ркнрк╛рк░рлЗ ркмрк╛ркжркмрк╛ркХрлАркирлБркВ ркЪрк┐рк╣рлНрки, ркмрк╛ркжркмрк╛ркХрлАркирлБркВ ркЪрк┐рк╣рлНрки, ркЪрк┐рк╣рлНрки
тЮЧ => тЮЧ, ркнрк╛ркЧрк╛ркХрк╛рк░, ркнрк╛рк░рлЗ ркнрк╛ркЧрк╛ркХрк╛рк░ркирлБркВ ркЪрк┐рк╣рлНрки, ркнрк╛ркЧрк╛ркХрк╛рк░ркирлБркВ ркЪрк┐рк╣рлНрки, ркЪрк┐рк╣рлНрки
тЮ░ => тЮ░, рк╡рк│рк╛ркВркХ, рк▓рлВркк
тЮ┐ => тЮ┐, рк╡рк╛ркВркХркбрк┐ркпрлБ рк▓рлВркк, ркЬрк╛рккрк╛рки, рклрлНрк░рлА ркбрк╛ркпрк▓
уА╜ => уА╜, ркЪрк┐рк╣рлНрки, ркнрк╛ркЧ
тЬ│ => тЬ│, ркдрк╛рк░рлЛ
тЬ┤ => тЬ┤, ркдрк╛рк░рлЛ
тЭЗ => тЭЗ, ркЪркоркХ, рк╕рлНрккрк╛рк░рлНркХрк▓
ЁЯТ▒ => ЁЯТ▒, ркорлБркжрлНрк░рк╛, рккрлИрк╕рк╛, рк╡рк┐ркирк┐ркоркп
ЁЯТ▓ => ЁЯТ▓, ркбрлЙрк▓рк░ ркЪрк┐рк╣рлНрки, ркШрк╛ркЯрлБркВ ркбрлЙрк▓рк░ ркЪрк┐рк╣рлНрки, ркбрлЙрк▓рк░, рккрлИрк╕рк╛
тА╝ => тА╝, ркЪрк┐рк╣рлНрки, рк╡рк┐рк░рк╛ркоркЪрк┐рк╣рлНрки
тБЙ => тБЙ, рккрлНрк░рк╢рлНрки, рк╡рк┐рк░рк╛ркоркЪрк┐рк╣рлНрки
тЭУ => тЭУ, рккрлНрк░рк╢рлНрки
тЭФ => тЭФ, рккрлНрк░рк╢рлНркирк╛рк░рлНрке ркЪрк┐рк╣рлНрки, рккрлНрк░рк╢рлНрки
тЭХ => тЭХ, ркЙркжрлНркЧрк╛рк░рк╡рк╛ркЪркХ ркЪрк┐рк╣рлНрки, ркЙркжрлНркЧрк╛рк░рк╡рк╛ркЪркХ
тЭЧ => тЭЧ, рк╡рк┐рк░рк╛ркоркЪрк┐рк╣рлНрки
уА░ => уА░, рк▓рк╛ркВркмрлБркВ ркзрлНрк╡ркирк┐ ркЪрк┐рк╣рлНрки, рк▓рк╣рлЗрк░рк╛ркдрлБркВ, ркбрлЗрк╢
┬й => ┬й, ркХрлЙрккрк┐рк░рк╛ркЗркЯ
┬о => ┬о, ркирлЛркВркзрк╛ркпрлЗрк▓
тДв => тДв, ркЯрлНрк░рлЗркб ркорк╛рк░рлНркХ, ркЪрк┐рк╣рлНрки
тЩИ => тЩИ, рк░рк╛рк╢рк┐ркЪркХрлНрк░
тЩЙ => тЩЙ, рк░рк╛рк╢рк┐ркЪркХрлНрк░
тЩК => тЩК, рк░рк╛рк╢рк┐ркЪркХрлНрк░
тЩЛ => тЩЛ, рк░рк╛рк╢рк┐ркЪркХрлНрк░
тЩМ => тЩМ, рк░рк╛рк╢рк┐ркЪркХрлНрк░
тЩН => тЩН, рк░рк╛рк╢рк┐ркЪркХрлНрк░
тЩО => тЩО, рк░рк╛рк╢рк┐ркЪркХрлНрк░
тЩП => тЩП, рк╕рлНркХрлЛрк░рлНрккрк┐ркЕрк╕, рк░рк╛рк╢рк┐ркЪркХрлНрк░
тЩР => тЩР, рк░рк╛рк╢рк┐ркЪркХрлНрк░
тЩС => тЩС, рк░рк╛рк╢рк┐ркЪркХрлНрк░
тЩТ => тЩТ, рк░рк╛рк╢рк┐ркЪркХрлНрк░
тЩУ => тЩУ, рк░рк╛рк╢рк┐ркЪркХрлНрк░
тЫО => тЫО, рк░рк╛рк╢рк┐ркЪркХрлНрк░
ЁЯФА => ЁЯФА, ркХрлНрк░рлЛрк╕ ркХрк░рлЗрк▓рк╛ ркдрлАрк░, ркХрлНрк░рлЛрк╕ ркХрк░рлЗрк▓ ркЬркоркгрк╛ркВ ркдрлАрк░, ркдрлАрк░
ЁЯФБ => ЁЯФБ, ркжркХрлНрк╖рк┐ркгрк╛рк╡рк░рлНркдрлА ркдрлАрк░, ркжркХрлНрк╖рк┐ркгрк╛рк╡рк░рлНркдрлА, ркдрлАрк░
ЁЯФВ => ЁЯФВ, ркжркХрлНрк╖рк┐ркгрк╛рк╡рк░рлНркдрлА ркдрлАрк░, ркиркВркмрк░ 1 рк╕рк╛ркерлЗркирк╛ ркжркХрлНрк╖рк┐ркгрк╛рк╡рк░рлНркдрлА ркдрлАрк░, ркжркХрлНрк╖рк┐ркгрк╛рк╡рк░рлНркдрлА, ркдрлАрк░, ркиркВркмрк░ 1
тЦ╢ => тЦ╢, ркдрлАрк░, ркдрлНрк░рк┐ркХрлЛркг, ркЪрк▓рк╛рк╡рлЛ, ркЬркоркгрлБркВ
тПй => тПй, рклрк╛рк╕рлНркЯ рклрлЛрк░рк╡рк░рлНркб ркХрк░рлЛ, ркбркмрк▓ ркЬркоркгрк╛ркВ ркдрлАрк░, ркЬркоркгрлБркВ, ркдрлАрк░
тПн => тПн, ркЖркЧрк▓рлБркВ ркжрлГрк╢рлНркп, ркЖркЧрк▓рлЛ ркЯрлНрк░рлЗркХ, ркдрлНрк░рк┐ркХрлЛркг
тПп => тПп, ркЬркоркгрлБркВ, ркдрлНрк░рк┐ркХрлЛркг, ркдрлАрк░
тЧА => тЧА, ркдрлАрк░, ркбрк╛ркмрлБркВ, рккрк▓ркЯрк╛рк╡рлЛ, ркдрлНрк░рк┐ркХрлЛркг
тПк => тПк, рк░рк┐рк╡рк╛ркЗркирлНркб ркХрк░рлЛ, ркбркмрк▓ ркбрк╛ркмрк╛ ркдрлАрк░, ркбрк╛ркмрлБркВ, ркдрлАрк░
тПо => тПо, ркдрлАрк░, рккрк╛ркЫрк▓рлБркВ ркжрлГрк╢рлНркп, рккрк╣рлЗрк▓рк╛ркирлЛ ркЯрлНрк░рлЗркХ, ркдрлНрк░рк┐ркХрлЛркг
ЁЯФ╝ => ЁЯФ╝, ркЙрккрк░ ркдрлНрк░рк┐ркХрлЛркг, ркЙрккрк░ ркдрлНрк░рк┐ркХрлЛркг ркмркЯрки, ркдрлНрк░рк┐ркХрлЛркг, ркмркЯрки
тПл => тПл, ркЙрккрк░ркирлБркВ ркдрлАрк░, ркбркмрк▓ ркЙрккрк▓рк╛ ркдрлАрк░, ркЙрккрк░, ркдрлАрк░
ЁЯФ╜ => ЁЯФ╜, ркирлАркЪрлЗ ркдрлНрк░рк┐ркХрлЛркг, ркирлАркЪрлЗ ркдрлНрк░рк┐ркХрлЛркг ркмркЯрки, ркдрлНрк░рк┐ркХрлЛркг, ркмркЯрки
тПм => тПм, ркирлАркЪрлЗркирлБркВ ркдрлАрк░, ркбркмрк▓ ркирлАркЪрк▓рк╛ ркдрлАрк░, ркирлАркЪрлЗ, ркдрлАрк░
тП╕ => тП╕, ркерлЛркнрк╛рк╡рлЛ, рккркЯрлНркЯрлА, ркКркнрлА
тП╣ => тП╣, рк░рлЛркХрлЛ, ркЪрлЛрк░рк╕
тП║ => тП║, рк░рлЗркХрлЛрк░рлНркб ркХрк░рлЛ, ркЧрлЛрк│
тПП => тПП, ркХрк╛ркврлА ркирк╛ркВркЦрлЛ
ЁЯОж => ЁЯОж, ркорлВрк╡рлА, ркорлВрк╡рлА ркЪрк┐рк╣рлНрки
ЁЯФЕ => ЁЯФЕ, ркУркЫрлА ркЪркоркХ, ркУркЫрлА, ркоркВркж, ркУркЫрлА ркЪркоркХркирлБркВ ркЪрк┐рк╣рлНрки, ркЪркоркХ
ЁЯФЖ => ЁЯФЖ, рк╡ркзрлБ ркЪркоркХ, ркдрлЗркЬрк╕рлНрк╡рлА, рк╡ркзрлБ ркЪркоркХркирлБркВ ркЪрк┐рк╣рлНрки, ркЪркоркХ
ЁЯУ╢ => ЁЯУ╢, ркорлЛркмрк╛ркЗрк▓ рк╕рк┐ркЧрлНркирк▓рлНрк╕, рк╕рлНркдркВркнрк╡рк╛рк│рлЛ ркПркирлНркЯрлЗркирк╛, рк╕рк┐ркЧрлНркирк▓ркирлА рккрлНрк░ркмрк│ркдрк╛, рк╕рк┐ркЧрлНркирк▓, ркПркирлНркЯрлЗркирк╛, ркорлЛркмрк╛ркЗрк▓, рклрлЛрки
ЁЯУ╡ => ЁЯУ╡, рк╕рлЗрк▓ рклрлЛрки ркирк╣рлАркВ, ркХрлЙрк▓рлНрк╕ ркирк╣рлАркВ, ркорлЛркмрк╛ркЗрк▓, рклрлЛрки
ЁЯУ│ => ЁЯУ│, ркХркВрккрки ркорлЛркб, рк╕рлЗрк▓ рклрлЛрки, ркорлЛркмрк╛ркЗрк▓, рклрлЛрки, ркорлЛркб
ЁЯУ┤ => ЁЯУ┤, рклрлЛрки ркмркВркз, рк╕рлЗрк▓ рклрлЛрки ркмркВркз, рк╕рлЗрк▓ рклрлЛрки, ркорлЛркмрк╛ркЗрк▓, рклрлЛрки, ркмркВркз
#тГг => #тГг, рк╣рлЗрк╢, рккрк╛ркЙркирлНркб
*тГг => *тГг, ркдрк╛рк░рлЛ
ЁЯФЯ => ЁЯФЯ, ркХрлАркХрлЕркк ркжрк╕, 10
ЁЯТп => ЁЯТп, рккрлВрк░рлНркг рк╕рлНркХрлЛрк░, 100 рккрлЛркЗркирлНркЯрлНрк╕, 100, рк╕рлНркХрлЛрк░
ЁЯФЮ => ЁЯФЮ, 18 ркирлА ркирлАркЪрлЗркирлБркВ ркХрлЛркИ ркирк╣рлАркВ, 18 ркерлА ркирлАркЪрлЗркирк╛ рккрлНрк░ркдрк┐ркмркВркзрк┐ркд, 18 ркерлА ркирлАркЪрлЗркирк╛, 18
ЁЯФа => ЁЯФа, ркЕрккрк░ркХрлЗрк╕ ркЕркХрлНрк╖рк░рлЛ, ркЕрккрк░ркХрлЗрк╕ рк▓рлЗркЯрк┐рки, ркЕрккрк░ркХрлЗрк╕, рк▓рлЗркЯрк┐рки
ЁЯФб => ЁЯФб, рк▓рлЛркЕрк░ркХрлЗрк╕ ркЕркХрлНрк╖рк░рлЛ, рк▓рлЛркЕрк░ркХрлЗрк╕ рк▓рлЗркЯрк┐рки, рк▓рлЛркЕрк░ркХрлЗрк╕, рк▓рлЗркЯрк┐рки
ЁЯФв => ЁЯФв, ркиркВркмрк░рлНрк╕
ЁЯФг => ЁЯФг, рккрлНрк░ркдрлАркХрлЛ
ЁЯФд => ЁЯФд, рк▓рлЗркЯрк┐рки ркорлВрк│рк╛ркХрлНрк╖рк░, рк▓рлЗркЯрк┐рки, ркЕркВркЧрлНрк░рлЗркЬрлА, ABC
ЁЯЕ░ => ЁЯЕ░, рккрлНрк░ркХрк╛рк░ A, рк▓рлЛрк╣рлАркирлЛ рккрлНрк░ркХрк╛рк░, рк▓рлЛрк╣рлА, A
ЁЯЖО => ЁЯЖО, рккрлНрк░ркХрк╛рк░ AB, рк▓рлЛрк╣рлАркирлЛ рккрлНрк░ркХрк╛рк░, рк▓рлЛрк╣рлА, AB
ЁЯЕ▒ => ЁЯЕ▒, рккрлНрк░ркХрк╛рк░ B, рк▓рлЛрк╣рлАркирлЛ рккрлНрк░ркХрк╛рк░, рк▓рлЛрк╣рлА, B
ЁЯЖС => ЁЯЖС, CL, CL ркирлБркВ ркЪрк┐рк╣рлНрки
ЁЯЖТ => ЁЯЖТ, ркХрлВрк▓, ркХрлВрк▓ркирлБркВ ркЪрк┐рк╣рлНрки
ЁЯЖУ => ЁЯЖУ, ркорклркд, рк╢рлБрк▓рлНркХ рк░рк╣рк┐ркд, ркЪрк┐рк╣рлНрки
тД╣ => тД╣, ркЖркЗ, ркорк╛рк╣рк┐ркдрлА
ЁЯЖФ => ЁЯЖФ, ID, ID ркирлБркВ ркЪрк┐рк╣рлНрки, ркУрк│ркЦ, ркЪрк┐рк╣рлНрки
тУВ => тУВ, ркЧрлЛрк│, ркПрко
ЁЯЖХ => ЁЯЖХ, ркирк╡рлБркВ, ркирк╡рк╛ркирлБркВ ркЪрк┐рк╣рлНрки, ркЪрк┐рк╣рлНрки
ЁЯЖЦ => ЁЯЖЦ, NG, NG ркЪрк┐рк╣рлНрки, ркЪрк┐рк╣рлНрки
ЁЯЕ╛ => ЁЯЕ╛, рккрлНрк░ркХрк╛рк░ O, рк▓рлЛрк╣рлАркирлЛ рккрлНрк░ркХрк╛рк░, рк▓рлЛрк╣рлА, O
ЁЯЖЧ => ЁЯЖЧ, ркСркХрлЗ
ЁЯЕ┐ => ЁЯЕ┐, рккрк╛рк░рлНркХрк┐ркВркЧ
ЁЯЖШ => ЁЯЖШ, SOS, SOS ркирлБркВ ркЪрк┐рк╣рлНрки, ркоркжркж, ркЪрк┐рк╣рлНрки
ЁЯЖЩ => ЁЯЖЩ, UP!, UP! ркЪрк┐рк╣рлНрки, ркЪрк┐рк╣рлНрки
ЁЯЖЪ => ЁЯЖЪ, рк╡рк┐рк░рлБркжрлНркз, рк╡рк┐., ркЪрк┐рк╣рлНрки
ЁЯИБ => ЁЯИБ, ркЬрк╛рккрк╛ркирлА рк╢ркмрлНркж
ЁЯИВ => ЁЯИВ, ркЬрк╛рккрк╛ркирлА рк╢ркмрлНркж
ЁЯИ╖ => ЁЯИ╖, ркЬрк╛рккрк╛ркирлА рк╢ркмрлНркж
ЁЯИ╢ => ЁЯИ╢, ркЬрк╛рккрк╛ркирлА рк╢ркмрлНркж
ЁЯИп => ЁЯИп, ркЬрк╛рккрк╛ркирлА рк╢ркмрлНркж
ЁЯЙР => ЁЯЙР, ркЬрк╛рккрк╛ркирлА рк╢ркмрлНркж
ЁЯИ╣ => ЁЯИ╣, ркЬрк╛рккрк╛ркирлА рк╢ркмрлНркж
ЁЯИЪ => ЁЯИЪ, ркЬрк╛рккрк╛ркирлА рк╢ркмрлНркж
ЁЯИ▓ => ЁЯИ▓, ркЬрк╛рккрк╛ркирлА рк╢ркмрлНркж
ЁЯЙС => ЁЯЙС, ркЪрлАркирлА рк╢ркмрлНркж
ЁЯИ╕ => ЁЯИ╕, ркЪрлАркирлА рк╢ркмрлНркж
ЁЯИ┤ => ЁЯИ┤, ркЪрлАркирлА рк╢ркмрлНркж
ЁЯИ│ => ЁЯИ│, ркЪрлАркирлА рк╢ркмрлНркж
уКЧ => уКЧ, ркЪрлАркирлА' ркЕркнрк┐ркиркВркжрки, ркЖркЗркбрк┐ркпрлЛркЧрлНрк░рк╛ркл
уКЩ => уКЩ, ркЧрлБрккрлНркд, ркЪрлАркирлА, ркЖркЗркбрк┐ркпрлЛркЧрлНрк░рк╛ркл
ЁЯИ║ => ЁЯИ║, ркЪрлАркирлА рк╢ркмрлНркж
ЁЯИ╡ => ЁЯИ╡, ркЪрлАркирлА рк╢ркмрлНркж
тЦк => тЦк, ркнрлМркорк┐ркдрк┐ркХ, ркЪрлЛрк░рк╕
тЦл => тЦл, ркнрлМркорк┐ркдрк┐ркХ, ркЪрлЛрк░рк╕
тЧ╗ => тЧ╗, ркнрлМркорк┐ркдрк┐ркХ, ркЪрлЛрк░рк╕
тЧ╝ => тЧ╝, ркнрлМркорк┐ркдрк┐ркХ, ркЪрлЛрк░рк╕
тЧ╜ => тЧ╜, ркнрлМркорк┐ркдрк┐ркХ, ркЪрлЛрк░рк╕
тЧ╛ => тЧ╛, ркнрлМркорк┐ркдрк┐ркХ, ркЪрлЛрк░рк╕
тмЫ => тмЫ, ркнрлМркорк┐ркдрк┐ркХ, ркЪрлЛрк░рк╕
тмЬ => тмЬ, ркнрлМркорк┐ркдрк┐ркХ, ркЪрлЛрк░рк╕
ЁЯФ╢ => ЁЯФ╢, ркорлЛркЯрлЛ рк╣рлАрк░рлЛ, ркирк╛рк░ркВркЧрлА, рк╣рлАрк░рлЛ
ЁЯФ╖ => ЁЯФ╖, ркорлЛркЯрлЛ рк╣рлАрк░рлЛ, рк╡рк╛ркжрк│рлА, рк╣рлАрк░рлЛ
ЁЯФ╕ => ЁЯФ╕, ркирк╛ркирлЛ рк╣рлАрк░рлЛ, ркирк╛рк░ркВркЧрлА, рк╣рлАрк░рлЛ
ЁЯФ╣ => ЁЯФ╣, ркирк╛ркирлЛ рк╣рлАрк░рлЛ, рк╡рк╛ркжрк│рлА, рк╣рлАрк░рлЛ
ЁЯФ║ => ЁЯФ║, ркЙрккрк░ ркдрлНрк░рк┐ркХрлЛркг, ркдрлНрк░рк┐ркХрлЛркг
ЁЯФ╗ => ЁЯФ╗, ркирлАркЪрлЗ ркдрлНрк░рк┐ркХрлЛркг, ркдрлНрк░рк┐ркХрлЛркг
ЁЯТа => ЁЯТа, рккрлБрк╖рлНрккркирлА рккрк╛ркВркЦркбрлА, рк╕рлБркВркжрк░, рккрлБрк╖рлНркк, ркбрк╛ркпркоркВркб, рк▓рк╛ркЧркгрлА
ЁЯФШ => ЁЯФШ, ркмркЯрки, рк░рлЗркбрк┐ркУ
ЁЯФ▓ => ЁЯФ▓, ркЪрлЛрк░рк╕ ркмркЯрки, ркЪрлЛрк░рк╕, ркмркЯрки
ЁЯФ│ => ЁЯФ│, ркЪрлЛрк░рк╕ ркмркЯрки, ркЪрлЛрк░рк╕, ркмркЯрки
тЪк => тЪк, ркЧрлЛрк│, ркнрлМркорк┐ркдрк┐ркХ
тЪл => тЪл, ркЧрлЛрк│, ркнрлМркорк┐ркдрк┐ркХ
ЁЯФ┤ => ЁЯФ┤, ркорлЛркЯрлБркВ рк╡рк░рлНркдрлБрк│, ркорлЛркЯрлБркВ рк▓рк╛рк▓ рк╡рк░рлНркдрлБрк│, рк▓рк╛рк▓, рк╡рк░рлНркдрлБрк│
ЁЯФ╡ => ЁЯФ╡, ркорлЛркЯрлБркВ рк╡рк░рлНркдрлБрк│, ркорлЛркЯрлБркВ рк╡рк╛ркжрк│рлА рк╡рк░рлНркдрлБрк│, рк╡рк╛ркжрк│рлА, рк╡рк░рлНркдрлБрк│
ЁЯЫС => ЁЯЫС, ркЕрк╖рлНркЯркХрлЛркг, рк╕ркВркХрлЗркд, рк░рлЛркХрлЛ
ЁЯЫТ => ЁЯЫТ, рк╢рлЙрккрк┐ркВркЧ, ркХрк╛рк░рлНркЯ, ркЯрлНрк░рлЙрк▓рлА, рк╢рлЙрккрк┐ркВркЧ
ЁЯЫ┤ => ЁЯЫ┤, рк╕рлНркХрлВркЯрк░, ркХрк┐ркХ
ЁЯЫ╡ => ЁЯЫ╡, ркорлЛркЯрк░, рк╕рлНркХрлВркЯрк░
ЁЯЫ╢ => ЁЯЫ╢, ркХрлЕркирлЛркИ, рк╣рлЛркбрлА
0тГг => 0тГг, рк╢рлВркирлНркп
1тГг => 1тГг, 1, ркПркХ, ркХрлАркХрлЕркк
2тГг => 2тГг, 2, ркмрлЗ, ркХрлАркХрлЕркк
3тГг => 3тГг, 3, ркдрлНрк░ркг, ркХрлАркХрлЕркк
4тГг => 4тГг, 4, ркЪрк╛рк░, ркХрлАркХрлЕркк
5тГг => 5тГг, 5, ркХрлАркХрлЕркк, рккрк╛ркВркЪ
6тГг => 6тГг, 6, ркЫ, ркХрлАркХрлЕркк
7тГг => 7тГг, 7, ркХрлАркХрлЕркк, рк╕рк╛ркд
8тГг => 8тГг, 8, ркЖрка, ркХрлАркХрлЕркк
9тГг => 9тГг, 9, ркХрлАркк, ркирк╡
ЁЯЗжЁЯЗи => ЁЯЗжЁЯЗи, ркПрк╕рлЗркирлНрк╢рки ркЖркЗрк▓рлЗркирлНркб
ЁЯЗжЁЯЗй => ЁЯЗжЁЯЗй, ркНркВркбрлЛрк░рк╛
ЁЯЗжЁЯЗк => ЁЯЗжЁЯЗк, ркпрлБркирк╛ркЗркЯрлЗркб ркЖрк░ркм ркЕркорлАрк░рк╛ркд
ЁЯЗжЁЯЗл => ЁЯЗжЁЯЗл, ркЕрклркШрк╛ркирк┐рк╕рлНркдрк╛рки
ЁЯЗжЁЯЗм => ЁЯЗжЁЯЗм, ркПркирлНркЯрлАркЧрлБркЖ ркЕркирлЗ ркмрк░рлНркорлБркбрк╛
ЁЯЗжЁЯЗо => ЁЯЗжЁЯЗо, ркНркВркЧрлНрк╡рк┐рк▓рк╛
ЁЯЗжЁЯЗ▒ => ЁЯЗжЁЯЗ▒, ркЕрк▓рлНркмрлЗркирк┐ркпрк╛
ЁЯЗжЁЯЗ▓ => ЁЯЗжЁЯЗ▓, ркЖрк░рлНркорлЗркирк┐ркпрк╛
ЁЯЗжЁЯЗ┤ => ЁЯЗжЁЯЗ┤, ркЕркВркЧрлЛрк▓рк╛
ЁЯЗжЁЯЗ╢ => ЁЯЗжЁЯЗ╢, ркПркирлНркЯрк╛рк░рлНркХркЯрк┐ркХрк╛
ЁЯЗжЁЯЗ╖ => ЁЯЗжЁЯЗ╖, ркЖрк░рлНркЬрлЗркирлНркЯрлАркирк╛
ЁЯЗжЁЯЗ╕ => ЁЯЗжЁЯЗ╕, ркЕркорлЗрк░рлАркХрки рк╕ркорлЛркЖ
ЁЯЗжЁЯЗ╣ => ЁЯЗжЁЯЗ╣, ркСрк╕рлНркЯрлНрк░рк┐ркпрк╛
ЁЯЗжЁЯЗ║ => ЁЯЗжЁЯЗ║, ркСрк╕рлНркЯрлНрк░рлЗрк▓рк┐ркпрк╛
ЁЯЗжЁЯЗ╝ => ЁЯЗжЁЯЗ╝, ркЕрк░рлБркмрк╛
ЁЯЗжЁЯЗ╜ => ЁЯЗжЁЯЗ╜, ркПрк▓рлЗркВркб ркЯрк╛рккрлБркУ
ЁЯЗжЁЯЗ┐ => ЁЯЗжЁЯЗ┐, ркЕркЭрк░ркмрлИркЬрк╛рки
ЁЯЗзЁЯЗж => ЁЯЗзЁЯЗж, ркмрлЛрк╕рлНркирк┐ркпрк╛ ркЕркирлЗ рк╣рк░рлНркЭрлЗркЧрлЛрк╡рк┐ркирк╛
ЁЯЗзЁЯЗз => ЁЯЗзЁЯЗз, ркмрк╛рк░рлНркмрк╛ркбрлЛрк╕
ЁЯЗзЁЯЗй => ЁЯЗзЁЯЗй, ркмрк╛ркВркЧрлНрк▓рк╛ркжрлЗрк╢
ЁЯЗзЁЯЗк => ЁЯЗзЁЯЗк, ркмрлЗрк▓рлНркЬрлАркпрко
ЁЯЗзЁЯЗл => ЁЯЗзЁЯЗл, ркмрлБрк░рлНркХрк┐ркирк╛ рклрк╛рк╕рлЛ
ЁЯЗзЁЯЗм => ЁЯЗзЁЯЗм, ркмрк▓рлНркЧрлЗрк░рк┐ркпрк╛
ЁЯЗзЁЯЗн => ЁЯЗзЁЯЗн, ркмрлЗрк╣рк░рлАрки
ЁЯЗзЁЯЗо => ЁЯЗзЁЯЗо, ркмрлБрк░рлБркВркбрлА
ЁЯЗзЁЯЗп => ЁЯЗзЁЯЗп, ркмрлЗркирк┐рки
ЁЯЗзЁЯЗ▒ => ЁЯЗзЁЯЗ▒, рк╕рлЗркирлНркЯ ркмрк╛рк░рлНркерлЗрк▓рлЗркорлА
ЁЯЗзЁЯЗ▓ => ЁЯЗзЁЯЗ▓, ркмрк░рлНркорлБркбрк╛
ЁЯЗзЁЯЗ│ => ЁЯЗзЁЯЗ│, ркмрлНрк░рлБркирлЗркЗ
ЁЯЗзЁЯЗ┤ => ЁЯЗзЁЯЗ┤, ркмрлЛрк▓рк┐рк╡рк┐ркпрк╛
ЁЯЗзЁЯЗ╢ => ЁЯЗзЁЯЗ╢, ркХрлЗрк░рлЗркмрк┐ркпрки ркирлЗркзрк░рк▓рлЗркирлНркбрлНркЭ
ЁЯЗзЁЯЗ╖ => ЁЯЗзЁЯЗ╖, ркмрлНрк░рк╛ркЭрк┐рк▓
ЁЯЗзЁЯЗ╕ => ЁЯЗзЁЯЗ╕, ркмрк╣рк╛ркорк╛рк╕
ЁЯЗзЁЯЗ╣ => ЁЯЗзЁЯЗ╣, ркнрлВркЯрк╛рки
ЁЯЗзЁЯЗ╗ => ЁЯЗзЁЯЗ╗, ркмрлМрк╡рлЗркд ркЖркЗрк▓рлЗркирлНркб
ЁЯЗзЁЯЗ╝ => ЁЯЗзЁЯЗ╝, ркмрлЛркдрлНрк╕рлНрк╡рк╛ркирк╛
ЁЯЗзЁЯЗ╛ => ЁЯЗзЁЯЗ╛, ркмрлЗрк▓рк╛рк░рлБрк╕
ЁЯЗзЁЯЗ┐ => ЁЯЗзЁЯЗ┐, ркмрлЗрк▓рлАркЭ
ЁЯЗиЁЯЗж => ЁЯЗиЁЯЗж, ркХрлЗркирлЗркбрк╛
ЁЯЗиЁЯЗи => ЁЯЗиЁЯЗи, ркХрлЛркХрлЛркЭ (ркХрлАрк▓рлАркВркЧ) ркЖркЗрк▓рлЗркирлНркбрлНрк╕
ЁЯЗиЁЯЗй => ЁЯЗиЁЯЗй, ркХрлЛркВркЧрлЛ - ркХрк┐ркВрк╢рк╛рк╕рк╛
ЁЯЗиЁЯЗл => ЁЯЗиЁЯЗл, рк╕рлЗркирлНркЯрлНрк░рк▓ ркЖрклрлНрк░рк┐ркХрки рк░рлАрккркмрлНрк▓рк┐ркХ
ЁЯЗиЁЯЗм => ЁЯЗиЁЯЗм, ркХрлЛркВркЧрлЛ - ркмрлНрк░рк╛ркЭрк╛рк╡рк┐рк▓рлЗ
ЁЯЗиЁЯЗн => ЁЯЗиЁЯЗн, рк╕рлНрк╡рк┐ркЯрлНркЭрк░рлНрк▓рлЕркирлНркб
ЁЯЗиЁЯЗо => ЁЯЗиЁЯЗо, ркХрлЛркЯ ркбрлА ркЖркЗрк╡рк░рлА
ЁЯЗиЁЯЗ░ => ЁЯЗиЁЯЗ░, ркХрлБркХ ркЖркЗрк▓рлЗркирлНркбрлНрк╕
ЁЯЗиЁЯЗ▒ => ЁЯЗиЁЯЗ▒, ркЪрк┐рк▓рлА
ЁЯЗиЁЯЗ▓ => ЁЯЗиЁЯЗ▓, ркХрлЕркорк░рлВрки
ЁЯЗиЁЯЗ│ => ЁЯЗиЁЯЗ│, ркЪрлАрки
ЁЯЗиЁЯЗ┤ => ЁЯЗиЁЯЗ┤, ркХрлЛрк▓ркорлНркмрк┐ркпрк╛
ЁЯЗиЁЯЗ╡ => ЁЯЗиЁЯЗ╡, ркХрлНрк▓рк┐рккрк░ркЯрки ркЖркЗрк▓рлЗркирлНркб
ЁЯЗиЁЯЗ╖ => ЁЯЗиЁЯЗ╖, ркХрлЛрк╕рлНркЯрк╛ рк░рк┐ркХрк╛
ЁЯЗиЁЯЗ║ => ЁЯЗиЁЯЗ║, ркХрлНркпрлБркмрк╛
ЁЯЗиЁЯЗ╗ => ЁЯЗиЁЯЗ╗, ркХрлЕркк рк╡рк░рлНркбрлЗ
ЁЯЗиЁЯЗ╝ => ЁЯЗиЁЯЗ╝, ркХрлНркпрлБрк░рк╛рк╕рк╛ркУ
ЁЯЗиЁЯЗ╜ => ЁЯЗиЁЯЗ╜, ркХрлНрк░рк┐рк╕ркорк╕ ркЖркЗрк▓рлЗркирлНркб
ЁЯЗиЁЯЗ╛ => ЁЯЗиЁЯЗ╛, рк╕рк╛ркпрккрлНрк░рк╕
ЁЯЗиЁЯЗ┐ => ЁЯЗиЁЯЗ┐, ркЪрлЗркХ рк░рлАрккркмрлНрк▓рк┐ркХ
ЁЯЗйЁЯЗк => ЁЯЗйЁЯЗк, ркЬрк░рлНркоркирлА
ЁЯЗйЁЯЗм => ЁЯЗйЁЯЗм, ркбрк┐ркПркЧрлЛ ркЧрк╛рк░рк╕рк┐ркЖ
ЁЯЗйЁЯЗп => ЁЯЗйЁЯЗп, ркЬрлАркмрлМркЯрлА
ЁЯЗйЁЯЗ░ => ЁЯЗйЁЯЗ░, ркбрлЗркиркорк╛рк░рлНркХ
ЁЯЗйЁЯЗ▓ => ЁЯЗйЁЯЗ▓, ркбрлЛркорк┐ркирк┐ркХрк╛
ЁЯЗйЁЯЗ┤ => ЁЯЗйЁЯЗ┤, ркбрлЛркорк┐ркирк┐ркХрки рк░рлАрккркмрлНрк▓рк┐ркХ
ЁЯЗйЁЯЗ┐ => ЁЯЗйЁЯЗ┐, ркЕрк▓рлНркЬрлАрк░рк┐ркпрк╛
ЁЯЗкЁЯЗж => ЁЯЗкЁЯЗж, рк╕рлНркпрлБркЯрк╛ ркЕркирлЗ ркорлЗрк▓рк┐рк▓рк╛
ЁЯЗкЁЯЗи => ЁЯЗкЁЯЗи, ркПркХрлНрк╡рк╛ркбрлЛрк░
ЁЯЗкЁЯЗк => ЁЯЗкЁЯЗк, ркПрк╕рлНркЯрлЛркирк┐ркпрк╛
ЁЯЗкЁЯЗм => ЁЯЗкЁЯЗм, ркЗркЬрк┐рккрлНркд
ЁЯЗкЁЯЗн => ЁЯЗкЁЯЗн, рккрк╢рлНркЪрк┐ркорлА рк╕рк╣рк╛рк░рк╛
ЁЯЗкЁЯЗ╖ => ЁЯЗкЁЯЗ╖, ркПрк░рк┐ркЯрлНрк░рк┐ркпрк╛
ЁЯЗкЁЯЗ╕ => ЁЯЗкЁЯЗ╕, рк╕рлНрккрлЗрки
ЁЯЗкЁЯЗ╣ => ЁЯЗкЁЯЗ╣, ркЗркерк┐ркУрккрк┐ркпрк╛
ЁЯЗкЁЯЗ║ => ЁЯЗкЁЯЗ║, ркпрлБрк░рлЛрккрк┐ркпрки рк╕ркВркШ
ЁЯЗлЁЯЗо => ЁЯЗлЁЯЗо, рклрк┐ркирк▓рлЗркирлНркб
ЁЯЗлЁЯЗп => ЁЯЗлЁЯЗп, рклрлАркЬрлА
ЁЯЗлЁЯЗ░ => ЁЯЗлЁЯЗ░, рклрлЙркХрк▓рлЗркирлНркб ркЯрк╛рккрлБркУ
ЁЯЗлЁЯЗ▓ => ЁЯЗлЁЯЗ▓, ркорк╛ркЗркХрлНрк░рлЛркирлЗрк╢рк┐ркпрк╛
ЁЯЗлЁЯЗ┤ => ЁЯЗлЁЯЗ┤, рклрлЕрк░рлЛ ркЯрк╛рккрлБркУ
ЁЯЗлЁЯЗ╖ => ЁЯЗлЁЯЗ╖, рклрлНрк░рк╛ркВрк╕
ЁЯЗмЁЯЗж => ЁЯЗмЁЯЗж, ркЧрлЗркмрки
ЁЯЗмЁЯЗз => ЁЯЗмЁЯЗз, ркпрлБркирк╛ркЗркЯрлЗркб ркХрк┐ркВркЧркбрко
ЁЯЗмЁЯЗй => ЁЯЗмЁЯЗй, ркЧрлНрк░рлЗркирлЗркбрк╛
ЁЯЗмЁЯЗк => ЁЯЗмЁЯЗк, ркЬрлНркпрлЛрк░рлНркЬрлАркпрк╛
ЁЯЗмЁЯЗл => ЁЯЗмЁЯЗл, рклрлНрк░рлЗркВркЪ ркЧркпрк╛ркирк╛
ЁЯЗмЁЯЗм => ЁЯЗмЁЯЗм, ркЧрлНрк╡рлЗрк░рлНркирк╕рлЗ
ЁЯЗмЁЯЗн => ЁЯЗмЁЯЗн, ркШрк╛ркирк╛
ЁЯЗмЁЯЗо => ЁЯЗмЁЯЗо, ркЬрлАркмрлНрк░рк╛рк▓рлНркЯрк░
ЁЯЗмЁЯЗ▒ => ЁЯЗмЁЯЗ▒, ркЧрлНрк░рлАркирк▓рлЗркирлНркб
ЁЯЗмЁЯЗ▓ => ЁЯЗмЁЯЗ▓, ркЧрлЗркорлНркмрк┐ркпрк╛
ЁЯЗмЁЯЗ│ => ЁЯЗмЁЯЗ│, ркЧрк┐ркирлА
ЁЯЗмЁЯЗ╡ => ЁЯЗмЁЯЗ╡, ркЧрлНрк╡рк╛ркбрлЗрк▓рлЛркк
ЁЯЗмЁЯЗ╢ => ЁЯЗмЁЯЗ╢, ркЗркХрлНрк╡рлЗркЯрлЛрк░рк┐ркпрк▓ ркЧрк┐ркирлА
ЁЯЗмЁЯЗ╖ => ЁЯЗмЁЯЗ╖, ркЧрлНрк░рлАрк╕
ЁЯЗмЁЯЗ╕ => ЁЯЗмЁЯЗ╕, ркжркХрлНрк╖рк┐ркг ркЬрлНркпрлЛрк░рлНркЬрлАркпрк╛ ркЕркирлЗ ркжркХрлНрк╖рк┐ркг рк╕рлЗркирлНркбрк╡рк┐ркЪ ркЖркЗрк▓рлЗркирлНркбрлНрк╕
ЁЯЗмЁЯЗ╣ => ЁЯЗмЁЯЗ╣, ркЧрлНрк╡рк╛ркЯрлЗркорк╛рк▓рк╛
ЁЯЗмЁЯЗ║ => ЁЯЗмЁЯЗ║, ркЧрлНрк╡рк╛рко
ЁЯЗмЁЯЗ╝ => ЁЯЗмЁЯЗ╝, ркЧрк┐ркирлА-ркмрк┐рк╕рк╛ркЙ
ЁЯЗмЁЯЗ╛ => ЁЯЗмЁЯЗ╛, ркЧркпрк╛ркирк╛
ЁЯЗнЁЯЗ░ => ЁЯЗнЁЯЗ░, рк╣рлЛркВркЧркХрлЛркВркЧ sar ркЪрлАрки
ЁЯЗнЁЯЗ▓ => ЁЯЗнЁЯЗ▓, рк╣рк░рлНркб ркЕркирлЗ ркорлЗркХркбрлЛркирк╛рк▓рлНркб ркЖркЗрк▓рлЗркирлНркбрлНрк╕
ЁЯЗнЁЯЗ│ => ЁЯЗнЁЯЗ│, рк╣рлЛркирлНркбрлБрк░рк╕
ЁЯЗнЁЯЗ╖ => ЁЯЗнЁЯЗ╖, ркХрлНрк░рлЛркПрк╢рк┐ркпрк╛
ЁЯЗнЁЯЗ╣ => ЁЯЗнЁЯЗ╣, рк╣рлИркдрк┐
ЁЯЗнЁЯЗ║ => ЁЯЗнЁЯЗ║, рк╣ркВркЧрлЗрк░рлА
ЁЯЗоЁЯЗи => ЁЯЗоЁЯЗи, ркХрлЕркирлЗрк░рлА ркЯрк╛рккрлБркУ
ЁЯЗоЁЯЗй => ЁЯЗоЁЯЗй, ркЗркирлНркбрлЛркирлЗрк╢рк┐ркпрк╛
ЁЯЗоЁЯЗк => ЁЯЗоЁЯЗк, ркЖркпрк░рлНрк▓рлЗркирлНркб
ЁЯЗоЁЯЗ▒ => ЁЯЗоЁЯЗ▒, ркЗркЭрк░рк╛ркЗрк▓
ЁЯЗоЁЯЗ▓ => ЁЯЗоЁЯЗ▓, ркЖркИрк▓ ркУркл ркорлЕрки
ЁЯЗоЁЯЗ│ => ЁЯЗоЁЯЗ│, ркнрк╛рк░ркд
ЁЯЗоЁЯЗ┤ => ЁЯЗоЁЯЗ┤, ркмрлНрк░рк┐ркЯрк┐рк╢ ркЗркирлНркбрк┐ркпрки ркУрк╢рки ркЯрлЗрк░рк┐ркЯрк░рлА
ЁЯЗоЁЯЗ╢ => ЁЯЗоЁЯЗ╢, ркЗрк░рк╛ркХ
ЁЯЗоЁЯЗ╖ => ЁЯЗоЁЯЗ╖, ркИрк░рк╛рки
ЁЯЗоЁЯЗ╕ => ЁЯЗоЁЯЗ╕, ркЖркЗрк╕рк▓рлЗркирлНркб
ЁЯЗоЁЯЗ╣ => ЁЯЗоЁЯЗ╣, ркЗркЯрк╛рк▓рлА
ЁЯЗпЁЯЗк => ЁЯЗпЁЯЗк, ркЬрк░рлНрк╕рлА
ЁЯЗпЁЯЗ▓ => ЁЯЗпЁЯЗ▓, ркЬркорлИркХрк╛
ЁЯЗпЁЯЗ┤ => ЁЯЗпЁЯЗ┤, ркЬрлЛрк░рлНркбрки
ЁЯЗпЁЯЗ╡ => ЁЯЗпЁЯЗ╡, ркЬрк╛рккрк╛рки
ЁЯЗ░ЁЯЗк => ЁЯЗ░ЁЯЗк, ркХрлЗркирлНркпрк╛
ЁЯЗ░ЁЯЗм => ЁЯЗ░ЁЯЗм, ркХрк┐рк░рлНркЧрк┐ркЭрлНрк╕рлНркдрк╛рки
ЁЯЗ░ЁЯЗн => ЁЯЗ░ЁЯЗн, ркХркВркмрлЛркбрк┐ркпрк╛
ЁЯЗ░ЁЯЗо => ЁЯЗ░ЁЯЗо, ркХрк┐рк░рк┐ркмрк╛ркЯрлА
ЁЯЗ░ЁЯЗ▓ => ЁЯЗ░ЁЯЗ▓, ркХрлЛркорлЛрк░рк╕
ЁЯЗ░ЁЯЗ│ => ЁЯЗ░ЁЯЗ│, рк╕рлЗркирлНркЯ ркХрк┐ркЯрлНрк╕ ркЕркирлЗ ркирлЗрк╡рк┐рк╕
ЁЯЗ░ЁЯЗ╡ => ЁЯЗ░ЁЯЗ╡, ркЙркдрлНркдрк░ ркХрлЛрк░рк┐ркпрк╛
ЁЯЗ░ЁЯЗ╖ => ЁЯЗ░ЁЯЗ╖, ркжркХрлНрк╖рк┐ркг ркХрлЛрк░рк┐ркпрк╛
ЁЯЗ░ЁЯЗ╝ => ЁЯЗ░ЁЯЗ╝, ркХрлБрк╡рлИркд
ЁЯЗ░ЁЯЗ╛ => ЁЯЗ░ЁЯЗ╛, ркХрлЗркорлЗрки ркЯрк╛рккрлБркУ
ЁЯЗ░ЁЯЗ┐ => ЁЯЗ░ЁЯЗ┐, ркХркЭрк╛ркХрк┐рк╕рлНркдрк╛рки
ЁЯЗ▒ЁЯЗж => ЁЯЗ▒ЁЯЗж, рк▓рк╛ркУрк╕
ЁЯЗ▒ЁЯЗз => ЁЯЗ▒ЁЯЗз, рк▓рлЗркмркирлЛрки
ЁЯЗ▒ЁЯЗи => ЁЯЗ▒ЁЯЗи, рк╕рлЗркирлНркЯ рк▓рлБрк╕рк┐ркпрк╛
ЁЯЗ▒ЁЯЗо => ЁЯЗ▒ЁЯЗо, рк▓рлИркЪркЯрлЗркВрк╕рлНркЯрлЗркЗрки
ЁЯЗ▒ЁЯЗ░ => ЁЯЗ▒ЁЯЗ░, рк╢рлНрк░рлАрк▓ркВркХрк╛
ЁЯЗ▒ЁЯЗ╖ => ЁЯЗ▒ЁЯЗ╖, рк▓рк╛ркЗркмрлЗрк░рк┐ркпрк╛
ЁЯЗ▒ЁЯЗ╕ => ЁЯЗ▒ЁЯЗ╕, рк▓рлЗрк╕рлЛркерлЛ
ЁЯЗ▒ЁЯЗ╣ => ЁЯЗ▒ЁЯЗ╣, рк▓рк┐ркерлБркЖркирк┐ркпрк╛
ЁЯЗ▒ЁЯЗ║ => ЁЯЗ▒ЁЯЗ║, рк▓ркХрлНркЭркоркмрк░рлНркЧ
ЁЯЗ▒ЁЯЗ╗ => ЁЯЗ▒ЁЯЗ╗, рк▓рк╛ркдрлНрк╡рк┐ркпрк╛
ЁЯЗ▒ЁЯЗ╛ => ЁЯЗ▒ЁЯЗ╛, рк▓рк┐ркмрк┐ркпрк╛
ЁЯЗ▓ЁЯЗж => ЁЯЗ▓ЁЯЗж, ркорлЛрк░рлЛркХрлНркХрлЛ
ЁЯЗ▓ЁЯЗи => ЁЯЗ▓ЁЯЗи, ркорлЛркирк╛ркХрлЛ
ЁЯЗ▓ЁЯЗй => ЁЯЗ▓ЁЯЗй, ркорлЛрк▓ркбрлЛрк╡рк╛
ЁЯЗ▓ЁЯЗк => ЁЯЗ▓ЁЯЗк, ркорлЙркирлНркЯрлЗркВркирлЗркЧрлНрк░рлЛ
ЁЯЗ▓ЁЯЗл => ЁЯЗ▓ЁЯЗл, рк╕рлЗркирлНркЯ ркорк╛рк░рлНркЯрк┐рки
ЁЯЗ▓ЁЯЗм => ЁЯЗ▓ЁЯЗм, ркорлЗркбрк╛ркЧрк╛рк╕рлНркХрк░
ЁЯЗ▓ЁЯЗн => ЁЯЗ▓ЁЯЗн, ркорк╛рк░рлНрк╢рк▓ ркЖркЗрк▓рлЗркирлНркбрлНрк╕
ЁЯЗ▓ЁЯЗ░ => ЁЯЗ▓ЁЯЗ░, ркорлЗрк╕рлЗркбрлЛркирк┐ркпрк╛
ЁЯЗ▓ЁЯЗ▒ => ЁЯЗ▓ЁЯЗ▒, ркорк╛рк▓рлА
ЁЯЗ▓ЁЯЗ▓ => ЁЯЗ▓ЁЯЗ▓, ркорлНркпрк╛ркВркорк╛рк░ (ркмрк░рлНркорк╛)
ЁЯЗ▓ЁЯЗ│ => ЁЯЗ▓ЁЯЗ│, ркоркВркЧрлЛрк▓рк┐ркпрк╛
ЁЯЗ▓ЁЯЗ┤ => ЁЯЗ▓ЁЯЗ┤, ркоркХрк╛ркЙ sar ркЪрлАрки
ЁЯЗ▓ЁЯЗ╡ => ЁЯЗ▓ЁЯЗ╡, ркЙркдрлНркдрк░рлАркп ркорк╛рк░рк┐ркпрк╛ркирк╛ ркЖркЗрк▓рлЗркирлНркбрлНрк╕
ЁЯЗ▓ЁЯЗ╢ => ЁЯЗ▓ЁЯЗ╢, ркорк╛рк░рлНркЯрлАркирлАркХ
ЁЯЗ▓ЁЯЗ╖ => ЁЯЗ▓ЁЯЗ╖, ркорлМрк░рк┐ркЯрк╛ркирк┐ркпрк╛
ЁЯЗ▓ЁЯЗ╕ => ЁЯЗ▓ЁЯЗ╕, ркорлЛркВркЯрк╕рлЗрк░рк╛ркд
ЁЯЗ▓ЁЯЗ╣ => ЁЯЗ▓ЁЯЗ╣, ркорк╛рк▓рлНркЯрк╛
ЁЯЗ▓ЁЯЗ║ => ЁЯЗ▓ЁЯЗ║, ркорлЛрк░рк┐рк╢рк┐ркпрк╕
ЁЯЗ▓ЁЯЗ╗ => ЁЯЗ▓ЁЯЗ╗, ркорк╛рк▓ркжрк┐рк╡рлНрк╕
ЁЯЗ▓ЁЯЗ╝ => ЁЯЗ▓ЁЯЗ╝, ркорк╛рк▓рк╛рк╡рлА
ЁЯЗ▓ЁЯЗ╜ => ЁЯЗ▓ЁЯЗ╜, ркорлЗркХрлНрк╕рк┐ркХрлЛ
ЁЯЗ▓ЁЯЗ╛ => ЁЯЗ▓ЁЯЗ╛, ркорк▓рлЗрк╢рк┐ркпрк╛
ЁЯЗ▓ЁЯЗ┐ => ЁЯЗ▓ЁЯЗ┐, ркорлЛркЭрк╛ркорлНркмрк┐ркХ
ЁЯЗ│ЁЯЗж => ЁЯЗ│ЁЯЗж, ркирк╛ркорк┐ркмрк┐ркпрк╛
ЁЯЗ│ЁЯЗи => ЁЯЗ│ЁЯЗи, ркирлНркпрлБ рк╕рлЗрк▓рлЗркбрлЛркирк┐ркпрк╛
ЁЯЗ│ЁЯЗк => ЁЯЗ│ЁЯЗк, ркирк╛ркЗркЬрк░
ЁЯЗ│ЁЯЗл => ЁЯЗ│ЁЯЗл, ркирлЛрк░рклрлЙркХ ркЯрк╛рккрлБ
ЁЯЗ│ЁЯЗм => ЁЯЗ│ЁЯЗм, ркирк╛ркЗркЬрлАрк░рлАркпрк╛
ЁЯЗ│ЁЯЗо => ЁЯЗ│ЁЯЗо, ркирк┐ркХрк╛рк░рк╛ркЧрлБркЖ
ЁЯЗ│ЁЯЗ▒ => ЁЯЗ│ЁЯЗ▒, ркирлЗркзрк░рк▓рлЗркирлНркб
ЁЯЗ│ЁЯЗ┤ => ЁЯЗ│ЁЯЗ┤, ркирлЙрк░рлНрк╡рлЗ
ЁЯЗ│ЁЯЗ╡ => ЁЯЗ│ЁЯЗ╡, ркирлЗрккрк╛рк│
ЁЯЗ│ЁЯЗ╖ => ЁЯЗ│ЁЯЗ╖, ркирлМрк░рлБ
ЁЯЗ│ЁЯЗ║ => ЁЯЗ│ЁЯЗ║, ркирлАркпрлБ
ЁЯЗ│ЁЯЗ┐ => ЁЯЗ│ЁЯЗ┐, ркирлНркпрлБркЭрлАрк▓рлЗркирлНркб
ЁЯЗ┤ЁЯЗ▓ => ЁЯЗ┤ЁЯЗ▓, ркУркорк╛рки
ЁЯЗ╡ЁЯЗж => ЁЯЗ╡ЁЯЗж, рккркирк╛ркорк╛
ЁЯЗ╡ЁЯЗк => ЁЯЗ╡ЁЯЗк, рккрлЗрк░рлБ
ЁЯЗ╡ЁЯЗл => ЁЯЗ╡ЁЯЗл, рклрлНрк░рлЗркВркЪ рккрлЛрк▓рк┐ркирлЗрк╢рк┐ркпрк╛
ЁЯЗ╡ЁЯЗм => ЁЯЗ╡ЁЯЗм, рккрк╛рккрлБркЖ ркирлНркпрлВ ркЧрк┐ркирлА
ЁЯЗ╡ЁЯЗн => ЁЯЗ╡ЁЯЗн, рклрк┐рк▓рлАрккрк╛ркЗркирлНрк╕
ЁЯЗ╡ЁЯЗ░ => ЁЯЗ╡ЁЯЗ░, рккрк╛ркХрк┐рк╕рлНркдрк╛рки
ЁЯЗ╡ЁЯЗ▒ => ЁЯЗ╡ЁЯЗ▒, рккрлЛрк▓рлЗркВркб
ЁЯЗ╡ЁЯЗ▓ => ЁЯЗ╡ЁЯЗ▓, рк╕рлЗркирлНркЯ рккрк┐ркпрк░ ркЕркирлЗ ркорлАркХрлНрк╡рлЗрк▓рки
ЁЯЗ╡ЁЯЗ│ => ЁЯЗ╡ЁЯЗ│, рккрлАркЯркХрлИрк░рлНрки ркЖркЗрк▓рлЗркирлНркбрлНрк╕
ЁЯЗ╡ЁЯЗ╖ => ЁЯЗ╡ЁЯЗ╖, рккрлНркпрлБркЕрк░рлНркЯрлЛ рк░рк┐ркХрлЛ
ЁЯЗ╡ЁЯЗ╕ => ЁЯЗ╡ЁЯЗ╕, рккрлЗрк▓рлЗрк╕рлНркЯрк┐ркирк┐ркпрки ркЯрлЗрк░рк┐ркЯрк░рлА
ЁЯЗ╡ЁЯЗ╣ => ЁЯЗ╡ЁЯЗ╣, рккрлЛрк░рлНркЯрлБркЧрк▓
ЁЯЗ╡ЁЯЗ╝ => ЁЯЗ╡ЁЯЗ╝, рккрк▓рк╛ркЙ
ЁЯЗ╡ЁЯЗ╛ => ЁЯЗ╡ЁЯЗ╛, рккрлЗрк░рк╛ркЧрлНрк╡рлЗ
ЁЯЗ╢ЁЯЗж => ЁЯЗ╢ЁЯЗж, ркХркдрк╛рк░
ЁЯЗ╢ЁЯЗ┤ => ЁЯЗ╢ЁЯЗ┤, ркЖркЙркЯрк▓рк╛ркИркирлНркЧ ркУрк╢ркирк┐ркпрк╛
ЁЯЗ╖ЁЯЗк => ЁЯЗ╖ЁЯЗк, рк░рлАркпрлБркирк┐ркпрки
ЁЯЗ╖ЁЯЗ┤ => ЁЯЗ╖ЁЯЗ┤, рк░рлЛркорк╛ркирк┐ркпрк╛
ЁЯЗ╖ЁЯЗ╕ => ЁЯЗ╖ЁЯЗ╕, рк╕рк░рлНркмрк┐ркпрк╛
ЁЯЗ╖ЁЯЗ║ => ЁЯЗ╖ЁЯЗ║, рк░рк╢рк┐ркпрк╛
ЁЯЗ╖ЁЯЗ╝ => ЁЯЗ╖ЁЯЗ╝, рк░рк╡рк╛ркВркбрк╛
ЁЯЗ╕ЁЯЗж => ЁЯЗ╕ЁЯЗж, рк╕рк╛ркЙркжрлА ркЕрк░рлЗркмрк┐ркпрк╛
ЁЯЗ╕ЁЯЗз => ЁЯЗ╕ЁЯЗз, рк╕рлЛрк▓рлЛркорки ркЖркЗрк▓рлЗркирлНркбрлНрк╕
ЁЯЗ╕ЁЯЗи => ЁЯЗ╕ЁЯЗи, рк╕рлЗрк╢рлЗрк▓рлНрк╕
ЁЯЗ╕ЁЯЗй => ЁЯЗ╕ЁЯЗй, рк╕рлБркжрк╛рки
ЁЯЗ╕ЁЯЗк => ЁЯЗ╕ЁЯЗк, рк╕рлНрк╡рлАркбрки
ЁЯЗ╕ЁЯЗм => ЁЯЗ╕ЁЯЗм, рк╕рк┐ркВркЧрк╛рккрлБрк░
ЁЯЗ╕ЁЯЗн => ЁЯЗ╕ЁЯЗн, рк╕рлЗркирлНркЯ рк╣рлЗрк▓рлЗркирк╛
ЁЯЗ╕ЁЯЗо => ЁЯЗ╕ЁЯЗо, рк╕рлНрк▓рлЛрк╡рлЗркирк┐ркпрк╛
ЁЯЗ╕ЁЯЗп => ЁЯЗ╕ЁЯЗп, рк╕рлНрк╡рк╛рк▓ркмрк░рлНркб ркЕркирлЗ ркЬрлЗрки ркорлЗркпрки
ЁЯЗ╕ЁЯЗ░ => ЁЯЗ╕ЁЯЗ░, рк╕рлНрк▓рлЛрк╡рлЗркХрк┐ркпрк╛
ЁЯЗ╕ЁЯЗ▒ => ЁЯЗ╕ЁЯЗ▒, рк╕рлАркПрк░рк╛ рк▓рлЗркУрки
ЁЯЗ╕ЁЯЗ▓ => ЁЯЗ╕ЁЯЗ▓, рк╕рлЕрки ркорлЗрк░рк┐ркирлЛ
ЁЯЗ╕ЁЯЗ│ => ЁЯЗ╕ЁЯЗ│, рк╕рлЗркирлЗркЧрк▓
ЁЯЗ╕ЁЯЗ┤ => ЁЯЗ╕ЁЯЗ┤, рк╕рлЛркорк╛рк▓рк┐ркпрк╛
ЁЯЗ╕ЁЯЗ╖ => ЁЯЗ╕ЁЯЗ╖, рк╕рлБрк░рлАркирк╛рко
ЁЯЗ╕ЁЯЗ╕ => ЁЯЗ╕ЁЯЗ╕, ркжркХрлНрк╖рк┐ркг рк╕рлБркжрк╛рки
ЁЯЗ╕ЁЯЗ╣ => ЁЯЗ╕ЁЯЗ╣, рк╕рк╛ркУ ркЯрлЙрко ркЕркирлЗ рккрлНрк░рк┐ркВрк╕рк┐рккрлЗ
ЁЯЗ╕ЁЯЗ╗ => ЁЯЗ╕ЁЯЗ╗, ркПрк▓ рк╕рлЗрк▓рлНрк╡рк╛ркбрлЛрк░
ЁЯЗ╕ЁЯЗ╜ => ЁЯЗ╕ЁЯЗ╜, рк╕рк┐ркВркЯ ркорк╛рк░рлНркЯрлЗрки
ЁЯЗ╕ЁЯЗ╛ => ЁЯЗ╕ЁЯЗ╛, рк╕рлАрк░рк┐ркпрк╛
ЁЯЗ╕ЁЯЗ┐ => ЁЯЗ╕ЁЯЗ┐, рк╕рлНрк╡рк╛ркЭрк┐рк▓рлЗркирлНркб
ЁЯЗ╣ЁЯЗж => ЁЯЗ╣ЁЯЗж, ркдрлНрк░рк┐рк╕рлНркдрк╛рки ркжрк╛ ркХрлБркирлНрк╣рк╛
ЁЯЗ╣ЁЯЗи => ЁЯЗ╣ЁЯЗи, ркдрлБрк░рлНркХрлНрк╕ ркЕркирлЗ ркХрк╛ркЗркХрлЛрк╕ ркЯрк╛рккрлБркУ
ЁЯЗ╣ЁЯЗй => ЁЯЗ╣ЁЯЗй, ркЪрк╛ркб
ЁЯЗ╣ЁЯЗл => ЁЯЗ╣ЁЯЗл, рклрлНрк░рлЗркВркЪ рк╕ркжрк░рлНрки ркЯрлЗрк░рк┐ркЯрк░рлАркЭ
ЁЯЗ╣ЁЯЗм => ЁЯЗ╣ЁЯЗм, ркЯрлЛркЧрлЛ
ЁЯЗ╣ЁЯЗн => ЁЯЗ╣ЁЯЗн, ркерк╛ркЗрк▓рлЗркВркб
ЁЯЗ╣ЁЯЗп => ЁЯЗ╣ЁЯЗп, ркдрк╛ркЬрлАркХрк┐рк╕рлНркдрк╛рки
ЁЯЗ╣ЁЯЗ░ => ЁЯЗ╣ЁЯЗ░, ркЯрлЛркХрлЗрк▓рк╛ркЙ
ЁЯЗ╣ЁЯЗ▒ => ЁЯЗ╣ЁЯЗ▒, ркдрк┐ркорлЛрк░-рк▓рлЗрк╕рлНркдрлЗ
ЁЯЗ╣ЁЯЗ▓ => ЁЯЗ╣ЁЯЗ▓, ркдрлБрк░рлНркХркорлЗркирк┐рк╕рлНркдрк╛рки
ЁЯЗ╣ЁЯЗ│ => ЁЯЗ╣ЁЯЗ│, ркЯрлНркпрлБркирк┐рк╢рк┐ркпрк╛
ЁЯЗ╣ЁЯЗ┤ => ЁЯЗ╣ЁЯЗ┤, ркЯрлЛркВркЧрк╛
ЁЯЗ╣ЁЯЗ╖ => ЁЯЗ╣ЁЯЗ╖, ркдрлБрк░рлНркХрлА
ЁЯЗ╣ЁЯЗ╣ => ЁЯЗ╣ЁЯЗ╣, ркЯрлНрк░рк┐ркирлАркжрк╛ркж ркЕркирлЗ ркЯрлЛркмрлЗркЧрлЛ
ЁЯЗ╣ЁЯЗ╗ => ЁЯЗ╣ЁЯЗ╗, ркдрлБрк╡рк╛рк▓рлБ
ЁЯЗ╣ЁЯЗ╝ => ЁЯЗ╣ЁЯЗ╝, ркдрк╛ркЗрк╡рк╛рки
ЁЯЗ╣ЁЯЗ┐ => ЁЯЗ╣ЁЯЗ┐, ркдрк╛ркВркЭрк╛ркирк┐ркпрк╛
ЁЯЗ║ЁЯЗж => ЁЯЗ║ЁЯЗж, ркпрлБркХрлНрк░рлЗрки
ЁЯЗ║ЁЯЗм => ЁЯЗ║ЁЯЗм, ркпрлБркЧрк╛ркВркбрк╛
ЁЯЗ║ЁЯЗ▓ => ЁЯЗ║ЁЯЗ▓, рк╕ркВркпрлБркХрлНркд рк░рк╛ркЬрлНркп ркЖркЙркЯрк▓рк╛ркЗркВркЧ ркЖркпрк▓рлЗркирлНркбрлНрк╕
ЁЯЗ║ЁЯЗ│ => ЁЯЗ║ЁЯЗ│, рк╕ркВркпрлБркХрлНркд рк░рк╛рк╖рлНркЯрлНрк░
ЁЯЗ║ЁЯЗ╕ => ЁЯЗ║ЁЯЗ╕, рк╕ркВркпрлБркХркд рк░рк╛ркЬрлНркп ркЕркорлЗрк░рк┐ркХрк╛
ЁЯЗ║ЁЯЗ╛ => ЁЯЗ║ЁЯЗ╛, ркЙрк░рлБркЧрлНрк╡рлЗ
ЁЯЗ║ЁЯЗ┐ => ЁЯЗ║ЁЯЗ┐, ркЙркЭрлНркмрлЗркХрк┐рк╕рлНркдрк╛рки
ЁЯЗ╗ЁЯЗж => ЁЯЗ╗ЁЯЗж, рк╡рлЗркЯрк┐ркХрки рк╕рк┐ркЯрлА
ЁЯЗ╗ЁЯЗи => ЁЯЗ╗ЁЯЗи, рк╕рлЗркирлНркЯ рк╡рк┐ркирлНрк╕рлЗркЯ ркЕркирлЗ ркЧрлНрк░рлЗркирлЗркбрлАркирлНрк╕
ЁЯЗ╗ЁЯЗк => ЁЯЗ╗ЁЯЗк, рк╡рлЗркирлЗркЭрлБркПрк▓рк╛
ЁЯЗ╗ЁЯЗм => ЁЯЗ╗ЁЯЗм, ркмрлНрк░рк┐ркЯрк┐рк╢ рк╡рк░рлНркЬрк┐рки ркЯрк╛рккрлБркУ
ЁЯЗ╗ЁЯЗо => ЁЯЗ╗ЁЯЗо, ркпрлБ.ркПрк╕. рк╡рк░рлНркЬрк┐рки ркЯрк╛рккрлБркУ
ЁЯЗ╗ЁЯЗ│ => ЁЯЗ╗ЁЯЗ│, рк╡рк┐ркпрлЗркдркирк╛рко
ЁЯЗ╗ЁЯЗ║ => ЁЯЗ╗ЁЯЗ║, рк╡рк╛ркирлБркЖркдрлБ
ЁЯЗ╝ЁЯЗл => ЁЯЗ╝ЁЯЗл, рк╡рлЗрк▓рлАрк╕ ркЕркирлЗ рклрлНркпрлБркЯрлБркирк╛
ЁЯЗ╝ЁЯЗ╕ => ЁЯЗ╝ЁЯЗ╕, рк╕ркорлЛркЖ
ЁЯЗ╜ЁЯЗ░ => ЁЯЗ╜ЁЯЗ░, ркХрлЛрк╕рлЛрк╡рлЛ
ЁЯЗ╛ЁЯЗк => ЁЯЗ╛ЁЯЗк, ркпрлЗркорлЗрки
ЁЯЗ╛ЁЯЗ╣ => ЁЯЗ╛ЁЯЗ╣, ркорлЗркпрлЛркЯ
ЁЯЗ┐ЁЯЗж => ЁЯЗ┐ЁЯЗж, ркжркХрлНрк╖рк┐ркг ркЖрклрлНрк░рк┐ркХрк╛
ЁЯЗ┐ЁЯЗ▓ => ЁЯЗ┐ЁЯЗ▓, ркЭрк╛ркорлНркмрк┐ркпрк╛
ЁЯЗ┐ЁЯЗ╝ => ЁЯЗ┐ЁЯЗ╝, ркЭрк┐ркорлНркмрк╛ркмрлНрк╡рлЗ
ЁЯЗ┐ЁЯЗ┐ => ЁЯЗ┐ЁЯЗ┐, ркЕркЬрлНркЮрк╛ркд рккрлНрк░ркжрлЗрк╢