ЁЯША => ЁЯША, ржХрзМрждрзБржХ, ржорж┐ржЪрж┐ржХрж┐ржпрж╝рж╛, ржорзБржЦ, рж╣рж╛ржБрж╣рж┐, рж╣рж╛ржБрж╣рж┐ ржержХрж╛, рж╣рж╛ржБрж╣рж┐ ржержХрж╛ ржорзБржЦ, рж╣рж╛ржБрж╣рж┐ржорзБржЦрзА
ЁЯШБ => ЁЯШБ, ржХрзМрждрзБржХ, ржорж┐ржЪрж┐ржХрж┐ржпрж╝рж╛, ржорж┐ржЪрж┐ржХрж┐ржпрж╝рж╛ ржЪржХрзБ рж╕рж╣ рж╣рж╛ржБрж╣рж┐ ржержХрж╛ ржорзБржЦ, ржорж┐ржЪрж┐ржХрж┐ржпрж╝рж╛ ржорзБржЦ, рж╣ржБрж╣рж╛, рж╣рж╛ржБрж╣рж┐
ЁЯШВ => ЁЯШВ, ржЖржиржирзНржж, ржЖржиржирзНржжрз░ ржЪржХрзБржкрж╛ржирзА, ржЖржиржирзНржжрз░ ржЪржХрзБржкрж╛ржирзА рж╕рж╣ ржорзБржЦ, ржорзБржЦ
ЁЯШГ => ЁЯШГ, ржХрзМрждрзБржХ, ржЦрзЛрж▓рж╛ ржорзБржЦрзЗрз░рзЗ ржорж┐ржЪрж┐ржХрж┐ржпрж╝рж╛, ржорж┐ржЪрж┐ржХрж┐ржпрж╝рж╛, ржорзБржЦ
ЁЯШД => ЁЯШД, ржХрзМрждрзБржХ, ржЦрзЛрж▓рж╛ ржорзБржЦрзЗрз░рзЗ ржорж┐ржЪрж┐ржХрж┐ржпрж╝рж╛, ржорж┐ржЪрж┐ржХрж┐ржпрж╝рж╛, ржорж┐ржЪрж┐ржХрж┐ржпрж╝рж╛ ржЪржХрзБ, ржорзБржЦ
ЁЯШЕ => ЁЯШЕ, ржарж╛ржгрзНржбрж╛ ржШрж╛ржо рж╕рж╣ ржорж┐ржЪрж┐ржХрж┐ржпрж╝рж╛ рж╣рж╛ржБрж╣рж┐, ржарж╛ржгрзНржбрж╛ ржШрж╛ржорз░ ржорж┐ржЪрж┐ржХрж┐ржпрж╝рж╛
ЁЯШЖ => ЁЯШЖ, ржЦрзЛрж▓рж╛ ржорзБржЦ, ржЦрзЛрж▓рж╛ ржорзБржЦрз░ ржорж┐ржЪрж┐ржХрж┐ржпрж╝рж╛ рж╣рж╛ржБрж╣рж┐, ржмржирзНржз ржЪржХрзБ, ржмржирзНржз ржЪржХрзБрз░рзЗ ржорж┐ржЪрж┐ржХрж┐ржпрж╝рж╛ рж╣рж╛ржБрж╣рж┐, ржорзБржЦ
ЁЯШЙ => ЁЯШЙ, ржЪржХрзБ ржЯрж┐ржкрж┐ржУрз▒рж╛, ржЪржХрзБ ржЯрж┐ржкрж┐ржУрз▒рж╛ ржорзБржЦ
ЁЯШК => ЁЯШК, ржорж┐ржЪрж┐ржХрж┐ржпрж╝рж╛ ржЪржХрзБ, ржорж┐ржЪрж┐ржХрж┐ржпрж╝рж╛ ржорзБржЦ, ржорж┐ржЪрж┐ржХрж┐ржпрж╝рж╛ ржорзБржЦ ржЖрз░рзБ ржЪржХрзБ, ржорж┐ржЪрж┐ржХрж┐ржпрж╝рж╛ рж╣рж╛ржБрж╣рж┐, ржорзБржЦ
ЁЯШЛ => ЁЯШЛ, ржорж┐ржЪрж┐ржХрж┐ржпрж╝рж╛ рж╣рж╛ржБрж╣рж┐рз░ ржорзБржЦ, ржорзБржЦ, рж╕рзБрж╕рзНржмрж╛ржжрзБ, рж╕рзБрж╕рзНржмрж╛ржжрзБ ржЦрж╛ржжрзНржп, рж╕рзБрж╕рзНржмрж╛ржжрзБ ржорзБржЦ
ЁЯШО => ЁЯШО, ржХрзБрж▓, ржЪрж╛ржиржЧрзНрж▓рж╛ржЫ, ржЪрж╛ржиржЧрзНрж▓рж╛ржЫ рж╕рж╣ ржорж┐ржЪрж┐ржХрж┐ржпрж╝рж╛ржЗ рж╣ржБрж╣рж╛, ржорж┐ржЪрж┐ржХрж┐ржпрж╝рж╛ рж╣рж╛ржБрж╣рж┐
ЁЯШН => ЁЯШН, ржЪржХрзБ, ржкрзНрз░рзЗржо, ржорз░ржорж▓ржЧрж╛, ржорж┐ржЪрж┐ржХрж┐ржпрж╝рж╛ рж╣рж╛ржБрж╣рж┐рз░ ржорзБржЦ, ржорзБржЦ, рж╣рзГржжржпрж╝ ржЪржХрзБ
ЁЯШШ => ЁЯШШ, ржЪрзБржорзНржмржи ржкрзНрз░рзЗрз░ржг ржХрз░рж╛, ржЪрзБржорзНржмржи ржкрзНрз░рзЗрз░ржг ржХрз░рж╛ ржорзБржЦ
ЁЯШЧ => ЁЯШЧ, ржЪрзБржорзНржмржи, ржЪрзБржорзНржмржи ржорзБржЦ, ржорзБржЦ
ЁЯШЩ => ЁЯШЩ, ржЪрзБржорзНржмржи ржЖрз░рзБ ржорж┐ржЪрж┐ржХрж┐ржпрж╝рж╛ рж╣рж╛ржБрж╣рж┐, ржорж┐ржЪрж┐ржХрж┐ржпрж╝рж╛ рж╣рж╛ржБрж╣рж┐ рж╕рж╣ ржЪрзБржорзНржмржи ржжрж┐ржпрж╝рж╛ ржорзБржЦ
ЁЯШЪ => ЁЯШЪ, ржЪржХрзБ ржмржирзНржз ржХрз░рж┐ ржЪрзБржорзНржмржи, ржЪрзБржорзНржмржи, ржмржирзНржз ржЪржХрзБ
тШ║ => тШ║, ржнрз░рзНрждрж┐ ржиржХрз░рж╛ рж╕рзНржорж╛ржЗрж▓рзА ржорзБржЦ, ржорж┐ржЪрж┐ржХрж┐ржпрж╝рж╛ржЗ ржержХрж╛ ржорзБржЦ, ржорзБржЦ, рж╕рзНржорж╛ржЗрж▓рзА
ЁЯШР => ЁЯШР, ржирж┐рз░ржкрзЗржХрзНрж╖, ржирж┐рз░ржкрзЗржХрзНрж╖ ржорзБржЦ, ржирж┐рж╕рзНрждрзЗржЬ, ржирж┐рж╕рзНрждрзЗржЬ ржорзБржЦ, ржорждрж╛ржоржд ржирж╛ржЗ, ржорзБржЦ
ЁЯШС => ЁЯШС, ржорждрж╛ржоржд ржирж╛ржЗ, ржоржирзЛржнрж╛рз▒ ржкрзНрз░ржХржЯ ржиржХрз░рж╛ ржорзБржЦ, ржоржирзЛржнрж╛рз▒рж╣рзАржи, ржорзБржЦ
ЁЯШ╢ => ЁЯШ╢, ржорзБржЦ ржЕржмрж┐рж╣ржирзЗ ржорзБржЦржоржгрзНржбрж▓, ржорзБржЦ ржирзЛрж╣рзЛрз▒рж╛ ржорзБржЦржоржгрзНржбрж▓
ЁЯШП => ЁЯШП, ржмрзЗржБржХрж╛ рж╣рж╛ржБрж╣рж┐, ржмрзЗржБржХрж╛ рж╣рж╛ржБрж╣рж┐рз░ ржорзБржЦ, ржорзБржЦ
ЁЯШг => ЁЯШг, ржЕржХрзНрж▓рж╛ржирзНржд, ржЕржХрзНрж▓рж╛ржирзНржд ржорзБржЦ, ржнрзБрж▓ ржХрз░рж┐рж▓рзЛржБ, ржоржЗ ржнрзБрж▓ ржХрз░рж┐рж▓рзЛржБ ржорзБржЦ, ржорзБржЦ
ЁЯШе => ЁЯШе, ржЕрж╕ржирзНрждрзБрж╖рзНржЯ, ржЕрж╕ржирзНрждрзБрж╖рзНржЯ ржХрж┐ржирзНрждрзБ рж╕ржХрж╛рж╣ ржкрзНрз░рж╛ржкрзНржд, ржУрж╣!, ржорзБржЦ, рж╕ржХрж╛рж╣ ржкрзНрз░рж╛ржкрзНржд
ЁЯШо => ЁЯШо, ржорзБржЦ, ржорзБржЦржоржгрзНржбрж▓, ржорзЗрж▓рж╛ ржорзБржЦ, ржорзЗрж▓рж╛ ржорзБржЦ рж╕рж╣ ржорзБржЦржоржгрзНржбрж▓
ЁЯШп => ЁЯШп, ржЖржЪрз░рж┐ржд, ржмрж┐рж╕рзНржорж┐ржд ржорзБржЦ, ржорзБржЦ, рж╕рзНрждржорзНржнрж┐ржд
ЁЯШк => ЁЯШк, рждржирзНржжрзНрз░рж╛ржоржЧрзНржи, рждржирзНржжрзНрз░рж╛ржоржЧрзНржи ржорзБржЦ, ржорзБржЦ
ЁЯШл => ЁЯШл, ржнрж╛ржЧрз░рзБрз▒рж╛, ржнрж╛ржЧрз░рзБрз▒рж╛ ржорзБржЦ, ржорзБржЦ
ЁЯШ┤ => ЁЯШ┤, ржЯрзЛржкржирж┐ ржпрзЛрз▒рж╛, ржЯрзЛржкржирж┐ ржпрзЛрз▒рж╛ ржорзБржЦ, ржорзБржЦ
ЁЯШМ => ЁЯШМ, рж╕ржХрж╛рж╣, рж╕ржХрж╛рж╣ ржкрзЛрз▒рж╛ ржорзБржЦ
ЁЯШЫ => ЁЯШЫ, ржЬрж┐ржнрж╛ ржЙрж▓рж┐ржУрз▒рж╛, ржЬрж┐ржнрж╛ ржУрж▓рж╛ржЗ ржержХрж╛ ржорзБржЦ, ржЬрж┐ржнрж╛ ржмрж╛рж╣рж┐рз░рж▓рзИ ржЙрж▓рж┐ржУрз▒рж╛
ЁЯШЬ => ЁЯШЬ, ржХрзМрждрзБржХ, ржЪржХрзБ ржЯрж┐ржкрж┐ржпрж╝рж╛ржЗ ржЬрж┐ржнрж╛ ржмрж╛рж╣рж┐рз░рж▓рзИ ржЙрж▓рж┐ржУрз▒рж╛, ржЬрж┐ржнрж╛ ржЙрж▓рж┐ржУрз▒рж╛, ржЬрзЛржХрзЛрз▒рж╛
ЁЯШЭ => ЁЯШЭ, ржШрзГржгрж╛, ржЪржХрзБ ржмржирзНржз, ржЬрж┐ржнрж╛ ржЙрж▓рж┐ржУрз▒рж╛, ржмржирзНржзрзБ ржЪржХрзБрз░рзЗ ржЬрж┐ржнрж╛ ржЙрж▓рж┐ржУрз▒рж╛, ржнржпрж╝рж╛ржиржХ, ржорзБржЦ
ЁЯШТ => ЁЯШТ, ржЕрж╕ржирзНрждрзБрж╖рзНржЯ, ржЕрж╕ржирзНрждрзБрж╖рзНржЯ ржорзБржЦ, ржмрж┐рз░ржХрзНржд, ржорзБржЦ
ЁЯШУ => ЁЯШУ, ржарж╛ржгрзНржбрж╛ ржШрж╛ржо, ржарж╛ржгрзНржбрж╛ ржШрж╛ржо рж╕рж╣ ржорзБржЦ, ржорзБржЦ
ЁЯШФ => ЁЯШФ, ржЪрж┐ржирзНрждрж╛ржоржЧрзНржи, ржЪрж┐ржирзНрждрж╛ржоржЧрзНржи ржорзБржЦ, ржмрж┐рж╖ржирзНржи, ржорзБржЦ
ЁЯШХ => ЁЯШХ, ржмрж┐ржнрзНрз░рж╛ржирзНржд, ржмрж┐ржнрзНрз░рж╛ржирзНржд ржорзБржЦ, ржорзБржЦ
ЁЯШ▓ => ЁЯШ▓, ржПржХрзЗржмрж╛рз░рзЗ рж╕рзНрждржорзНржнрж┐ржд, ржорзБржЦ, рж╕рзНрждржорзНржнрж┐ржд, рж╣рждржмрж╛ржХ, рж╣рждржмрж╛ржХ рж╣рзЛрз▒рж╛ ржорзБржЦ
ЁЯШЦ => ЁЯШЦ, ржХрж┐ржВржХрж░рзНрждржмрзНржпржмрж┐ржорзВржврж╝, ржХрж┐ржВржХрж░рзНрждржмрзНржпржмрж┐ржорзВржврж╝ ржорзБржЦ, ржорзБржЦ
ЁЯШЮ => ЁЯШЮ, ржЕрж╕ржирзНрждрзБрж╖рзНржЯ, ржЕрж╕ржирзНрждрзБрж╖рзНржЯ ржорзБржЦ, ржорзБржЦ
ЁЯШЯ => ЁЯШЯ, ржЪрж┐ржирзНрждрж┐ржд, ржЪрж┐ржирзНрждрж┐ржд ржорзБржЦ, ржорзБржЦ
ЁЯШд => ЁЯШд, ржмрж┐ржЬржпрж╝, ржмрж┐ржЬржпрж╝рз░ ржнрж╛рз▒, ржоржЗ ржЬрж┐ржХрж┐рж▓рзЛржБ, ржоржЗ ржЬрж┐ржХрж┐рж▓рзЛржБ ржорзБржЦ, ржорзБржЦ
ЁЯШв => ЁЯШв, ржХржирзНржжрж╛, ржХржирзНржжрж╛ ржорзБржЦ, ржЪржХрзБрж▓рзЛ, ржжрзБржЦ, ржорзБржЦ
ЁЯШн => ЁЯШн, ржХржирзНржзрж╛, ржХрж╛ржирзНржжрзЛржи, ржЪржХрзБрж▓рзЛ, ржЬрзЛрз░ржХрзИ ржХржирзНржжрж╛, ржорзБржЦ
ЁЯШж => ЁЯШж, ржнрзНрз░рзВржХрзБржЯрж┐, ржнрзНрз░рзВржХрзБржЯрж┐ рж╕рж╣ ржорзЗрж▓рж╛ ржорзБржЦ, ржнрзНрз░рзВржХрзБржЯрж┐рз░ ржорзБржЦ, ржорзБржЦ, ржорзЗрж▓рж╛ ржорзБржЦ
ЁЯШз => ЁЯШз, ржжрзБржЦ ржнрзЛржЧрж╛, ржорзБржЦ, рж╢рзЛржХрж╛ржХрзБрж▓, рж╢рзЛржХрж╛ржХрзБрж▓ ржорзБржЦ
ЁЯШи => ЁЯШи, ржЖрждржЩрзНржХрж┐ржд, ржЖрждржЩрзНржХрж┐ржд ржорзБржЦ, ржнржпрж╝рж╛рждрзБрз░, ржорзБржЦ
ЁЯШй => ЁЯШй, ржХрзНрж▓рж╛ржирзНржд, ржХрзНрж▓рж╛ржирзНржд ржорзБржЦ, ржнрж╛ржЧрз░рзБрз▒рж╛, ржорзБржЦ
ЁЯШм => ЁЯШм, ржнрзЗржЩрзБржЪрж╛рж▓рж┐, ржнрзЗржЩрзБржЪрзЛрз▒рж╛, ржорзБржЦ, ржорзБржЦ ржнрзЗржЩрзБржЪрж╛рж▓рж┐
ЁЯШ░ => ЁЯШ░, ржЦрз░ржзрз░ ржХрз░рж╛ ржорзБржЦ, ржарж╛ржгрзНржбрж╛ ржШрж╛ржо, ржарж╛ржгрзНржбрж╛ ржШрж╛ржо рж╕рж╣ ржирзАрж▓рж╛ ржорзБржЦ, ржорзБржЦ, ржорзЗрж▓рж╛ ржорзБржЦ
ЁЯШ▒ => ЁЯШ▒, ржЖрждржЩрзНржХрж┐ржд, ржнржпрж╝, ржнржпрж╝ржд ржЪрж┐ржЮрз░рж╛, ржнржпрж╝ржд ржЪрж┐ржЮрз░рж╛ ржорзБржЦ, ржнржпрж╝рж╛рждрзБрз░, ржнржпрж╝рж╛рждрзБрз░ ржорзБржЦ, ржорзБржЦ
ЁЯШ│ => ЁЯШ│, рз░ржЩрж╛ ржкрз░рж╛, рз░ржЩрж╛ ржкрз░рж╛ ржорзБржЦ, рж╣рждржмрзБржжрзНржзрж┐ржд ржкрз░рж╛, рж╣рждржмрзБржжрзНржзрж┐ржд ржкрз░рж╛ ржорзБржЦ
ЁЯШ╡ => ЁЯШ╡, ржмрж┐рж╣рзНржмрж▓, ржмрж┐рж╣рзНржмрж▓ рж╣рзЛрз▒рж╛ ржорзБржЦ, ржорзБржЦ
ЁЯШб => ЁЯШб, ржХрзНрж╖рзБржмрзНржз, ржЦржЩрж╛рж▓, ржорзБржЦ, ржорзБржЦ ржУржлржирзНржжрзЛрз▒рж╛, рз░ржЩрж╛ ржУржлржирзНржжрзЛрз▒рж╛ ржорзБржЦ, рз░ржЩрж╛ ржкрз░рж╛ ржорзБржЦ
ЁЯШа => ЁЯШа, ржЦржВ, ржЦржЩрж╛рж▓ ржорзБржЦ, ржорзБржЦ
ЁЯШ╖ => ЁЯШ╖, ржмрждрз░рз░ рждрж▓ржд, ржорж╛рж╕рзНржХ, ржорж╛рж╕рзНржХ рж╕рж╣ ржорзБржЦ, ржорзБржЦ, ржорзЗржбрж┐ржХрзЗрж▓ ржорж╛рж╕рзНржХ, рж╢рзАржд
ЁЯШЗ => ЁЯШЗ, ржЬрзНржпрзЛрждрж┐ржГржЪржХрзНрз░, ржЬрзНржпрзЛрждрж┐ржГржЪржХрзНрз░ рж╕рж╣ ржорж┐ржЪрж┐ржХрж┐ржпрж╝рж╛ рж╣рж╛ржБрж╣рж┐, ржорж┐ржЪрж┐ржХрж┐ржпрж╝рж╛ рж╣рж╛ржБрж╣рж┐, ржорзБржЦ
ЁЯШИ => ЁЯШИ, ржорж┐ржЪрж┐ржХрж┐ржпрж╝рж╛ рж╣рж╛ржБрж╣рж┐, рж╢рж┐ржВ, рж╢рж┐ржВ рж╕рж╣ ржорж┐ржЪрж┐ржХрж┐ржпрж╝рж╛ рж╣рж╛ржБрж╣рж┐
ЁЯС┐ => ЁЯС┐, ржЗржорзНржк, ржорзБржЦ, рз░рж╛ржХрзНрж╖рж╕, рж╕рз░рзБ ржнрзВржд
ЁЯС╣ => ЁЯС╣, ржЬрж╛ржкрж╛ржирзА рз░рж╛ржХрзНрж╖рж╕, ржнрзВржд, ржорзБржЦ, рз░рж╛ржХрзНрж╖рж╕
ЁЯС║ => ЁЯС║, ржЬрж╛ржкрж╛ржирзА ржкрж┐рж╢рж╛ржЪ, ржкрж┐рж╢рж╛ржЪ, ржнрзВржд, ржорзБржЦ
ЁЯТА => ЁЯТА, ржХржВржХрж╛рж▓, ржорзБржЦ, рж╕рж╛ржзрзБ ржХржерж╛
ЁЯС╗ => ЁЯС╗, ржнрзВржд, ржорзБржЦ, рж╕рж╛ржзрзБ ржХржерж╛рз░ ржнрзВржд
ЁЯС╜ => ЁЯС╜, UFO, ржПрж▓рж┐ржпрж╝рзЗржи, ржмрз░рзНрж╣рж┐ржЧрзНрз░рж╣рз░ ржкрзНрз░рж╛ржгрзА, ржорзБржЦ
ЁЯС╛ => ЁЯС╛, UFO, ржПрж▓рж┐ржпрж╝рзЗржи ржотАЩржирж╖рзНржЯрж╛рз░, ржотАЩржирж╖рзНржЯрж╛рз░, ржорзБржЦ, рж╕рж╛ржзрзБ ржХржерж╛
ЁЯТй => ЁЯТй, ржорж▓, рж╢рзМржЪ
ЁЯШ║ => ЁЯШ║, ржорзБржЦ, ржорзЗржХрзБрз░рзА, ржорзЗржХрзБрз░рзАрз░ ржорзБржЦ, ржорзЗрж▓рж╛ ржорзБржЦ, ржорзЗрж▓рж╛ ржорзБржЦ рж╕рж╣ ржорзЗржХрзБрз░рзАрз░ ржорзБржЦржоржгрзНржбрж▓, рж╣рж╛ржБрж╣рж┐ ржержХрж╛ ржорзЗржХрзБрз░рзА ржорзБржЦ
ЁЯШ╕ => ЁЯШ╕, ржорж┐ржЪрж┐ржХрж┐ржпрж╝рж╛, ржорж┐ржЪрж┐ржХрж┐ржпрж╝рж╛ржЗ ржержХрж╛ ржорзБржЦ ржЖрз░рзБ ржЪржХрзБ рж╕рж╣ ржорзЗржХрзБрз░рзА, ржорж┐ржЪрж┐ржХрж┐ржпрж╝рж╛ржЗ ржержХрж╛ ржорзЗржХрзБрз░рзАрз░ ржорзБржЦ, ржорзЗржХрзБрз░рзА, ржорзЗржХрзБрз░рзАрз░ ржорзБржЦ
ЁЯШ╣ => ЁЯШ╣, ржЖржиржирзНржжрз░ ржЪржХрзБрж▓рзЛ, ржЖржиржирзНржжрз░ ржЪржХрзБрж▓рзЛ рж╕рж╣ ржорзЗржХрзБрз░рзАрз░ ржорзБржЦ, ржорзЗржХрзБрз░рзА, ржорзЗржХрзБрз░рзАрз░ ржорзБржЦ
ЁЯШ╗ => ЁЯШ╗, ржкрзНрз░рзЗржо, ржорзБржЦ, ржорзЗржХрзБрз░рзА, ржорзЗржХрзБрз░рзАрз░ ржорзБржЦ, рж╣рж╛ржБрж╣рж┐ ржержХрж╛ ржорзЗржХрзБрз░рзА ржорзБржЦ, рж╣рзГржжржпрж╝, рж╣рзГржжржпрж╝ ржЖржХрзГрждрж┐рз░ ржЪржХрзБ рж╕рж╣ рж╣рж╛ржБрж╣рж┐ ржержХрж╛ ржорзЗржХрзБрз░рзАрз░ ржорзБржЦржоржгрзНржбрж▓
ЁЯШ╝ => ЁЯШ╝, ржмрж┐ржХрзГржд, ржмрж┐ржХрзГржд ржорзЗржХрзБрз░рзАрз░ ржорзБржЦ, ржмрж┐ржжрзНрж░рзВржкрж╛рждрзНржоржХ рж╣рж╛ржБрж╣рж┐, ржорзБржЦ, ржорзЗржХрзБрз░рзА, ржорзЗржХрзБрз░рзАрз░ ржорзБржЦ
ЁЯШ╜ => ЁЯШ╜, ржЪржХрзБ, ржЪржХрзБ ржмржирзНржз, ржЪрзБржорж╛ ржжрж┐ ржержХрж╛, ржЪрзБржорж╛ ржжрж┐ ржержХрж╛ ржорзЗржХрзБрз░рзА, ржЪрзБржорзНржмржи, ржорзБржЦ, ржорзЗржХрзБрз░рзА
ЁЯЩА => ЁЯЩА, ржХрзНрж▓рж╛ржирзНржд ржорзЗржХрзБрз░рзАрз░ ржорзБржЦ, ржорзБржЦ, ржорзЗржХрзБрз░рзА, рж╕ржБржЪрж╛ржХрзИржпрж╝рзЗ ржЖржЪрз░рж┐ржд, рж╣рзЗ ржнржЧрз▒рж╛ржи
ЁЯШ┐ => ЁЯШ┐, ржХржирзНржжрж╛ ржорзЗржХрзБрз░рзАрз░ ржорзБржЦ, ржХржирзНржзрж╛, ржХрж╛ржирзНржжрзЛржи, ржорзБржЦ, ржорзЗржХрзБрз░рзА, ржорзЗржХрзБрз░рзАрз░ ржорзБржЦ
ЁЯШ╛ => ЁЯШ╛, ржорзБржЦ, ржорзБржЦ ржУржлржирзНржжрзЛрз▒рж╛, ржорзБржЦ ржУржлржирзНржжрзЛрз▒рж╛ ржорзЗржХрзБрз░рзА ржорзБржЦ, ржорзЗржХрзБрз░рзА, ржорзЗржХрзБрз░рзАрз░ ржорзБржЦ
ЁЯЩИ => ЁЯЩИ, ржмрж╛ржирзНржжрз░, ржмрзЗржпрж╝рж╛ ржирж╛ржЪрж╛ржм, ржмрзЗржпрж╝рж╛ ржирж╛ржЪрж╛ржм ржмрж╛ржирзНржжрз░
ЁЯЩЙ => ЁЯЩЙ, ржмрж╛ржирзНржжрз░, ржмрзЗржпрж╝рж╛ ржирзБрж╢рзБржирж┐ржм, ржмрзЗржпрж╝рж╛ ржирзБрж╢рзБржирж┐ржм ржмрж╛ржирзНржжрз░
ЁЯЩК => ЁЯЩК, ржмрж╛ржирзНржжрз░, ржмрзЗржпрж╝рж╛ ржиржХтАЩржм, ржмрзЗржпрж╝рж╛ ржиржХтАЩржм ржмрж╛ржирзНржжрз░
ЁЯС╢ => ЁЯС╢, ржХрзЗржЪрзБрз▒рж╛, ржорж╛ржирзБрж╣, рж╢рж┐рж╢рзБ
ЁЯСж => ЁЯСж, ржорж╛ржирзБрж╣, рж▓тАЩрз░рж╛
ЁЯСз => ЁЯСз, ржЫрзЛрз▒рж╛рж▓рзА, ржорж╛ржирзБрж╣
ЁЯСи => ЁЯСи, ржкрзБрз░рзБрж╖, ржмрзНржпржХрзНрждрж┐
ЁЯСй => ЁЯСй, ржмрзНржпржХрзНрждрж┐, ржорж╣рж┐рж▓рж╛
ЁЯС┤ => ЁЯС┤, ржкрзБрз░рзБрж╖, ржмрзГржжрзНржз ржорж╛ржирзБрж╣
ЁЯС╡ => ЁЯС╡, ржмрзГржжрзНржзрж╛ ржорж╣рж┐рж▓рж╛, ржорж╣рж┐рж▓рж╛
ЁЯСо => ЁЯСо, ржЖрз░ржХрзНрж╖рзА, ржкрзБрж▓рж┐ржЪ, ржкрзБрж▓рж┐ржЪ ржмрж┐рж╖ржпрж╝рж╛
ЁЯТВ => ЁЯТВ, ржЧрж╛рз░рзНржбржорзЗржи, ржкрзНрз░рж╣рз░рзА, ржмрзНржпржХрзНрждрж┐
ЁЯС╖ => ЁЯС╖, ржирж┐рз░рзНржорж╛ржг рж╢рзНрз░ржорж┐ржХ, рж╢рзНрз░ржорж┐ржХ
ЁЯС╕ => ЁЯС╕, рз░рж╛ржгрзА, рж╕рж╛ржзрзБ ржХржерж╛рз░ рз░рж╛ржгрзА
ЁЯС│ => ЁЯС│, ржкрж╛ржЧрзБрз░рж┐, ржкрж╛ржЧрзБрз░рж┐ ржержХрж╛ ржкрзБрз░рзБрж╖, ржорж╛ржирзБрж╣
ЁЯС▓ => ЁЯС▓, ржЧрзБрз▒рж╛ ржкрж┐ ржорзЛ, ржорж╛ржирзБрж╣, ржорзЛржЪрз░ рж╕рзИрждрзЗ ржмрзНржпржХрзНрждрж┐
ЁЯС▒ => ЁЯС▒, ржЫрзЛрз▒рж╛рж▓рзА, рж╕рзЛржгрж╛рж▓рзА ржЪрзБрж▓рж┐, рж╕рзЛржгрж╛рж▓рзА ржЪрзБрж▓рж┐рз░рзЗ ржЫрзЛрз▒рж╛рж▓рзА
ЁЯС░ => ЁЯС░, ржУрз░ржирж┐рз░ рж╕рзИрждрзЗ ржХржЗржирж╛, ржХржЗржирж╛, ржмрж┐ржмрж╛рж╣
ЁЯС╝ => ЁЯС╝, ржжрзЗрз▒ржжрзВржд, рж╢рж┐рж╢рзБ ржжрзЗрз▒ржжрзВржд, рж╕рж╛ржзрзБ ржХржерж╛
ЁЯОЕ => ЁЯОЕ, ржЙржжржпрж╛ржкржи, ржЦрзНрз░рзАрж╖рзНржЯржорж╛ржЪ, ржЪрж╛ржирзНрждрж╛, ржЪрж╛ржирзНрждрж╛ ржХрзНрж▓тАЩржЬ, ржмрз░ржжрж┐ржи
ЁЯЩН => ЁЯЩН, ржмрзНржпржХрзНрждрж┐, ржнржЩрзНржЧрзА, ржнрзНрз░рзВржХрзБржЯрж┐, ржнрзНрз░рзВржХрзБржЯрж┐ ржорз░рж╛ ржмрзНржпржХрзНрждрж┐
ЁЯЩО => ЁЯЩО, ржмрзНржпржХрзНрждрж┐, ржнржЩрзНржЧрзА, ржорзБржЦ ржУржлржирзНржжрзЛрз▒рж╛, ржорзБржЦ ржУржлржирзНржжрзЛрз▒рж╛ ржмрзНржпржХрзНрждрж┐
ЁЯЩЕ => ЁЯЩЕ, ржирж╣ржпрж╝, ржирж┐рж╖рж┐ржжрзНржз, ржнржЩрзНржЧрзА, ржнрж╛рж▓ ржирж╣ржпрж╝, ржнрж╛рж▓ ржирж╣ржпрж╝ ржнржЩрзНржЧрзА, ржорзБржЦ
ЁЯЩЖ => ЁЯЩЖ, ржарж┐ржХ ржЖржЫрзЗ, ржарж┐ржХ ржнржЩрзНржЧрзА, ржнржЩрзНржЧрзА, ржорзБржЦ
ЁЯТБ => ЁЯТБ, рждржерзНржп, рждржерзНржп ржХрзЗржирзНржжрзНрз░, ржмрзНржпржХрзНрждрж┐, рж╕рж╣рж╛ржпрж╝
ЁЯЩЛ => ЁЯЩЛ, ржмрзНржпржХрзНрждрж┐, ржнржЩрзНржЧрзА, рж╕рзБржЦрзА, рж╕рзБржЦрзА ржмрзНржпржХрзНрждрж┐, рж╣рж╛ржд ржжржЩрж╛, рж╣рж╛ржд ржжржЩрж╛ ржмрзНржпржХрзНрждрж┐
ЁЯЩЗ => ЁЯЩЗ, ржЧржнрзАрз░ ржорзБрз░ ржжрзБржкрж┐ржУрз▒рж╛, ржжрзБржГржЦрзАржд, ржмрзНржпржХрзНрждрж┐, ржнржЩрзНржЧрзА, ржоржЗ ржжрзБржГржЦрзАржд, ржорзБрз░ ржжрзБржкрж┐ржУрз▒рж╛
ЁЯТЖ => ЁЯТЖ, ржЪрзЗрж▓рзБржи, ржорж╛рж▓рж┐ржЪ, ржорзБржЦрз░ ржорж╛рж▓рж┐ржЪ
ЁЯТЗ => ЁЯТЗ, ржЪрзБрж▓рж┐ ржХржЯрж╛, ржкрж╛рз░рзНрж▓рж╛рз░, ржмрж┐ржЙржЯрж┐ ржкрж╛рз░рзНрж▓рж╛рз░
ЁЯЪ╢ => ЁЯЪ╢, ржЦрзЛржЬ ржХржврж╝рж╛, ржкржержЪрж╛рз░рзА
ЁЯПГ => ЁЯПГ, ржЦрзЗрж▓, ржжрзМрз░ржмрж┐ржж, ржжрзМрз░рж╛, ржорж╛рз░рж╛ржержи
ЁЯТГ => ЁЯТГ, ржирз░рзНрждржХрзА, ржирзГрждрзНржп, ржорж╛ржирзБрж╣
ЁЯСп => ЁЯСп, ржЫрзЛрз▒рж╛рж▓рзА, ржорзБрз░ржд ржлрж┐ржЯрж╛ ржорз░рж╛ ржЫрзЛрз▒рж╛рж▓рзА
ЁЯЫА => ЁЯЫА, ржмрж╛рже
ЁЯСд => ЁЯСд, ржЖржмржХрзНрж╖ ржорзВрж░рзНрждрж┐, ржкрж╛рз░рзНрж╢рзНржм ржорзВрз░рзНрждрж┐, ржорж╛ржирзБрж╣
ЁЯСе => ЁЯСе, ржЖржмржХрзНрж╖ ржорзВрж░рзНрждрж┐, ржкрж╛рз░рзНрж╢рзНржм ржорзВрз░рзНрждрж┐, ржорж╛ржирзБрж╣
ЁЯПЗ => ЁЯПЗ, ржЦрзЗрж▓, ржШрзЛржБрз░рж╛, ржШрзЛржБрз░рж╛ ржжрзМрз░
ЁЯПВ => ЁЯПВ, рж╢рзНржитАЩржмрз░рзНржб, рж╢рзНржитАЩржмрз░рзНржбрж╛рз░, рж╢рзНржитАЩржмрз░рзНржбрж┐ржВ
ЁЯПД => ЁЯПД, ржЦрзЗрж▓, ржЪрж╛рз░рзНржлрж╛рз░, ржЪрж╛рз░рзНржлрж┐ржВ
ЁЯЪг => ЁЯЪг, ржирж╛ржУ, ржмржарж╛ ржорз░рж╛ ржирж╛ржУ, ржмрж╛рж╣ржи
ЁЯПК => ЁЯПК, ржЦрзЗрж▓, рж╕рж╛ржБрждрзЛрз░, рж╕рж╛ржБрждрзЛрз░ржмрж┐ржж
ЁЯЪ┤ => ЁЯЪ┤, ржЪрж╛ржЗржХрзЗрж▓ ржЪрж╛рж▓ржХ, ржмрж╛ржЗржХ, ржмрж╛ржЗржЪрж╛ржЗржХрзЗрж▓ ржЪрж╛рж▓ржХ
ЁЯЪ╡ => ЁЯЪ╡, ржЪрж╛ржЗржХрзЗрж▓ ржЪрж╛рж▓ржХ, ржкрз░рзНржмржд, ржкрз░рзНржмрждрзАржпрж╝рж╛ ржмрж╛ржЗржЪрж╛ржЗржХрзЗрж▓ ржЪрж╛рж▓ржХ, ржмрж╛ржЗржХ
ЁЯСл => ЁЯСл, ржжржорзНржкрждрзА, ржмрзНржпржХрзНрждрж┐, ржорж╣рж┐рж▓рж╛ ржЖрз░рзБ ржкрзБрз░рзБрж╖, рж╣рж╛рждрзЗ рж╣рж╛ржд ржзрз░рж┐ ржержХрж╛ ржорж╣рж┐рж▓рж╛ ржЖрз░рзБ ржкрзБрз░рзБрж╖
ЁЯСм => ЁЯСм, ржжрзБржЬржи ржкрзБрз░рзБрж╖, ржмрзНржпржХрзНрждрж┐, рж╣рж╛рждрзЗ рж╣рж╛ржд ржзрз░рж┐ ржержХрж╛ ржжрзБржЬржи ржкрзБрз░рзБрж╖
ЁЯСн => ЁЯСн, ржжрзБржЧрз░рж╛ржХрзА ржорж╣рж┐рж▓рж╛, рж╣рж╛рждрзЗ рж╣рж╛ржд ржзрз░рж┐ ржержХрж╛ ржжрзБржЧрз░рж╛ржХрзА ржорж╣рж┐рж▓рж╛
ЁЯТП => ЁЯТП, ржХрж┐ржЪ, ржЪрзБржорж╛, ржЪрзБржорзНржмржи, рз░рзЛржорж╛ржЮрзНржЪ
ЁЯТС => ЁЯТС, ржжржорзНржкрждрзНрждрзА, ржкрзНрз░рзЗржо, рз░рзЛржорж╛ржЮрзНржЪ, рж╣рзГржжржпрж╝ ржЪрж┐ржирз░ рж╕рзИрждрзЗ ржжржорзНржкрждрзНрждрзА
ЁЯСк => ЁЯСк, ржжрзЗржЙрждрж╛ржХ, ржкрз░рж┐ржпрж╝рж╛рж▓, ржорж╛ржХ, рж▓тАЩрз░рж╛-ржЫрзЛрз▒рж╛рж▓рзА
ЁЯТк => ЁЯТк, ржмрж▓ржмрж╛ржи, ржмрж╛рж╣рзБ, ржмрж╛рж╣рзБржмрж▓, ржорж╛ржВрж╕ржкрзЗрж╢рзА
ЁЯСИ => ЁЯСИ, ржЖржЩрзБрж▓рж┐, рждрз░рзНржЬржирзА ржЖржЩрзБрж▓рж┐, ржмрж╛ржБржУ ржорзБржЦрзАржпрж╝рж╛ ржЖржЩрзБрж▓рж┐
ЁЯСЙ => ЁЯСЙ, ржЖржЩрзБрж▓рж┐, рждрз░рзНржЬржирзА ржЖржЩрзБрж▓рж┐, рж╕рзЛржБ ржорзБржЦрзАржпрж╝рж╛ ржЖржЩрзБрж▓рж┐
ЁЯСЖ => ЁЯСЖ, ржЖржЩрзБрж▓рж┐, ржУржкрз░ ржорзБржЦрзАржпрж╝рж╛ ржЖржЩрзБрж▓рж┐, рждрз░рзНржЬржирзА ржЖржЩрзБрж▓рж┐
ЁЯСЗ => ЁЯСЗ, ржЖржЩрзБрж▓рж┐, рждрз░рзНржЬржирзА ржЖржЩрзБрж▓рж┐, рждрж▓ ржорзБржЦрзАржпрж╝рж╛ ржЖржЩрзБрж▓рж┐
тЬМ => тЬМ, ржХрзЗржБржЪрж┐, ржмрж┐ржЬржпрж╝, ржмрж┐ржЬржпрж╝рз░ рж╣рж╛рждрз░ ржЪрж┐рж╣рзНржи, рж╣ржпрж╝
тЬЛ => тЬЛ, ржХрж╛ржЧрж╛ржЬ, ржжржЩрж╛ рж╣рж╛ржд
ЁЯСМ => ЁЯСМ, ржЕтАЩржХрзЗ ржЪрж┐ржи, ржЕтАЩржХрзЗ рж╣рж╛рждрз░ ржЪрж┐ржи, рж╣рж╛ржд
ЁЯСН => ЁЯСН, ржУржкрз░ ржорзБржЦрзАржпрж╝рж╛ ржмрзБржврж╝рж╛ ржЖржЩрзБрж▓рж┐, ржерж╛ржорзНржмржЪ ржЖржк, ржмрзБржврж╝рж╛ ржЖржЩрзБрж▓рж┐
ЁЯСО => ЁЯСО, рждрж▓ ржорзБржЦрзАржпрж╝рж╛ ржмрзБржврж╝рж╛ ржЖржЩрзБрж▓рж┐, ржерж╛ржорзНржмржЪ ржбрж╛ржЙржи, ржмрзБржврж╝рж╛ ржЖржЩрзБрж▓рж┐
тЬК => тЬК, ржУржкрз░ржорзБрз▒рж╛ рж╣рж╛рждрз░ ржорзБржарж┐, рж╢рж┐рж▓
ЁЯСК => ЁЯСК, ржШрзЛржЪрж╛, рж╣рж╛ржд, рж╣рж╛рждрз░ ржорзБржарж┐
ЁЯСЛ => ЁЯСЛ, ржорзЗрж▓рж╛ рж╣рж╛ржд, рж╣рж╛ржд, рж╣рж╛ржд ржЬрзЛржХрз░рж╛
ЁЯСП => ЁЯСП, рж╣рж╛ржд, рж╣рж╛ржд ржЪрж╛ржкрз░рж┐, рж╣рж╛ржд рждрж╛рж▓рж┐, рж╣рж╛рждрз░ ржЪрж┐ржи
ЁЯСР => ЁЯСР, ржЦрзЛрж▓рж╛ рж╣рж╛ржд, ржЦрзЛрж▓рж╛ рж╣рж╛рждрз░ ржЪрж┐ржи, рж╣рж╛ржд
ЁЯЩМ => ЁЯЩМ, ржЖржиржирзНржж ржЙржжржпрж╛ржкржи, ржЖржиржирзНржжржд ржжрзБржпрж╝рзЛржЦржи рж╣рж╛ржд ржжржЩрж╛, ржжрзБржпрж╝рзЛ рж╣рж╛ржд, рж╣рзБрз░рзЗ
ЁЯЩП => ЁЯЩП, ржкрзНрз░рж╛рз░рзНржержирж╛, ржкрзНрз░рж╛рз░рзНржержирж╛ ржХрз░рж╛, ржнржЩрзНржЧрзА, рж╣рж╛ржд, рж╣рж╛рждржпрзЛрз░ ржХрз░рж╛
ЁЯТЕ => ЁЯТЕ, ржХржЪржорзЗржЯрж┐ржХ, ржиржЦ, ржиржЦрз░ ржпрждржи, ржирзЗржЗрж▓ ржкрж▓рж┐ржЪ, ржкрзНрз░рж╕рж╛ржзржи, ржорзЗржирж┐ржХрж┐ржЙрз░
ЁЯСВ => ЁЯСВ, ржХрж╛ржг, рж╢рз░рзАрз░
ЁЯСГ => ЁЯСГ, ржирж╛ржХ, ржорзБржЦ, рж╢рз░рзАрз░
ЁЯСг => ЁЯСг, ржнрз░рж┐рз░ ржЪрж┐ржи, ржнрз░рж┐рз░ ржкржЯрж╛, рж╢рз░рзАрз░
ЁЯСА => ЁЯСА, ржЪржХрзБ, ржЪржХрзБрж╣рж╛рж▓рж┐, ржорзБржЦ
ЁЯСЕ => ЁЯСЕ, ржЬрж┐ржнрж╛, ржорзБржЦ, рж╢рз░рзАрз░
ЁЯСД => ЁЯСД, ржУржа, ржорзБржЦ, рж╢рз░рзАрз░
ЁЯТЛ => ЁЯТЛ, ржУржБржа, ржЪрзБржорж╛, ржЪрзБржорзНржмржирз░ ржЪрж┐рж╣рзНржи, рз░рзЛржорж╛ржЮрзНржЪ
ЁЯТШ => ЁЯТШ, ржХрж╛ржбрж╝ ржержХрж╛ рж╣рзГржжржпрж╝, ржкрзНрз░рзЗржо, рж╣рзГржжржпрж╝, рж╣рзГржжржпрж╝ ржЖрз░рзБ ржХрж╛ржБржбрж╝
ЁЯТУ => ЁЯТУ, ржЖржмрзЗржЧ, ржзржкржзржкржирж┐ ржХрз░рж╛ рж╣рзГржжржпрж╝, ржкрзНрз░рзЗржо, рж╕рзНржкржирзНржжржи, рж╣рзГржжржпрж╝
ЁЯТФ => ЁЯТФ, ржЖржмрзЗржЧ, ржнржЧрзНржи, ржнржЧрзНржи рж╣рзГржжржпрж╝, рж╣рзГржжржпрж╝
ЁЯТХ => ЁЯТХ, ржЖржмрзЗржЧ, ржжрзБржЦржи рж╣рзГржжржпрж╝, ржкрзНрз░рзЗржо, ржкрзНрз░рзЗржорж┐ржХ
ЁЯТЦ => ЁЯТЦ, ржЖржмрзЗржЧ, ржЙрждрзНрждрзЗржЬрж┐ржд, ржЬрж┐рж▓рж┐ржХрж┐ ржержХрж╛ рж╣рзГржжржпрж╝, ржкрзНрз░рзЗржо
ЁЯТЧ => ЁЯТЧ, ржЖржмрзЗржЧ, ржЙрждрзНрждрзЗржЬрж┐ржд, ржкрзНрз░рзЗржо, ржмрж╛ржврж╝рж┐ ржЕрж╣рж╛ рж╣рзГржжржпрж╝, рж╣рзГржжржпрж╝
ЁЯТЩ => ЁЯТЩ, ржЖржмрзЗржЧ, ржирзАрж▓рж╛, ржирзАрж▓рж╛ рж╣рзГржжржпрж╝, рж╣рзГржжржпрж╝
ЁЯТЪ => ЁЯТЪ, ржЖржмрзЗржЧ, рж╕рзЗржЙржЬрзАржпрж╝рж╛ рж╣рзГржжржпрж╝, рж╣рзГржжржпрж╝
ЁЯТЫ => ЁЯТЫ, ржЖржмрзЗржЧ, рж╣рж╛рж▓ржзрзАржпрж╝рж╛ рж╣рзГржжржпрж╝, рж╣рзГржжржпрж╝
ЁЯТЬ => ЁЯТЬ, ржЖржмрзЗржЧ, ржмрзЗржЩрзБржирзАржпрж╝рж╛, ржмрзЗржЩрзБржирзАржпрж╝рж╛ рж╣рзГржжржпрж╝, рж╣рзГржжржпрж╝
ЁЯТЭ => ЁЯТЭ, ржЖржмрзЗржЧ, ржнрзЗрж▓рзЗржгрзНржЯрж╛ржЗржи, рз░рж┐ржмржи, рз░рж┐ржмржи рж╕рж╣ рж╣рзГржжржпрж╝, рж╣рзГржжржпрж╝
ЁЯТЮ => ЁЯТЮ, ржЖржмрзЗржЧ, ржШрзБрз░рж┐ ржержХрж╛ рж╣рзГржжржпрж╝, ржкрзНрз░рзЗржо, рж╣рзГржжржпрж╝
ЁЯТЯ => ЁЯТЯ, рж╕ржЬрзНржЬрж┐ржд рж╣рзГржжржпрж╝, рж╣рзГржжржпрж╝
ЁЯТМ => ЁЯТМ, ржкрзНрз░рзЗржо ржкрждрзНрз░, рз░рзЛржорж╛ржЮрзНржЪ, рж╣рзГржжржпрж╝, рж╣рзГржжржпрж╝рз░ ржЪрж┐рж╣рзНржи рж╕рж╣ ржЪрж┐ржарж┐
ЁЯТд => ЁЯТд, ржЯрзЛржкржирж┐, ржирж╛ржХрз░ ржШрзЛрз░рзНржШрзЛрз░ржгрж┐, ржирж┐ржжрзНрз░рж╛ржоржЧрзНржи
ЁЯТв => ЁЯТв, ржЖржмрзЗржЧ, ржЦржВ, ржЦржЩрз░ ржЪрж┐рж╣рзНржи
ЁЯТг => ЁЯТг, ржЖржмрзЗржЧ, ржмржорзНржм
ЁЯТе => ЁЯТе, ржЖржмрзЗржЧ, рж╕ржВржШрз░рзНрж╖
ЁЯТж => ЁЯТж, ржШрж╛ржо, ржШрж╛ржо ржЫрж┐ржЯрж┐ржХрж┐ ржкрз░рж╛, ржШрж╛ржорзЛрз▒рж╛
ЁЯТи => ЁЯТи, ржЖржмрзЗржЧ, ржЬрзЛрз░рзЗ ржжрзМрз░рж╛, ржжрзМрз░рж╛
ЁЯТл => ЁЯТл, ржЖржЪржирзНржжрзНрз░рж╛ржЗ ржХрз░рж╛, рждрз░рж╛
ЁЯТм => ЁЯТм, ржЙржХрзНрждрж┐, ржЙржХрзНрждрж┐ ржмрж╛ржмрж▓, ржЙржХрзНрждрж┐ ржмрзЗрж▓рзБржи, ржХржорж┐ржХ, ржмржХрзНрждржмрзНржп ржмрж╛ржмрж▓, ржмржХрзНрждржмрзНржп ржмрзЗрж▓рзБржи
ЁЯТн => ЁЯТн, ржХржорж┐ржХ, ржЪрж┐ржирзНрждрж╛, ржЪрж┐ржирзНрждрж╛ ржмрж╛ржмрж▓, ржЪрж┐ржирзНрждрж╛ ржмрзЗрж▓рзБржи
ЁЯСУ => ЁЯСУ, ржЪржЪржорж╛, ржкрзЛржЪрж╛ржХ
ЁЯСФ => ЁЯСФ, ржирзЗржХржЯрж╛ржЗ, ржкрзЛржЪрж╛ржХ
ЁЯСХ => ЁЯСХ, ржЯрж┐-ржЪрж╛рз░рзНржЯ, ржкрзЛржЪрж╛ржХ
ЁЯСЦ => ЁЯСЦ, ржЯрзНрз░рж╛ржЙржЬрж╛рз░, ржкрзЗржгрзНржЯ, ржкрзЛржЪрж╛ржХ
ЁЯСЧ => ЁЯСЧ, ржбрзНрз░рзЗржЫ, ржорж╣рж┐рж▓рж╛рз░ ржкрзЛржЪрж╛ржХ
ЁЯСШ => ЁЯСШ, ржХрж┐ржорзЛржирзЛ, ржЬрж╛ржкрж╛ржирзА ржкрзЛржЪрж╛ржХ, ржкрзЛржЪрж╛ржХ
ЁЯСЩ => ЁЯСЩ, ржкрзЛржЪрж╛ржХ, ржмрж┐ржХрж┐ржирж┐, рж╕рж╛ржБрждрзЛрз░рз░ ржкрзЛржЪрж╛ржХ
ЁЯСЪ => ЁЯСЪ, ржкрзЛржЪрж╛ржХ, ржорж╣рж┐рж▓рж╛рз░ ржкрзЛржЪрж╛ржХ
ЁЯСЫ => ЁЯСЫ, ржзржи ржерзЛрз▒рж╛ ржорзЛржирж╛, ржкрж╛рз░рзНржЪ
ЁЯСЬ => ЁЯСЬ, рж╣рж╛рждржорзЛржирж╛, рж╣рзЗржгрзНржбржмрзЗржЧ
ЁЯСЭ => ЁЯСЭ, ржкрж╛ржЙржЪ, ржкрзЛржЪрж╛ржХ, ржмрзЗржЧ, ржорзЛржирж╛
ЁЯОТ => ЁЯОТ, рж╕рзНржХрзБрж▓, рж╕рзНржХрзБрж▓ ржмрзЗржЧ
ЁЯСЮ => ЁЯСЮ, ржЬрзЛрждрж╛, ржкрзБрз░рзБрж╖рз░ ржЬрзЛрждрж╛, ржкрзЛржЪрж╛ржХ
ЁЯСЯ => ЁЯСЯ, ржПржерж▓рзЗржЯрз░ ржЬрзЛрждрж╛, ржЬрзЛрждрж╛, ржкрзЛржЪрж╛ржХ, рж╕рзНржирзАржХрж╛рз░
ЁЯСа => ЁЯСа, ржЬрзЛрждрж╛, ржкрзЛржЪрж╛ржХ, рж╣рж╛ржЗ-рж╣рж┐рж▓
ЁЯСб => ЁЯСб, ржЪрзЗржгрзНржбрзЗрж▓, ржкрзЛржЪрж╛ржХ, ржорж╣рж┐рж▓рж╛рз░ ржЪрзЗржгрзНржбрзЗрж▓
ЁЯСв => ЁЯСв, ржкрзЛржЪрж╛ржХ, ржмрзБржЯ ржЬрзЛрждрж╛, ржорж╣рж┐рж▓рж╛рз░ ржмрзБржЯ
ЁЯСС => ЁЯСС, ржкрзЛржЪрж╛ржХ, ржорзБржХрзБржЯ
ЁЯСТ => ЁЯСТ, ржЯрзБржкрж┐, ржкрзЛржЪрж╛ржХ, ржорж╣рж┐рж▓рж╛рз░ ржЯрзБржкрж┐
ЁЯОй => ЁЯОй, ржЯржк рж╣рзЗржЯ, рж╣рзЗржЯ
ЁЯОУ => ЁЯОУ, ржЙржжржпрж╛ржкржи, ржХрзЗржк, ржЧрзНрз░рзЗржбрзБрз▒рзЗрж╢рзНржмржи ржХрзЗржк, ржЯрзБржкрж┐
ЁЯТД => ЁЯТД, ржХржЪржорзЗржЯрж┐ржХ, ржкрзНрз░рж╕рж╛ржзржи, ржорзЗржХржЖржк, рж▓рж┐ржкрж╖рзНржЯрж┐ржХ
ЁЯТН => ЁЯТН, ржЖржЩрзБржарж┐, рз░рзЛржорж╛ржЮрзНржЪ
ЁЯТО => ЁЯТО, ржоржгрж┐, ржоржгрж┐ ржкрж╛ржерз░, рз░рзЛржорж╛ржЮрзНржЪ, рж╣рзАрз░рж╛
ЁЯР╡ => ЁЯР╡, ржЬрзАрз▒, ржмрж╛ржирзНржжрз░, ржмрж╛ржирзНржжрз░рз░ ржорзБржЦ, ржорзБржЦ
ЁЯРТ => ЁЯРТ, ржЬржирзНрждрзБ, ржмрж╛ржирзНржжрз░
ЁЯР╢ => ЁЯР╢, ржХрзБржХрзБрз░, ржХрзБржХрзБрз░рз░ ржорзБржЦ, ржЬрзАрз▒, ржорзБржЦ
ЁЯРХ => ЁЯРХ, ржХрзБржХрзБрз░, ржХрзБржХрзБрз░рз░ ржкрзЛрз▒рж╛рж▓рзА
ЁЯРй => ЁЯРй, ржХрзБржХрзБрз░, ржХрзЗржХрзЛрз░рж╛ ржирзЛржорз░ ржХрзБржХрзБрз░, ржЬрзАрз▒
ЁЯР║ => ЁЯР║, ржХрзБржХрзБрз░ржирзЗржЪрзАржпрж╝рж╛ ржмрж╛ржШ, ржХрзБржХрзБрз░ржирзЗржЪрзАржпрж╝рж╛ ржмрж╛ржШрз░ ржорзБржЦ, ржЬрзАрз▒, ржорзБржЦ
ЁЯР▒ => ЁЯР▒, ржЬрзАрз▒, ржорзБржЦ, ржорзЗржХрзБрз░рзА, ржорзЗржХрзБрз░рзАрз░ ржорзБржЦ
ЁЯРИ => ЁЯРИ, ржЬржирзНрждрзБ, ржорзЗржХрзБрз░рж┐
ЁЯРп => ЁЯРп, ржЬрзАрз▒, ржмрж╛ржШ, ржмрж╛ржШрз░ ржорзБржЦ
ЁЯРЕ => ЁЯРЕ, ржЬржирзНрждрзБ, ржмрж╛ржШ
ЁЯРЖ => ЁЯРЖ, ржЬржирзНрждрзБ, ржирж╛рж╣рз░ржлрзБржЯрзБржХрзА ржмрж╛ржШ
ЁЯР┤ => ЁЯР┤, ржШрзЛржБрз░рж╛, ржШрзЛржБрз░рж╛рз░ ржорзБржЦ, ржЬрзАрз▒, ржорзБржЦ
ЁЯРО => ЁЯРО, ржШрзЛржБрз░рж╛, ржЬржирзНрждрзБ
ЁЯРо => ЁЯРо, ржЧрз░рзБ, ржЧрз░рзБрз░ ржорзБржЦ, ржЬрзАрз▒, ржорзБржЦ
ЁЯРВ => ЁЯРВ, ржЬржирзНрждрзБ, рж╖рж╛ржБржбрж╝
ЁЯРГ => ЁЯРГ, ржЬржирзНрждрзБ, ржотАЩрж╣
ЁЯРД => ЁЯРД, ржЧрз░рзБ, ржЬржирзНрждрзБ
ЁЯР╖ => ЁЯР╖, ржЧрж╛рж╣рз░рж┐, ржЧрж╛рж╣рз░рж┐рз░ ржорзБржЦ, ржЬрзАрз▒, ржорзБржЦ
ЁЯРЦ => ЁЯРЦ, ржЧрж╛рж╣рз░рж┐, ржЬржирзНрждрзБ
ЁЯРЧ => ЁЯРЧ, ржЬржирзНрждрзБ, ржмржиржЧрж╛рж╣рз░рж┐
ЁЯР╜ => ЁЯР╜, ржЧрж╛рж╣рз░рж┐, ржЧрж╛рж╣рз░рж┐рз░ ржирж╛ржХ, ржЬрзАрз▒
ЁЯРП => ЁЯРП, ржЬржирзНрждрзБ, рз░рж╛ржо ржЫрж╛ржЧрж▓рзА
ЁЯРС => ЁЯРС, ржЬржирзНрждрзБ, ржнрзЗржбрж╝рж╛
ЁЯРР => ЁЯРР, ржЫрж╛ржЧрж▓рзА, ржЬржирзНрждрзБ
ЁЯРк => ЁЯРк, ржЙржЯ, ржПржЯрж╛ ржХрзБржЬ ржержХрж╛ ржЙржЯ, ржЬрзАрз▒
ЁЯРл => ЁЯРл, ржЙржЯ, ржЬрзАрз▒, ржжрзБржЯрж╛ ржХрзБржЬ ржержХрж╛ ржЙржЯ
ЁЯРШ => ЁЯРШ, ржЬржирзНрждрзБ, рж╣рж╛рждрзА
ЁЯРн => ЁЯРн, ржЬрзАрз▒, ржирж┐ржЧржирж┐, ржирж┐ржЧржирж┐рз░ ржорзБржЦ
ЁЯРБ => ЁЯРБ, ржЬржирзНрждрзБ, ржирж┐ржЧржирж┐
ЁЯРА => ЁЯРА, ржПржирзНржжрзБрз░, ржЬржирзНрждрзБ
ЁЯР╣ => ЁЯР╣, ржЬрзАрз▒, ржорзБржЦ, рж╣рж╛ржорж╖рзНржЯрж╛рз░, рж╣рж╛ржорж╖рзНржЯрж╛рз░рз░ ржорзБржЦ
ЁЯР░ => ЁЯР░, ржПржирзНржжрзБрз░, ржПржирзНржжрзБрз░рз░ ржорзБржЦ, ржЬрзАрз▒, ржорзБржЦ
ЁЯРЗ => ЁЯРЗ, ржЬржирзНрждрзБ, рж╢рж╣рж╛ржкрж╣рзБ
ЁЯР╗ => ЁЯР╗, ржЬрзАрз▒, ржнрж╛рж▓рзБржХ, ржнрж╛рж▓рзБржХрз░ ржорзБржЦ, ржорзБржЦ
ЁЯРи => ЁЯРи, ржХрзЛрз▒рж╛рж▓рж╛, ржХрзЛрз▒рж╛рж▓рж╛ ржнрж╛рж▓рзБржХ, ржЬрзАрз▒
ЁЯР╝ => ЁЯР╝, ржЬрзАрз▒, ржкрж╛ржгрзНржбрж╛, ржкрж╛ржгрзНржбрж╛рз░ ржорзБржЦ, ржорзБржЦ
ЁЯР╛ => ЁЯР╛, ржЬржирзНрждрзБ, ржЬржирзНрждрзБрз░ ржнрз░рж┐рз░ ржкржЯрж╛, ржнрз░рж┐рз░ ржкржЯрж╛рз░ ржЪрж┐рж╣рзНржи
ЁЯРФ => ЁЯРФ, ржкржХрзНрж╖рзА, ржорж╛ржЗржХрзА ржорзВрз░рзНржЧрзА
ЁЯРУ => ЁЯРУ, ржкржХрзНрж╖рзА, ржорждрж╛ ржорзВрз░рзНржЧрзА
ЁЯРг => ЁЯРг, ржХржгрж┐ ржлрзБржЯрж┐ ржУрж▓рзЛрз▒рж╛ ржЪрз░рж╛ржЗ ржкрзЛрз▒рж╛рж▓рзА, ржЬрзАрз▒, ржкржХрзНрж╖рзА, ржорзВрз░рзНржЧрзА, ржорзВрз░рзНржЧрзА ржкрзЛрз▒рж╛рж▓рзА
ЁЯРд => ЁЯРд, ржЬрзАрз▒, ржкржХрзНрж╖рзА, ржкрзЛрз▒рж╛рж▓рзА, ржкрзЛрз▒рж╛рж▓рзА ржорзВрз░рзНржЧрзА, ржорзВрз░рзНржЧрзА
ЁЯРе => ЁЯРе, ржЬрзАрз▒, ржкржХрзНрж╖рзА, ржорзВрз░рзНржЧрзА, ржорзВрз░рзНржЧрзАрз░ ржкрзЛрз▒рж╛рж▓рзА, рж╕ржирзНржорзБржЦ ржорзБржЦрзА ржорзВрз░рзНржЧрзАрз░ ржкрзЛрз▒рж╛рж▓рзА
ЁЯРж => ЁЯРж, ржЪрз░рж╛ржЗ, ржЬрзАрз▒
ЁЯРз => ЁЯРз, ржЬрзАрз▒, ржкржХрзНрж╖рзА, ржкрзЗржЩрзНржЧрзБржЗржи
ЁЯР╕ => ЁЯР╕, ржЬрзАрз▒, ржнрзЗржХрзБрж▓рж┐, ржнрзЗржБржХрзБрж▓рж┐рз░ ржорзБржЦ, ржорзБржЦ
ЁЯРК => ЁЯРК, ржШрз░рж┐ржпрж╝рж╛рж▓, ржЬржирзНрждрзБ
ЁЯРв => ЁЯРв, ржХрж╛ржЫ, ржЬрзАрз▒
ЁЯРН => ЁЯРН, рж╕рз░рзАрж╕рзГржк, рж╕рж╛ржк
ЁЯР▓ => ЁЯР▓, ржЬрзАрз▒, ржбрзНрз░рзЗржЧржи, ржбрзНрз░рзЗржЧржирз░ ржорзБржЦ, ржорзБржЦ
ЁЯРЙ => ЁЯРЙ, ржЬржирзНрждрзБ, ржбрзНрз░рзЗржЧржи
ЁЯР│ => ЁЯР│, рждрж┐ржорж┐ ржорж╛ржЫ, ржлрзЛржБрз▒рж╛рз░рж╛ ржорз░рж╛ рждрж┐ржорж┐ ржорж╛ржЫ, ржорж╛ржЫ
ЁЯРЛ => ЁЯРЛ, ржЬржирзНрждрзБ, рждрж┐ржорж┐ржорж╛ржЫ
ЁЯРм => ЁЯРм, ржЬрзАрз▒, ржбрж▓ржлрж┐ржи
ЁЯРЯ => ЁЯРЯ, ржЬрзАрз▒, ржорж╛ржЫ
ЁЯРа => ЁЯРа, ржЬрж▓ржЬ ржЬрзАрз▒, ржмрж┐рж╖рзБрз▒рзАржпрж╝ ржорж╛ржЫ, ржорж╛ржЫ
ЁЯРб => ЁЯРб, ржЬрзАрз▒, ржмрзНрж▓рзЛржлрж┐ржЫ, ржорж╛ржЫ
ЁЯРЩ => ЁЯРЩ, ржЕржХрзНржЯрзЛржкрж╛ржЪ, ржЬржирзНрждрзБ
ЁЯРЪ => ЁЯРЪ, ржХрзБржгрзНржбрж▓рзАржпрж╝ ржЦрзЛрж▓рж╛, ржЦрзЛрж▓рж╛, ржЬржирзНрждрзБ
ЁЯРМ => ЁЯРМ, ржЬржирзНрждрзБ, рж╢рж╛ржорзБржХ
ЁЯРЫ => ЁЯРЫ, ржЪрзЗрж▓рж╛, ржкрж▓рзБ, ржкрзЛржХ, ржмрж┐ржЫрж╛
ЁЯРЬ => ЁЯРЬ, ржкрз░рзБрз▒рж╛, ржкрзЛржХ
ЁЯРЭ => ЁЯРЭ, ржкрждржВржЧ, ржорж╛ржЦрж┐, ржорзМржорж╛ржЦрж┐
ЁЯРЮ => ЁЯРЮ, ржЧрзБржмрз░рзБрз▒рж╛ ржкрзЛржХ, ржкрждржВржЧ, рж╕рзЛржгржкрзЛржХ
ЁЯТР => ЁЯТР, ржлрзБрж▓, ржлрзБрж▓рз░ ржерзЛржкрж╛, ржмтАЩржХрзЗржЯ, рз░рзЛржорж╛ржЮрзНржЪ
ЁЯМ╕ => ЁЯМ╕, ржЪрзЗрз░рзА, ржЪрзЗрз░рзА ржкрзБрж╖рзНржк, ржлрзБрж▓, ржлрзБрж▓ ржжрз░рзНрж╢ржи
ЁЯТо => ЁЯТо, ржлрзБрж▓, ржлрзБрж▓рз░ рж╖рзНржЯрж╛ржорзНржк, рж╢рзБржн рж╕ржорзНржкржирзНржи рж╖рзНржЯрж╛ржорзНржк, рж╖рзНржЯрж╛ржорзНржк
ЁЯМ╣ => ЁЯМ╣, ржЧрзЛрж▓рж╛ржк, ржлрзБрж▓
ЁЯМ║ => ЁЯМ║, ржЬржмрж╛ржлрзБрж▓, ржлрзБрж▓
ЁЯМ╗ => ЁЯМ╗, ржлрзБрж▓, рж╕рзВрз░рзНржпрзНржпржорзБржЦрзА ржлрзБрж▓
ЁЯМ╝ => ЁЯМ╝, ржкрзБрж╖рзНржк, ржлрзБрж▓
ЁЯМ╖ => ЁЯМ╖, ржЯрж┐ржЙрж▓рж┐ржк, ржлрзБрж▓
ЁЯМ▒ => ЁЯМ▒, ржЕржВржХрзБрз░, ржЧржЫржкрзБрж▓рж┐, ржкрзБрж▓рж┐
ЁЯМ▓ => ЁЯМ▓, ржЧржЫ, ржЪрж┐рз░рж╕рзЗржЙржЬ, ржЪрж┐рз░рж╕рзЗржЙржЬ ржЧржЫ
ЁЯМ│ => ЁЯМ│, ржЧржЫ, ржЫрж╛ржБ ржжрж┐ржпрж╝рж╛, ржЫрж╛ржБ ржжрж┐ржпрж╝рж╛ ржЧржЫ, ржкрз░рзНржгржкрж╛рждрзА
ЁЯМ┤ => ЁЯМ┤, ржЧржЫ, рждрж╛рж▓, рждрж╛рж▓ ржЧржЫ
ЁЯМ╡ => ЁЯМ╡, ржЙржжрзНржнрж┐ржж, ржХрзЗржХрзЗржЯрж╛ржЪ
ЁЯМ╛ => ЁЯМ╛, ржХрз░рзНржг, ржзрж╛ржи, ржзрж╛ржи ржЧржЫ, ржзрж╛ржирз░ ржХрз░рзНржг
ЁЯМ┐ => ЁЯМ┐, ржФрж╖ржзрзА, ржкрж╛ржд
ЁЯНА => ЁЯНА, ржШрж╛ржБрж╣, ржЪрж╛рз░рж┐ржЦрж┐рж▓рж╛ ржкрж╛рждрз░ ржШрж╛ржБрж╣, ржкрж╛ржд, ржнрж╛ржЧрзНржпржмрж╛ржи
ЁЯНБ => ЁЯНБ, ржкрж╛ржд, ржорзЗржкрж▓ ржкрж╛ржд, рж╕рз░рж┐ ржкрз░рж╛ ржкрж╛ржд
ЁЯНВ => ЁЯНВ, ржкрж╛ржд, рж╕рз░рж╛ ржкрж╛ржд, рж╕рз░рж┐ ржкрз░рж╛, рж╕рз░рж┐ ржкрз░рж╛ ржкрж╛ржд
ЁЯНГ => ЁЯНГ, ржкрж╛ржд, ржмрждрж╛рж╣, ржмрждрж╛рж╣ ржмрж▓рж╛, ржмрждрж╛рж╣ржд ржкрж╛ржд
ЁЯНЗ => ЁЯНЗ, ржЖржЩрзБрз░, ржлрж▓
ЁЯНИ => ЁЯНИ, рждрз░ржорзБржЬ, ржлрж▓рж╛
ЁЯНЙ => ЁЯНЙ, рждрз░ржорзБржЬ, ржлрж▓
ЁЯНК => ЁЯНК, ржХржорж▓рж╛, ржлрж▓, ржорзМржЪрзБржорзА ржЯрзЗржЩрж╛
ЁЯНЛ => ЁЯНЛ, ржирзЗржорзБ, ржирзЗржорзБ ржЯрзЗржЩрж╛, ржлрж▓
ЁЯНМ => ЁЯНМ, ржХрж▓, ржлрж▓
ЁЯНН => ЁЯНН, ржЖржирж╛рз░рж╕, ржлрж▓
ЁЯНО => ЁЯНО, ржЖржкрзЗрж▓, ржлрж▓, рз░ржЩрж╛, рз░ржЩрж╛ ржЖржкрзЗрж▓
ЁЯНП => ЁЯНП, ржЖржкрзЗрж▓, ржлрж▓, рж╕рзЗржЙржЬрзАржпрж╝рж╛, рж╕рзЗржЙржЬрзАржпрж╝рж╛ ржЖржкрзЗрж▓
ЁЯНР => ЁЯНР, ржирж╛ржЪржкрждрж┐, ржлрж▓
ЁЯНС => ЁЯНС, ржирз░рж╛ржмржЧрз░рж┐, ржлрж▓
ЁЯНТ => ЁЯНТ, ржЪрзЗрз░рзА, ржлрж▓
ЁЯНУ => ЁЯНУ, ржлрж▓, ржмрзЗрз░рзА, рж╖рзНржЯтАЩржмрзЗрз░рзА
ЁЯНЕ => ЁЯНЕ, ржкрж╛ржЪрж▓рж┐, ржмрж┐рж▓рж╛рж╣рзА
ЁЯНЖ => ЁЯНЖ, ржкрж╛ржЪрж▓рж┐, ржмрзЗржЩрзЗржирж╛
ЁЯМ╜ => ЁЯМ╜, ржХрз░рзНржг, ржЧрзЛржоржзрж╛ржи, ржорж╛ржХрзИ
ЁЯНД => ЁЯНД, ржХрж╛ржаржлрзБрж▓рж╛
ЁЯМ░ => ЁЯМ░, ржмрж╛ржжрж╛ржо
ЁЯНЮ => ЁЯНЮ, ржкрж╛ржЙрз░рзБржЯрзА, ржкрж╛ржУрз░рзБржЯрзАрз░ рж▓рзЛржл, рз░рзЗрж╖рзНржЯрзБрз░рзЗржгрзНржЯ
ЁЯНЦ => ЁЯНЦ, ржорж╛ржВрж╕, рз░рзЗрж╖рзНржЯрзБрз░рзЗржгрзНржЯ, рж╣рж╛ржбрж╝ рж╕рж╣ ржорж╛ржВрж╕
ЁЯНЧ => ЁЯНЧ, ржХрзБржХрзБрз░рж╛ ржорж╛ржВрж╕, ржХрзБржХрзБрз░рж╛ ржорж╛ржВрж╕рз░ ржарзЗржВ, ржарзЗржВ, рз░рзЗрж╖рзНржЯрзБрз░рзЗржгрзНржЯ
ЁЯНФ => ЁЯНФ, ржмрж╛рз░рзНржЧрж╛рз░, рз░рзЗрж╖рзНржЯрзБрз░рзЗржгрзНржЯ, рж╣рзЗржоржмрж╛рз░рзНржЧрж╛рз░
ЁЯНЯ => ЁЯНЯ, ржлрзНрз░рзЗржирзНрж╕ ржлрзНрз░рж╛ржЗ, ржнржЬрж╛, рз░рзЗрж╖рзНржЯрзБрз░рзЗржгрзНржЯ
ЁЯНХ => ЁЯНХ, ржЯрзБржХрзБрз░рж╛, ржкрж┐ржЬрзНржЬрж╛, ржкрж┐ржЬрзНржЬрж╛рз░ ржЯрзБржХрзБрз░рж╛, рз░рзЗрж╖рзНржЯрзБрз░рзЗржгрзНржЯ
ЁЯН│ => ЁЯН│, рждрж╛рз▒рж╛, рз░ржирзНржзрж╛, рз░рзЗрж╖рзНржЯрзБрз░рзЗржгрзНржЯ
ЁЯН▓ => ЁЯН▓, ржЦрж╛ржжрзНржпрз░ ржмрж╛рждрж┐, рз░рзЗрж╖рзНржЯрзБрз░рзЗржгрзНржЯ, рж╖рзНржЯрж┐ржЙ
ЁЯН▒ => ЁЯН▒, ржмрзЗржирзНржЯрзБ, ржмрзЗржирзНржЯрзБ ржмржХрзНрж╕, рз░рзЗрж╖рзНржЯрзБрз░рзЗржгрзНржЯ
ЁЯНШ => ЁЯНШ, ржЪрж╛ржЙрж▓, ржЪрж╛ржЙрж▓ ржЦрзБржирзНржжрж╛ ржЦрзБржирзНржжржирж╛
ЁЯНЩ => ЁЯНЩ, ржЕржирж┐ржЧрж┐рз░рж┐, ржЪрж╛ржЙрж▓, ржЪрж╛ржЙрж▓рз░ ржЧрзЛрж▓рж╛, рз░рзЗрж╖рзНржЯрзБрз░рзЗржгрзНржЯ
ЁЯНЪ => ЁЯНЪ, ржнрж╛ржд, рз░ржирзНржзрж╛ ржнрж╛ржд, рз░рзЗрж╖рзНржЯрзБрз░рзЗржгрзНржЯ
ЁЯНЫ => ЁЯНЫ, ржЖржЮрзНржЬрж╛, ржЖржЮрзНржЬрж╛ ржЖрз░рзБ ржнрж╛ржд, ржнрж╛ржд, рз░рзЗрж╖рзНржЯрзБрз░рзЗржгрзНржЯ
ЁЯНЬ => ЁЯНЬ, ржирзБржбрж▓, ржирзБржбрж▓рз░ ржмрж╛рждрж┐, ржмрж╛рждрж┐, ржнрж╛ржк ржУрж▓рж╛ржЗ ржержХрж╛, рз░рж╛ржорзЗржи, рз░рзЗрж╖рзНржЯрзБрз░рзЗржгрзНржЯ
ЁЯНЭ => ЁЯНЭ, ржкрж╛рж╖рзНржЯрж╛, рз░рзЗрж╖рзНржЯрзБрз░рзЗржгрзНржЯ, рж╕рзНржкрж╛ржШрзЗржЯрж┐
ЁЯНа => ЁЯНа, ржЖрж▓рзБ, ржорж┐ржарж╛ ржЖрж▓рзБ, рж╕рзЗржХрж╛ ржЖрж▓рзБ
ЁЯНв => ЁЯНв, ржЕтАЩржбрзЗржи, ржЦрз░рж┐ржХрж╛, ржЦрз░рж┐ржХрж╛ржд ржжрж┐ржпрж╝рж╛ рж╕рж╛ржЧрз░рзАржпрж╝ ржЦрж╛ржжрзНржп, рз░рзЗрж╖рзНржЯрзБрз░рзЗржгрзНржЯ
ЁЯНг => ЁЯНг, ржЪрзБржЪрж┐, рз░рзЗрж╖рзНржЯрзБрз░рзЗржгрзНржЯ
ЁЯНд => ЁЯНд, ржнржЬрж╛ ржорж┐ржЫрж╛ржорж╛ржЫ, ржорж┐ржЫрж╛ржорж╛ржЫ, рз░рзЗрж╖рзНржЯрзБрз░рзЗржгрзНржЯ
ЁЯНе => ЁЯНе, ржШрзБрз░ржгрзАржпрж╝рж╛ ржбрж┐ржЬрж╛ржЗржирз░ рж╕рзИрждрзЗ ржорж╛ржЫрз░ ржХрзЗржХ, ржорж╛ржЫ, ржорж╛ржЫрз░ ржХрзЗржХ, рз░рзЗрж╖рзНржЯрзБрз░рзЗржгрзНржЯ
ЁЯНб => ЁЯНб, ржЦрз░рж┐ржХрж╛ржд ржжрж┐ржпрж╝рж╛ ржорзЛржЪрж┐ ржмрж▓, ржбрзЗржЩрзНржЧрзЛ, ржорзЛржЪрж┐, ржорзЛржЪрж┐ ржмрж▓, рз░рзЗрж╖рзНржЯрзБрз░рзЗржгрзНржЯ
ЁЯНж => ЁЯНж, ржЖржЗржЪ ржХрзНрз░рзАржо, ржХрзЛржорж▓ ржЖржЗржЪ ржХрзНрз░рзАржо, ржХрзНрз░рзАржо, рз░рзЗрж╖рзНржЯрзБрз░рзЗржгрзНржЯ
ЁЯНз => ЁЯНз, ржЪрзЗржнржб ржЖржЗржЪ, рз░рзЗрж╖рзНржЯрзБрз░рзЗржгрзНржЯ
ЁЯНи => ЁЯНи, ржЖржЗржЪ, ржЖржЗржЪ ржХрзНрз░рзАржо, ржХрзНрз░рзАржо, рз░рзЗрж╖рзНржЯрзБрз░рзЗржгрзНржЯ
ЁЯНй => ЁЯНй, ржбтАЩржирж╛ржЯ, рз░рзЗрж╖рзНржЯрзБрз░рзЗржгрзНржЯ
ЁЯНк => ЁЯНк, ржХрзБржБржХрж┐, рз░рзЗрж╖рзНржЯрзБрз░рзЗржгрзНржЯ
ЁЯОВ => ЁЯОВ, ржЙржжржпрж╛ржкржи, ржХрзЗржХ, ржЬржирзНржоржжрж┐ржи, ржЬржирзНржоржжрж┐ржирз░ ржХрзЗржХ
ЁЯН░ => ЁЯН░, ржХржЯрж╛ ржХрзЗржХ, рз░рзЗрж╖рзНржЯрзБрз░рзЗржгрзНржЯ, рж╢рзНрж▓рж╛ржЗржЪржб ржХрзЗржХ
ЁЯНл => ЁЯНл, ржЪржХрж▓рзЗржЯ, ржЪржХрж▓рзЗржЯ ржмрж╛рз░, рз░рзЗрж╖рзНржЯрзБрз░рзЗржгрзНржЯ
ЁЯНм => ЁЯНм, ржХрзЗржгрзНржбрзА, рз░рзЗрж╖рзНржЯрзБрз░рзЗржгрзНржЯ
ЁЯНн => ЁЯНн, ржХрзЗржгрзНржбрж┐, рз░рзЗрж╖рзНржЯрзБрз░рзЗржгрзНржЯ, рж▓рж▓рж┐ржкржк
ЁЯНо => ЁЯНо, ржХрж╛рж╖рзНржЯрж╛рз░рзНржб, ржкрзБржбрж┐ржВ, рз░рзЗрж╖рзНржЯрзБрз░рзЗржгрзНржЯ
ЁЯНп => ЁЯНп, ржмрж╛рждрж┐, ржорзМ, ржорзМрз░ ржмрж╛рждрж┐, рз░рзЗрж╖рзНржЯрзБрз░рзЗржгрзНржЯ
ЁЯН╝ => ЁЯН╝, ржХрзЗржБржЪрзБрз▒рж╛рз░ ржмржЯрж▓, ржЧрж╛ржЦрзАрз░ ржЦрзЛрз▒рж╛ ржмржЯрж▓
ЁЯН╡ => ЁЯН╡, ржЪрж╛рж╣, ржЪрж╛рж╣рз░ ржкрж┐ржпрж╝рж▓рж╛, ржкрж┐ржпрж╝рж▓рж╛
ЁЯН╢ => ЁЯН╢, ржХрж╛ржк, ржмржЯрж▓, ржмржЯрж▓ ржЖрз░рзБ ржХрж╛ржк, ржмрж╛рз░, рз░рзЗрж╖рзНржЯрзБрз░рзЗржгрзНржЯ
ЁЯН╖ => ЁЯН╖, ржЧрж┐рж▓рж╛ржЪ, ржмрж╛рз░, рз░рзЗрж╖рзНржЯрзБрз░рзЗржгрзНржЯ, рз▒рж╛ржЗржи, рз▒рж╛ржЗржирз░ ржЧрж┐рж▓рж╛ржЪ, рж╕рзБрз░рж╛
ЁЯН╕ => ЁЯН╕, ржХржХржЯрзЗржЗрж▓, ржХржХржЯрзЗржЗрж▓ ржЧрж┐рж▓рж╛ржЪ, ржмрж╛рз░, рз░рзЗрж╖рзНржЯрзБрз░рзЗржгрзНржЯ
ЁЯН╣ => ЁЯН╣, ржЯрзНрз░тАЩржкрж┐ржХрзЗрж▓ ржбрзНрз░рж┐ржВржХ, ржбрзНрз░рж┐ржВржХ, ржмрж╛рз░, рз░рзЗрж╖рзНржЯрзБрз░рзЗржгрзНржЯ
ЁЯН║ => ЁЯН║, ржмрж╛рз░, ржмрж┐ржпрж╝рзЗрз░, ржмрж┐ржпрж╝рзЗрз░ ржоржЧ, ржоржЧ, рз░рзЗрж╖рзНржЯрзБрз░рзЗржгрзНржЯ
ЁЯН╗ => ЁЯН╗, ржмрж╛рз░, ржмрж┐ржпрж╝рзЗрз░, ржмрж┐ржпрж╝рзЗрз░ ржоржЧ, ржмрж┐ржпрж╝рзЗрз░ ржоржЧрз░ ржЦрзБржирзНржжрж╛, рз░рзЗрж╖рзНржЯрзБрз░рзЗржгрзНржЯ
ЁЯН┤ => ЁЯН┤, ржХрж╛ржЯрж╛ржЪрж╛ржорзБржЪ, ржХрж╛ржЯрж╛ржЪрж╛ржорзБржЪ ржЖрз░рзБ ржЪрзБрз░рж┐, ржЪрзБрз░рж┐, рз░рзЗрж╖рзНржЯрзБрз░рзЗржгрзНржЯ
ЁЯФк => ЁЯФк, ржХржЯрж╛рз░рзА, ржЪрзБрз░рж┐, рз░ржирзНржзрж╛ ржЪрзБрз░рж┐
ЁЯМН => ЁЯМН, ржЖржлрзНрз░рж┐ржХрж╛, ржЗржЙрз░рзЛржк, ржЧрзЛрж▓ржХ, ржкрзГржерж┐ржмрзА
ЁЯМО => ЁЯМО, ржЖржорзЗрз░рж┐ржХрж╛, ржЧрзЛрж▓ржХ, ржкрзГржерж┐ржмрзА
ЁЯМП => ЁЯМП, ржЕрж╖рзНржЯрзНрз░рзЗрж▓рзАржпрж╝рж╛, ржПржЪрж┐ржпрж╝рж╛, ржЧрзЛрж▓ржХ, ржкрзГржерж┐ржмрзА
ЁЯМР => ЁЯМР, ржЧрзЛрж▓ржХ, ржнрзВржоржзрзНржп
ЁЯЧ╛ => ЁЯЧ╛, ржЬрж╛ржкрж╛ржи, ржЬрж╛ржкрж╛ржирз░ ржорзЗржк, ржорзЗржк
ЁЯМЛ => ЁЯМЛ, ржЖржЧрзНржирзЗржпрж╝ржЧрж┐рз░рж┐, ржЖржЧрзНржирзЗржпрж╝ржЧрж┐рз░рж┐ ржЙржжрзНржЧрж┐рз░ржг
ЁЯЧ╗ => ЁЯЧ╗, ржкрз░рзНржмржд, ржорж╛ржЙржгрзНржЯ ржлрж┐ржЬрж┐
ЁЯПа => ЁЯПа, ржЖржЯрзНржЯрж╛рж▓рж┐ржХрж╛, ржЧрзГрж╣, ржШрз░
ЁЯПб => ЁЯПб, ржШрз░, ржмрж╛ржЧрж┐ржЪрж╛рз░ рж╕рзИрждрзЗ ржШрз░
ЁЯПв => ЁЯПв, ржЕржЯрзНржЯрж╛рж▓рж┐ржХрж╛, ржЕржлрж┐ржЪ, ржЕржлрж┐ржЪ ржШрз░, ржХрж╛рз░рзНржпрж╛рж▓ржпрж╝
ЁЯПг => ЁЯПг, ржЬрж╛ржкрж╛ржирзА ржкрзЛрж╖рзНржЯ ржЕржлрж┐ржЪ, ржкрзЛрж╖рзНржЯ ржЕржлрж┐ржЪ
ЁЯПд => ЁЯПд, ржЗржЙрз░рзЛржкрж┐ржпрж╝рж╛ржи ржкрзЛрж╖рзНржЯ ржЕржлрж┐ржЪ, ржкрзЛрж╖рзНржЯ ржЕржлрж┐ржЪ
ЁЯПе => ЁЯПе, ржЪрж┐ржХрж┐рзОрж╕рж╛рж▓ржпрж╝, ржмрж┐рж▓рзНржбрж┐ржВ, рж╣рж╕рзНржкрж┐ржЯрж╛рж▓
ЁЯПж => ЁЯПж, ржЧрзГрж╣, ржмрзЗржВржХ
ЁЯПи => ЁЯПи, ржмрж┐ржЪржирж╛, рж╣рзЛржЯрзЗрж▓
ЁЯПй => ЁЯПй, ржкрзНрз░рзЗржо ржмрж┐ржЪржирж╛, ржмрж┐ржЪржирж╛, рж╣рзЛржЯрзЗрж▓
ЁЯПк => ЁЯПк, ржжрзЛржХрж╛ржи, ржмрж┐рж▓рзНржбрж┐ржВ, рж╕рзБрж▓ржн ржорзВрж▓рзНржпрз░ ржжрзЛржХрж╛ржи
ЁЯПл => ЁЯПл, ржмрж┐ржжрзНржпрж╛рж▓ржпрж╝, рж╕рзНржХрзБрж▓
ЁЯПм => ЁЯПм, ржбрж┐ржкрж╛рз░ржЯржорзЗржгрзНржЯ рж╖рзНржЯтАЩрз░, ржжрзЛржХрж╛ржи
ЁЯПн => ЁЯПн, ржХрж╛рз░ржЦрж╛ржирж╛, ржлрзЗржХрзНржЯрз░рзА
ЁЯПп => ЁЯПп, ржЕржЯрзНржЯрж╛рж▓рж┐ржХрж╛, ржЬрж╛ржкрж╛ржирзА ржжрзБрз░рзНржЧ, ржжрзБрз░рзНржЧ
ЁЯП░ => ЁЯП░, ржЕржЯрзНржЯрж╛рж▓рж┐ржХрж╛, ржЗржЙрз░рзЛржкрзАржпрж╝рж╛ржи ржжрзБрз░рзНржЧ, ржжрзБрз░рзНржЧ
ЁЯТТ => ЁЯТТ, ржЧрзАрз░рзНржЬрж╛, ржмрж┐ржмрж╛рж╣, ржмрж┐ржмрж╛рж╣ ржЧрзАрз░рзНржЬрж╛ржШрз░, рз░рзЛржорж╛ржЮрзНржЪ
ЁЯЧ╝ => ЁЯЧ╝, ржЯржХрж┐ржЕтАЩ, ржЯржХрж┐ржЕтАЩ ржЯрж╛рз▒рж╛рз░, рж╕рзНрждржорзНржн
ЁЯЧ╜ => ЁЯЧ╜, ржорзВрз░рзНрждрж┐, рж╖рзНржЯрзЗржЪрзНржпрзБ ржЕржл рж▓рж┐ржмрж╛рз░ржЯрж┐, рж╕рзНржмрждржирзНрждрзНрз░рждрж╛
тЫк => тЫк, ржЧрзАрз░рзНржЬрж╛, ржЧрзГрж╣
тЫ▓ => тЫ▓, ржлрж╛ржЙржгрзНржЯрзЗржЗржи
тЫ║ => тЫ║, рждржорзНржмрзБ, рж╢рж┐ржмрж┐рз░
ЁЯМБ => ЁЯМБ, ржХрзБржБрз▒рж▓рзА, ржХрзБржБрз▒рж▓рзАржоржпрж╝
ЁЯМГ => ЁЯМГ, рждрз░рж╛, рз░рж╛рждрж┐, рз░рж╛рждрж┐рз░ рждрз░рж╛
ЁЯМД => ЁЯМД, ржкрз░рзНржмржд, ржкрз░рзНржмрждрз░ ржУржкрз░рзЗржжрж┐ рж╕рзВрз░рзНржпрзЛржжржпрж╝, рз░рж╛рждрж┐ржкрзБрз▒рж╛рз░ рж╕рзВрз░рзНржп, рж╕рзВрз░рзНржпрзЛржжржпрж╝
ЁЯМЕ => ЁЯМЕ, рз░рж╛рждрж┐ржкрзБрз▒рж╛рз░ рж╕рзВрз░рзНржп, рж╕рзВрз░рзНржпрзЛржжржпрж╝
ЁЯМЖ => ЁЯМЖ, ржЕржЯрзНржЯрж╛рж▓рж┐ржХрж╛, ржЧржзрзБрж▓рж┐, ржЪрж╣рз░, рж▓рзЗржгрзНржбрж╕рзНржХрзЗржк, рж╕ржирзНржзрзНржпрж╛, рж╕ржирзНржзрзНржпрж╛рз░ ржЪрж╣рз░, рж╕рзВрз░рзНржпрж╛рж╕рзНржд
ЁЯМЗ => ЁЯМЗ, ржЕржЯрзНржЯрж╛рж▓рж┐ржХрж╛, ржЕржЯрзНржЯрж╛рж▓рж┐ржХрж╛рз░ ржУржкрз░рзЗржжрж┐ рж╕рзВрз░рзНржпрж╛рж╕рзНржд, рж╕ржирзНржзрзНржпрж╛, рж╕рзВрз░рзНржпрж╛рж╕рзНржд
ЁЯМЙ => ЁЯМЙ, ржирж┐рж╢рж╛, ржирж┐рж╢рж╛рз░ ржжрж▓ржВ, ржирзИрж╢ ржжрж▓ржВ
ЁЯММ => ЁЯММ, рж╣рж╛рждрзА-ржкржЯрж┐
ЁЯОа => ЁЯОа, ржХрзЗрз░ржЪрзЗрж▓, ржХрзЗрз░ржЪрзЗрж▓ ржШрзЛрз░рж╛, ржШрзЛрз░рж╛, ржоржирзЛрз░ржЮрзНржЬржи
ЁЯОб => ЁЯОб, ржЪржХрж╛, ржлрзЗрз░рж┐ржЪ, ржлрзЗрз░рж┐ржЪ ржЪржХрж╛, ржмрж┐ржирзЛржжржи ржкрж╛рз░рзНржХ, ржоржирзЛрз░ржЮрзНржЬржи
ЁЯОв => ЁЯОв, ржХрзЛрж╖рзНржЯрж╛рз░, ржмрж┐ржирзЛржжржи ржкрж╛рз░рзНржХ, ржоржирзЛрз░ржЮрзНржЬржи, рз░рзЛрж▓рж╛рз░, рз░рзЛрж▓рж╛рз░ ржХтАЩрж╖рзНржЯрж╛рз░
ЁЯТИ => ЁЯТИ, ржирж╛ржкрж┐ржд, ржирж╛ржкрж┐рждрз░ ржжрзЛржХрж╛ржи
ЁЯОк => ЁЯОк, ржЪрж╛рз░рзНржХрж╛ржЪрз░ рждржорзНржмрзБ, рждржорзНржмрзБ, ржоржирзЛрз░ржЮрзНржЬржи
ЁЯОн => ЁЯОн, ржХрж▓рж╛, ржкрзНрз░ржжрз░рзНрж╢ржиржорзВрж▓ржХ ржХрж▓рж╛, ржоржирзЛрз░ржЮрзНржЬржи, ржорзБржЦрж╛
ЁЯОи => ЁЯОи, ржЪрж┐рждрзНрз░рж╢рж┐рж▓рзНржкрж┐, ржЪрж┐рждрзНрз░рж╢рж┐рж▓рзНржкрж┐рз░ ржкрзЗрж▓рзЗржЯ, рз░ржВ, рз░ржЩрз░ ржкрзЗрж▓рзЗржЯ, рж╢рж┐рж▓рзНржкржХрж▓рж╛
ЁЯО░ => ЁЯО░, ржЦрзЗрж▓, рж╢рзНрж▓тАЩржЯ, рж╢рзНрж▓тАЩржЯ ржорзЗржЪрж┐ржи
ЁЯЪВ => ЁЯЪВ, ржЯрзНрз░рзЗржЗржи, ржмрж╛рж╣ржи, ржнрж╛ржк ржЗржЮрзНржЬрж┐ржи, рз░рзЗрж▓ ржЗржЮрзНржЬрж┐ржи
ЁЯЪГ => ЁЯЪГ, ржЯрзНрз░рж╛ржо, ржЯрзНрз░рзЗржЗржи, ржмрж╛рж╣ржи, ржмрзИржжрзНржпрзБрждрж┐ржХ, ржмрзИржжрзНржпрзБрждрж┐ржХ ржЯрзНрз░рзЗржЗржи, рз░рзЗрж▓ ржХрж╛рз░, рз░рзЗрж▓рз▒рзЗ
ЁЯЪД => ЁЯЪД, ржЙржЪрзНржЪ-ржЧрждрж┐рз░ ржЯрзНрз░рзЗржЗржи, ржмрж╛рж╣ржи, ржмрзБрж▓рзЗржЯ ржЯрзНрз░рзЗржЗржи
ЁЯЪЕ => ЁЯЪЕ, ржЙржЪрзНржЪ ржЧрждрж┐рз░ ржЯрзНрз░рзЗржЗржи, ржЯрзНрз░рзЗржЗржи, ржмрж╛рж╣ржи, ржмрзБрж▓рзЗржЯ ржирж╛ржХ, ржмрзБрж▓рзЗржЯ ржирж╛ржХ рж╕рж╣ ржЙржЪрзНржЪ ржЧрждрж┐рз░ ржЯрзНрз░рзЗржЗржи
ЁЯЪЖ => ЁЯЪЖ, ржЯрзНрз░рзЗржЗржи, ржмрж╛рж╣ржи, рз░рзЗрж▓
ЁЯЪЗ => ЁЯЪЗ, ржЪрж╛ржмрз▒рзЗ, ржмрж╛рж╣ржи, ржорзЗржЯрзНрз░тАЩ рз░рзЗрж▓
ЁЯЪИ => ЁЯЪИ, ржкрж╛рждрж▓, ржкрж╛рждрж▓ рз░рзЗрж▓, ржмрж╛рж╣ржи, рз░рзЗрж▓
ЁЯЪЙ => ЁЯЪЙ, рз░рзЗрж▓, рз░рзЗрж▓ рж╖рзНржЯрзЗржЪржи, рж╖рзНржЯрзЗржЪржи
ЁЯЪК => ЁЯЪК, ржЯрзНрз░рж╛ржо, ржмрж╛рж╣ржи
ЁЯЪЭ => ЁЯЪЭ, ржмрж╛рж╣ржи, ржорзЛржирзЛрз░рзЗрж▓
ЁЯЪЮ => ЁЯЪЮ, ржкрз░рзНржмржд, ржкрз░рзНржмрждрзАржпрж╝рж╛ ржХрзЗржмрж▓ ржХрж╛рз░, ржкрз░рзНржмрждрзАржпрж╝рж╛ рз░рзЗрж▓, ржмрж╛рж╣ржи, рз░рзЗрж▓рз▒рзЗ
ЁЯЪЛ => ЁЯЪЛ, ржХрж╛рз░, ржЯрзНрз░рж╛ржо, ржЯрзНрз░рж╛ржо ржХрж╛рз░, ржмрж╛рж╣ржи
ЁЯЪМ => ЁЯЪМ, ржмрж╛ржЫ, ржмрж╛рж╣ржи
ЁЯЪН => ЁЯЪН, ржЖрж╣рж┐ ржержХрж╛, ржЖрж╣рж┐ ржержХрж╛ ржмрж╛ржЫ, ржмрж╛ржЫ, ржмрж╛рж╣ржи
ЁЯЪО => ЁЯЪО, ржЯрзНрз░рж▓рзА, ржЯрзНрз░рж▓рзАржмрж╛ржЫ, ржмрж╛ржЫ, ржмрж╛рж╣ржи
ЁЯЪР => ЁЯЪР, ржмрж╛ржЫ, ржмрж╛рж╣ржи, ржорж┐ржирж┐ржмрж╛ржЫ
ЁЯЪС => ЁЯЪС, ржПржорзНржмрзБрж▓рзЗржирзНрж╕, ржмрж╛рж╣ржи
ЁЯЪТ => ЁЯЪТ, ржЕржЧрзНржирж┐ржирж┐рз░рзНржмрж╛ржкржХ ржЧрж╛ржбрж╝рзА, ржЕржЧрзНржирж┐ржирж┐рз░рзНржмрж╛ржкржХ ржЯрзНрз░рж╛ржХ, ржЬрзБржЗ, ржмрж╛рж╣ржи
ЁЯЪУ => ЁЯЪУ, ржЖрз░ржХрзНрж╖рзА, ржЖрз░ржХрзНрж╖рзАрз░ ржмрж╛рж╣ржи, ржкрзЗржЯрзНрз░рж▓ ржХрж╛рз░, ржмрж╛рж╣ржи
ЁЯЪФ => ЁЯЪФ, ржЖрз░ржХрзНрж╖рзА, ржЖрз░ржХрзНрж╖рзАрз░ ржмрж╛рж╣ржи, ржЖрж╣рж┐ ржержХрж╛ ржЖрз░ржХрзНрж╖рзАрз░ ржмрж╛рж╣ржи, ржмрж╛рж╣ржи
ЁЯЪХ => ЁЯЪХ, ржЯрзЗржХрзНрж╕рж┐, ржмрж╛рж╣ржи
ЁЯЪЦ => ЁЯЪЦ, ржЖрж╣рж┐ ржержХрж╛ ржЯрзЗржХрзНрж╕рж┐, ржЯрзЗржХрзНрж╕рж┐, ржмрж╛рж╣ржи
ЁЯЪЧ => ЁЯЪЧ, ржЕржЯрзЛржорзЛржмрж╛ржЗрж▓, ржХрж╛рз░, ржмрж╛рж╣ржи
ЁЯЪШ => ЁЯЪШ, ржЕржЯрзЛржорзЛржмрж╛ржЗрж▓, ржЖрж╣рж┐ ржержХрж╛ ржЕржЯрзЛржорзЛржмрж╛ржЗрж▓, ржЖрж╣рж┐ ржержХрж╛ ржХрж╛рз░, ржХрж╛рз░, ржмрж╛рж╣ржи
ЁЯЪЩ => ЁЯЪЩ, ржЖрз░.ржнрж┐., ржмрж╛рж╣ржи, ржмрж┐ржирзЛржжржирз░ ржмрж╛рж╣ржи
ЁЯЪЪ => ЁЯЪЪ, ржЯрзНрз░рж╛ржХ, ржмрж╛рж╣ржХ, ржмрж┐рждрз░ржг ржЯрзНрз░рж╛ржХ
ЁЯЪЫ => ЁЯЪЫ, ржЪрзЗржорж┐, ржЯрзНрз░рж╛ржХ, ржЯрзНрз░рзЗржЗрж▓рж╛рз░, ржмрж╛рж╣ржи, ржпрзЛрз░рж╛ рж▓ржЧрзЛрз▒рж╛ рж▓рз░рзА, рж▓рз░рзА
ЁЯЪЬ => ЁЯЪЬ, ржЯрзНрз░рзЗржХрзНржЯрз░, ржмрж╛рж╣ржи
ЁЯЪ▓ => ЁЯЪ▓, ржЪрж╛ржЗржХрзЗрж▓, ржмрж╛ржЗржХ, ржмрж╛ржЗржЪрж╛ржЗржХрзЗрж▓, ржмрж╛рж╣ржи
ЁЯЪП => ЁЯЪП, ржЖрж╕рзНржерж╛ржи, ржмрж╛ржЫ, ржмрж╛ржЫ ржЖрж╕рзНржерж╛ржи
тЫ╜ => тЫ╜, ржЗржирзНржзржи, ржЗржирзНржзржи ржкрж╛ржорзНржк, ржкрзЗржЯрзНрз░тАЩрж▓ ржХрзЗржирзНржжрзНрз░, ржкрзЗржЯрзНрз░рж▓
ЁЯЪи => ЁЯЪи, ржЖрз░ржХрзНрж╖рзАрз░ ржмрж╛рж╣ржи, ржЖрз░ржХрзНрж╖рзАрз░ рж▓рж╛ржЗржЯ, ржШрзВрз░рзНржгрзАржпрж╝ржорж╛ржи рж▓рж╛ржЗржЯ, рз░ржЩрж╛ рж▓рж╛ржЗржЯ
ЁЯЪе => ЁЯЪе, ржЯрзНрз░рзЗржлрж┐ржХ, ржЯрзНрз░рзЗржлрж┐ржХ ржЪрж┐ржЧржирзЗрж▓, ржЯрзНрз░рзЗржлрж┐ржХ рж▓рж╛ржЗржЯ, ржкржерж╛рж▓рж┐ ржЯрзНрз░рзЗржлрж┐ржХ рж▓рж╛ржЗржЯ, рж▓рж╛ржЗржЯ
ЁЯЪж => ЁЯЪж, ржЙрж▓ржорзНржм ржЯрзНрз░рзЗржлрж┐ржХ рж▓рж╛ржЗржЯ, ржЯрзНрз░рзЗржлрж┐ржХ, ржЯрзНрз░рзЗржлрж┐ржХ ржЪрж┐ржЧржирзЗрж▓, ржЯрзНрз░рзЗржлрж┐ржХ рж▓рж╛ржЗржЯ, рж▓рж╛ржЗржЯ
ЁЯЪз => ЁЯЪз, ржЪрж┐рж╣рзНржи, ржирж┐рз░рзНржорж╛ржг, ржирж┐рз░рзНржорж╛ржгрз░ ржЪрж┐рж╣рзНржи, ржирж┐рз░рзНржорзАржпрж╝ржорж╛ржи
тЪУ => тЪУ, ржЪрж┐рж╣рзНржи, рж▓ржЩрзНржЧрз░
тЫ╡ => тЫ╡, ржирж╛ржУ, ржкрж╛рж▓рждрз░рж╛ ржирж╛ржУ, ржпрж╝рж╛ржЪрзНржЫ, рз░рж┐ржЬрз░рзНржЯ, рж╕ржорзБржжрзНрз░ рз░рж┐ржЬрз░рзНржЯ
ЁЯЪд => ЁЯЪд, ржирж╛ржУ, ржмрж╛рж╣ржи, рж╕рзНржкрзАржбржмрзЛржЯ
ЁЯЪв => ЁЯЪв, ржЬрж╛рж╣рж╛ржЬ, ржмрж╛рж╣ржи
ЁЯТ║ => ЁЯТ║, ржЖрж╕ржи, ржЪржХрзА
ЁЯЪБ => ЁЯЪБ, ржмрж╛рж╣ржи, рж╣рзЗрж▓рж┐ржХржкрзНржЯрж╛рз░
ЁЯЪЯ => ЁЯЪЯ, ржУрж▓ржорж╛, ржУрж▓ржорж╛ рз░рзЗрж▓рз▒рзЗ, ржмрж╛рж╣ржи, рз░рзЗрж▓рз▒рзЗ
ЁЯЪа => ЁЯЪа, ржХрж╛рз░, ржХрзЗржмрж▓, ржХрзЗржмрж▓ ржХрж╛рз░, ржкрз░рзНржмржд, ржкрз░рзНржмрждрзАржпрж╝рж╛ ржХрзЗржмрж▓ржХрж╛рз░, ржкрз░рзНржмрждрзАржпрж╝рж╛ ржХрзЗржмрж▓рз▒рзЗ, ржмрж╛рж╣ржи
ЁЯЪб => ЁЯЪб, ржХрзЗржмрж▓ ржХрж╛рз░, ржЧржгрзНржбрзЛрж▓рж╛, ржЯрзНрз░рж╛ржорз▒рзЗ, ржмрж╛ржпрж╝ржмрзАржпрж╝, ржмрж╛ржпрж╝ржмрзАржпрж╝ рз░рзЗрж▓рз▒рзЗ, ржмрж╛рж╣ржи, рз░рзЛржкрз▒рзЗ
ЁЯЪА => ЁЯЪА, ржмрж╛рж╣ржи, рз░ржХрзЗржЯ
ЁЯЪк => ЁЯЪк, ржжрзБрз▒рж╛рз░
ЁЯЪ╜ => ЁЯЪ╜, рж╢рзМржЪрж╛ржЧрж╛рз░
ЁЯЪ┐ => ЁЯЪ┐, рж╢рзНржмрж╛рз▒рж╛рз░
ЁЯЫБ => ЁЯЫБ, ржмрж╛рже ржЯрж╛ржм
тМЫ => тМЫ, ржмрж╛рж▓рж┐, ржмрж╛рж▓рж┐ржШржбрж╝рзА
тП│ => тП│, ржЯрж╛ржЗржорж╛рз░, ржмрж╛рж▓рж┐ ржЯрж╛ржЗржорж╛рз░, ржмрж╛рж▓рж┐ржШржбрж╝рзА, ржмрж╛рж▓рж┐рз░ ржШржгрзНржЯрж╛ржШржбрж╝рзА
тМЪ => тМЪ, ржШржбрж╝рзА, рж╣рж╛рждржШржбрж╝рзА
тП░ => тП░, ржПрж▓рж╛рз░рзНржо, ржПрж▓рж╛рз░рзНржо ржШржбрж╝рзА, ржШржбрж╝рзА
ЁЯХЫ => ЁЯХЫ, 12 ржмржЬрж╛, 12:00, ржШржбрж╝рзА
ЁЯХз => ЁЯХз, 12:30, ржШржбрж╝рзА, ржмрж╛рз░ ржмрж╛ржЬрж┐ рждрзНрз░рж┐рж╢ ржорж┐ржирж┐ржЯ
ЁЯХР => ЁЯХР, 1 ржмржЬрж╛, 1:00, ржШржбрж╝рзА
ЁЯХЬ => ЁЯХЬ, 1:30, ржШржбрж╝рзА, ржбрзЗрз░ ржмржЬрж╛
ЁЯХС => ЁЯХС, 2 ржмржЬрж╛, 2:00, ржШржбрж╝рзА
ЁЯХЭ => ЁЯХЭ, 2:30, ржЖржврж╝рзИ ржмржЬрж╛, ржШржбрж╝рзА
ЁЯХТ => ЁЯХТ, 3 ржмржЬрж╛, 3:00, ржШржбрж╝рзА
ЁЯХЮ => ЁЯХЮ, 3:30, ржШржбрж╝рзА, рждрж┐ржирж┐ ржмрж╛ржЬрж┐ рждрзНрз░рж┐рж╢ ржорж┐ржирж┐ржЯ
ЁЯХУ => ЁЯХУ, 4 ржмржЬрж╛, 4:00, ржШржбрж╝рзА
ЁЯХЯ => ЁЯХЯ, 4:30, ржШржбрж╝рзА, ржЪрж╛рз░рж┐ ржмрж╛ржЬрж┐ рждрзНрз░рж┐рж╢ ржорж┐ржирж┐ржЯ
ЁЯХФ => ЁЯХФ, 5 ржмржЬрж╛, 5:00, ржШржбрж╝рзА
ЁЯХа => ЁЯХа, 5:30, ржШржбрж╝рзА, ржкрж╛ржБржЪ ржмрж╛ржЬрж┐ рждрзНрз░рж┐рж╢ ржорж┐ржирж┐ржЯ
ЁЯХХ => ЁЯХХ, 6 ржмржЬрж╛, 6:00, ржШржбрж╝рзА
ЁЯХб => ЁЯХб, 6:30, ржШржбрж╝рзА, ржЫржпрж╝ ржмрж╛ржЬрж┐ рждрзНрз░рж┐рж╢ ржорж┐ржирж┐ржЯ
ЁЯХЦ => ЁЯХЦ, 7 ржмржЬрж╛, 7:00, ржШржбрж╝рзА
ЁЯХв => ЁЯХв, 7:30, ржШржбрж╝рзА, рж╕рж╛ржд ржмрж╛ржЬрж┐ рждрзНрз░рж┐рж╢ ржорж┐ржирж┐ржЯ
ЁЯХЧ => ЁЯХЧ, 8 ржмржЬрж╛, 8:00, ржШржбрж╝рзА
ЁЯХг => ЁЯХг, 8:30, ржЖржа ржмрж╛ржЬрж┐ рждрзНрз░рж┐рж╢ ржорж┐ржирж┐ржЯ, ржШржбрж╝рзА
ЁЯХШ => ЁЯХШ, 9 ржмржЬрж╛, 9:00, ржШржбрж╝рзА
ЁЯХд => ЁЯХд, 9:30, ржШржбрж╝рзА, ржи ржмрж╛ржЬрж┐ рждрзНрз░рж┐рж╢ ржорж┐ржирж┐ржЯ
ЁЯХЩ => ЁЯХЩ, 10 ржмржЬрж╛, 10:00, ржШржбрж╝рзА
ЁЯХе => ЁЯХе, 10:30, ржШржбрж╝рзА, ржжрж╣ ржмрж╛ржЬрж┐ рждрзНрз░рж┐рж╢ ржорж┐ржирж┐ржЯ
ЁЯХЪ => ЁЯХЪ, 11 ржмржЬрж╛, 11:00, ржШржбрж╝рзА
ЁЯХж => ЁЯХж, 11:30, ржПржШрж╛рз░ ржмрж╛ржЬрж┐ рждрзНрз░рж┐рж╢ ржорж┐ржирж┐ржЯ, ржШржбрж╝рзА
ЁЯМС => ЁЯМС, ржЕржорж╛рз▒рж╕рзНржпрж╛, ржЕржорж╛рз▒рж╕рзНржпрж╛рз░ ржЪржирзНржжрзНрз░, ржЪржирзНржжрзНрз░, ржирждрзБржи, ржирждрзБржи ржЪржирзНржжрзНрз░
ЁЯМТ => ЁЯМТ, ржЕрз░рзНржз, ржЕрз░рзНржзржЪржирзНржжрзНрз░, ржЪржирзНржжрзНрз░, ржмрз░рзНржжрзНржзрж┐ржд, ржмрз░рзНржжрзНржзрж┐ржд ржЪржирзНржжрзНрз░
ЁЯМУ => ЁЯМУ, ржЕрз░рзНржз, ржЕрз░рзНржзржЪржирзНржжрзНрз░, ржЪржирзНржжрзНрз░, ржкрзНрз░ржержо ржЕрз░рзНржз ржЪржирзНржжрзНрз░
ЁЯМФ => ЁЯМФ, ржЪржирзНржжрзНрз░, ржжрзБрз░рж╛ржкрж┐ржарж┐ржпрж╝рж╛, ржжрзБрз░рж╛ржкрж┐ржарж┐ржпрж╝рж╛ ржЪржирзНржжрзНрз░, ржмрз░рзНржжрзНржзрж┐ржд, ржмрз░рзНржжрзНржзрж┐ржд ржЪржирзНржжрзНрз░
ЁЯМХ => ЁЯМХ, ржЙржЬрзНржЬрзНржмрж▓, ржЙржЬрзНржЬрзНржмрж▓ ржЪржирзНржжрзНрз░, ржЪржирзНржжрзНрз░, ржкрзВрз░рзНржгрж┐ржорж╛, ржкрзВрз░рзНржгрж┐ржорж╛рз░ ржЬрзЛржи
ЁЯМЦ => ЁЯМЦ, ржЪржирзНржжрзНрз░, ржжрзБрз░рж╛ржкрж┐ржарж┐ржпрж╝рж╛, ржжрзБрз░рж╛ржкрж┐ржарж┐ржпрж╝рж╛ ржЪржирзНржжрзНрз░, ржирж┐рж╕рзНрждрзЗржЬ, ржирж┐рж╕рзНрждрзЗржЬ ржЪржирзНржжрзНрз░
ЁЯМЧ => ЁЯМЧ, ржЕржирзНрждрж┐ржо ржЕрз░рзНржз ржЪржирзНржжрзНрз░, ржЕрз░рзНржз, ржЕрз░рзНржз ржЪржирзНржжрзНрз░, ржЪржирзНржжрзНрз░
ЁЯМШ => ЁЯМШ, ржХрж╛ржБржЪрж┐, ржХрж╛ржБржЪрж┐ржЬрзЛржи, ржЪржирзНржжрзНрз░, ржирж┐рж╕рзНрждрзЗржЬ, ржирж┐рж╕рзНрждрзЗржЬ ржЪржирзНржжрзНрз░
ЁЯМЩ => ЁЯМЩ, ржХрж╛ржБржЪрж┐, ржХрж╛ржБржЪрж┐ржЬрзЛржи, ржЪржирзНржжрзНрз░
ЁЯМЪ => ЁЯМЪ, ржЪржирзНржжрзНрз░, ржирждрзБржи ржЪржирзНржжрзНрз░, ржирждрзБржи ржЪржирзНржжрзНрз░ ржорзБржЦ, ржорзБржЦ, ржорзБржЦ рж╕рж╣ ржирждрзБржи ржЪржирзНржжрзНрз░
ЁЯМЫ => ЁЯМЫ, ржЕрз░рзНржз ржЪржирзНржжрзНрз░, ржПржЦржи ржорзБржЦ рж╕рж╣ ржЕрз░рзНржз ржЪржирзНржжрзНрз░, ржПржЦржи ржорзБржЦ рж╕рж╣ ржЪржирзНржжрзНрз░, ржЪржирзНржжрзНрз░, ржорзБржЦ
ЁЯМЬ => ЁЯМЬ, ржЕржирзНрждрж┐ржо ржЕрз░рзНржз ржЪржирзНржжрзНрз░, ржЕрз░рзНржз ржЪржирзНржжрзНрз░, ржЕрз░рзНржз ржЪржирзНржжрзНрз░рз░ ржорзБржЦ, ржПржЦржи ржорзБржЦ рж╕рж╣ ржЕрз░рзНржз ржЪржирзНржжрзНрз░, ржПржЦржи ржорзБржЦ рж╕рж╣ ржЪржирзНржжрзНрз░, ржЪржирзНржжрзНрз░, ржорзБржЦ
ЁЯМЭ => ЁЯМЭ, ржПржЦржи ржорзБржЦ рж╕рж╣ ржЪржирзНржжрзНрз░, ржПржЦржи ржорзБржЦ рж╕рж╣ ржкрзВрз░рзНржг ржЪржирзНржжрзНрз░, ржЪржирзНржжрзНрз░, ржкрзВрз░рзНржг, ржкрзВрз░рзНржг ржЪржирзНржжрзНрз░, ржкрзВрз░рзНржг ржЪржирзНржжрзНрз░ ржорзБржЦ, ржорзБржЦ
ЁЯМЮ => ЁЯМЮ, ржорзБржЦ, рж╕рзВрз░рзНржп, рж╕рзВрз░рзНржп ржорзБржЦ
ЁЯМЯ => ЁЯМЯ, ржЙржЬрзНржЬрзНржмрж▓рж┐ржд, ржЬрж┐рж▓рж┐ржХрж╛, ржЬрж┐рж▓рж┐ржХрж┐ ржержХрж╛ рждрз░рж╛, рждрз░рж╛, ржжрзАржкрзНржд
ЁЯМа => ЁЯМа, ржЦрж╣рж┐ ржкрз░рж╛, ржЦрж╣рж┐ ржкрз░рж╛ рждрз░рж╛, рждрз░рж╛, ржкржкрзАржпрж╝рж╛, ржкржкрзАржпрж╝рж╛ рждрз░рж╛
тШБ => тШБ, ржбрж╛рз▒рз░, ржмрждрз░
тЫЕ => тЫЕ, ржбрж╛рз▒рз░, ржбрж╛рз▒рз░рз░ ржкрж┐ржЫржлрж╛рж▓рзЗ рж╕рзВрз░рзНржпрзНржп, ржбрж╛рз▒рз░рз░ рж╕рзИрждрзЗ рж╕рзВрз░рзНржпрзНржп, рж╕рзВрз░рзНржпрзНржп
ЁЯМА => ЁЯМА, ржЖржЪржирзНржжрзНрз░рж╛ржЗ, ржШрзВрз░рзНржгрзА ржмрждрж╛рж╣, ржзрзБржорзБрж╣рж╛, ржзрзБржорзБрж╣рж╛-ржмрждрж╛рж╣
ЁЯМИ => ЁЯМИ, рз░рж╛ржоржзрзЗржирзБ
ЁЯМВ => ЁЯМВ, ржЫржБрждрж┐, ржмрз░рж╖рзБржг, ржмрзГрж╖рзНржЯрж┐ржкрж╛ржд
тЪб => тЪб, ржЙржЪрзНржЪ, ржЙржЪрзНржЪ ржнтАЩрж▓рзНржЯрзЗржЬ, ржЙржЪрзНржЪ ржнтАЩрж▓рзНржЯрзЗржЬ ржЪрж┐рж╣рзНржи, ржЙржЪрзНржЪ ржнтАЩрж▓рзНржЯрзЗржЬ ржмрж┐ржкржж, ржЪрж┐рж╣рзНржи, ржмрж┐ржкржж, ржнтАЩрж▓рзНржЯрзЗржЬ
тЫД => тЫД, рждрзБрж╖рж╛рз░, рждрзБрж╖рж╛рз░ ржЕржмрж┐рж╣ржирзЗ рждрзБрж╖рж╛рз░ ржорж╛ржирз▒, рждрзБрж╖рж╛рз░ ржорж╛ржирз▒
ЁЯФе => ЁЯФе, ржЬрзБржЗ, рж╢рж┐ржЦрж╛
ЁЯТз => ЁЯТз, ржШрж╛ржо, ржШрж╛ржорз░ ржЯрзЛржкрж╛рж▓, ржарж╛ржгрзНржбрж╛ ржШрж╛ржо
ЁЯМК => ЁЯМК, ржврзМ, ржкрж╛ржирзАрз░ ржврзМ, рж╕рж╛ржЧрз░рз░ ржврзМ
ЁЯОГ => ЁЯОГ, ржЙржжржпрж╛ржкржи, ржЬрзЗржХ, рз░ржЩрж╛рж▓рж╛ржУ, рж╣рзЗрж▓рзЛрз▒рзАржи
ЁЯОД => ЁЯОД, ржЙржжржпрж╛ржкржи, ржЦрзНрз░рзАрж╖рзНржЯржорж╛ржЪ ржЧржЫ, ржЧржЫ
ЁЯОЖ => ЁЯОЖ, ржЖрждржЪржмрж╛ржЬрзА, ржЙржжржпрж╛ржкржи
ЁЯОЗ => ЁЯОЗ, ржЖрждржЪржмрж╛ржЬрзА, ржЙржжржпрж╛ржкржи, ржлржЯржХрж╛, ржлрзБрж▓ржЬрз░рж┐
тЬи => тЬи, рждрз░рж╛, рждрж┐рз░ржмрж┐рз░рж╛ржЗ ржержХрж╛, рждрж┐рз░ржмрж┐рз░рж╛ржЗ ржержХрж╛ рждрз░рж╛, рждрж┐рз░ржмрж┐рз░рзЛрз▒рж╛
ЁЯОИ => ЁЯОИ, ржЙржжржпрж╛ржкржи, ржмрзЗрж▓рзБржи
ЁЯОЙ => ЁЯОЙ, ржЙржжржпрж╛ржкржи, ржкрж╛рз░рзНржЯрзА, ржкрж╛рз░рзНржЯрзА ржкржкрж╛рз░
ЁЯОК => ЁЯОК, ржЙржжржпрж╛ржкржи, ржХржиржлрзЗржЯрж┐, ржХржиржлрзЗржЯрж┐ ржмрж▓
ЁЯОЛ => ЁЯОЛ, ржЙржжржпрж╛ржкржи, ржХрж╛ржЧржЬрз░ ржкржЯрж┐, ржЧржЫ, ржЧржЫ ржЖрз░рзБ ржХрж╛ржЧржЬрз░ ржкржЯрж┐, рждрз░рж╛ ржЙрзОрж╕рз▒
ЁЯОН => ЁЯОН, ржЙржжржпрж╛ржкржи, ржЬрж╛ржкрж╛ржирзА, ржирждрзБржи ржмржЫрз░, ржкрж╛ржЗржи, ржкрж╛ржЗржи рж╕рж╛ржЬ-рж╕ржЬрзНржЬрж╛
ЁЯОО => ЁЯОО, ржЙрзОрж╕рз▒, ржЙржжржпрж╛ржкржи, ржЬрж╛ржкрж╛ржирзА, ржкрзБрждрж▓рж╛, ржкрзБрждрж▓рж╛рз░ ржЙрзОрж╕рз▒
ЁЯОП => ЁЯОП, ржЙржжржпрж╛ржкржи, ржХрж╛рз░рзНржк рж╖рзНржЯрзНрз░рж┐ржорж╛рз░, рж╖рзНржЯрзНрз░рж┐ржорж╛рз░
ЁЯОР => ЁЯОР, ржЪрж╛ржЗржо, ржЭржВржХрж╛рз░, ржмрждрж╛рж╣рз░ ржЭржВржХрж╛рз░, рз▒рж┐ржгрзНржб ржЪрж╛ржЗржо
ЁЯОС => ЁЯОС, ржЪржирзНржжрзНрз░ ржжрз░рзНрж╢ржи, ржЪржирзНржжрзНрз░ ржжрз░рзНрж╢ржи ржЙрзОрж╕рз▒
ЁЯОА => ЁЯОА, ржЙржжржпрж╛ржкржи, рз░рж┐ржмржи
ЁЯОБ => ЁЯОБ, ржЙржжржпрж╛ржкржи, ржЙржкрж╣рж╛рз░, ржорзЗрз░рж┐ржУрз▒рж╛ ржЙржкрж╣рж╛рз░
ЁЯОл => ЁЯОл, ржЯрж┐ржХрзЗржЯ, ржоржирзЛрз░ржЮрзНржЬржи
ЁЯПЖ => ЁЯПЖ, ржЯрзНрз░тАЩржлрж┐, ржкрзБрз░рж╖рзНржХрж╛рз░
тЪ╜ => тЪ╜, ржлрзБржЯржмрж▓, ржлрзБржЯржмрж▓рз░ ржмрж▓, ржмрж▓
тЪ╛ => тЪ╛, ржмрзЗржЫржмрж▓
ЁЯПА => ЁЯПА, ржмрж╛рж╕рзНржХрзЗржЯржмрж▓, ржмрж╛рж╕рзНржХрзЗржЯржмрж▓ ржЦрзЗрж▓
ЁЯПИ => ЁЯПИ, ржЖржорзЗрз░рж┐ржХрж╛ржи ржлрзБржЯржмрж▓, ржЦрзЗрж▓, ржмрж▓
ЁЯПЙ => ЁЯПЙ, ржЦрзЗрж▓, ржмрж▓, рз░рж╛ржЧржмрзА ржлрзБржЯржмрж▓, рз░рж╛ржЧржмрзАрз░ ржмрж▓
ЁЯО╛ => ЁЯО╛, ржХрзНрз░рзАржбрж╝рж╛, ржЯрзЗржирж┐ржЪ, ржЯрзЗржирж┐ржЪ ржмрж▓, ржЯрзЗржирж┐ржЪ рз░рзЗржХрзЗржЯ ржЖрз░рзБ ржмрж▓, ржмрж▓
ЁЯО▒ => ЁЯО▒, ржЖржаржЯрж╛ ржмрж▓, ржЦрзЗрж▓, ржмрж┐рж▓рж┐ржпрж╝рж╛рз░рзНржб
ЁЯО│ => ЁЯО│, ржЧрзЗржо, ржмрж▓, ржмрзЛржЙрж▓рж┐ржВ, ржмрзМрж▓рж┐ржВ
ЁЯОп => ЁЯОп, ржЦрзЗрж▓, ржкрзНрз░рждржХрзНрж╖рзНржп рж▓ржХрзНрж╖рзНржпржнрзЗржж, ржнрзЗржж, рж▓ржХрзНрж╖рзНржп, рж╕ржарж┐ржХ рж▓ржХрзНрж╖рзНржпржнрзЗржж
тЫ│ => тЫ│, ржЧтАЩрж▓рзНржл, ржЧтАЩрж▓рзНржл ржлрзНрж▓рзЗржЧ, ржлрзНрж▓рзЗржЧ ржЗржи рж╣рзЛрж▓, рж╣рзЛрж▓
ЁЯОг => ЁЯОг, ржмрз░рж╢рж┐, ржмрз░рж╢рж┐ ржЖрз░рзБ ржорж╛ржЫ, ржмрз░рж╢рж┐ ржмрзЛрз▒рж╛, ржоржирзЛрз░ржЮрзНржЬржи, ржорж╛ржЫ, ржорж╛ржЫ ржзрз░рж╛
ЁЯО╜ => ЁЯО╜, ржХрзНрз░рзАржбрж╝рж╛, ржЪрж╛рз░рзНржЯ, ржжрзМрз░рж╛, ржжрзМрз░рж╛ ржЪрж╛рз░рзНржЯ, рж╢рзНржмрзЗржЫ, рж╢рзНржмрзЗржЫ рж╕рж╣ ржжрзМрз░рж╛ ржЪрж╛рз░рзНржЯ
ЁЯО┐ => ЁЯО┐, ржХрзНрз░рзАржбрж╝рж╛, ржмрзБржЯ, рж╕рзНржХрж┐, рж╕рзНржХрж┐ ржЖрз░рзБ ржмрзБржЯ
ЁЯОо => ЁЯОо, ржЧрзЗржо, ржЧрзЗржо ржХржгрзНржЯрзНрз░тАЩрж▓рж╛рз░, ржнрж┐ржбрж┐ржЕтАЩ ржЧрзЗржо
ЁЯО▓ => ЁЯО▓, ржЦрзЗрж▓, ржбрж╛ржЗржЪ, ржкрж╛рж╢рж╛
ЁЯГП => ЁЯГП, ржЬтАЩржХрж╛рз░, ржЬтАЩржХрж╛рз░ ржХрж╛рз░рзНржб, рждрж╛ржЪ, рждрж╛ржЪ ржкрж╛ржд
ЁЯАД => ЁЯАД, ржЯрж╛ржЗрж▓, ржбрзНрз░рзЗржЧржи, ржорж╛рж╣ржЬржВ, ржорж╛рж╣ржЬржВ ржЯрж╛ржЗрж▓, рз░ржЩрж╛ ржбрзНрз░рзЗржЧржи
ЁЯО┤ => ЁЯО┤, ржЦрзЗрж▓, рждрж╛ржЪ ржЦрзЗрж▓, рждрж╛ржЪ ржкрж╛ржд, ржлрзБрж▓, ржлрзБрж▓рж╛ржо ржХрж╛рз░рзНржб, рж╣рж╛ржирж╛ржлрзБржбрж╝рж╛
ЁЯФЗ => ЁЯФЗ, ржХржерж╛ ржиржХтАЩржм, ржирж┐рж╢ржмрзНржж, ржмрж╛рждрж┐рж▓ ржЪрж┐рж╣рзНржи рж╕рж╣ рж╕рзНржкрзАржХрж╛рз░, рж╢ржмрзНржж ржиржХрз░рж┐ржм
ЁЯФИ => ЁЯФИ, рж▓рж╛ржЙржбрж╕рзНржкрзАржХрж╛рз░, рж╕рзНржкрзАржХрж╛рз░
ЁЯФЙ => ЁЯФЙ, ржирж┐ржорзНржи ржнрж▓рж┐ржЙржо, ржирж┐ржорзНржи ржнрж▓рж┐ржЙржо рж╕рж╣ рж╕рзНржкрзАржХрж╛рз░, рж╕рзНржкрзАржХрж╛рз░
ЁЯФК => ЁЯФК, ржЙржЪрзНржЪ ржнрж▓рж┐ржЙржо, ржЙржЪрзНржЪ ржнрж▓рж┐ржЙржо рж╕рж╣ рж╕рзНржкрзАржХрж╛рз░, рж╕рзНржкрзАржХрж╛рз░
ЁЯУв => ЁЯУв, ржпрзЛржЧрж╛ржпрзЛржЧ, рз░рж╛ржЬрж╣рзБрз▒рж╛ ржШрзЛрж╖ржгрж╛, рж▓рж╛ржЙржбрж╕рзНржкрзАржХрж╛рз░, рж╣рж╛ржд рж╕рзНржкрзАржХрж╛рз░
ЁЯУг => ЁЯУг, ржорзЗржЧрж╛ржлрзЛржи, ржпрзЛржЧрж╛ржпрзЛржЧ
ЁЯУп => ЁЯУп, ржкрзЛрж╖рзНржЯрзЗрж▓ рж╣рз░рзНржг, рж╣рз░рзНржг
ЁЯФФ => ЁЯФФ, ржЧрзАрз░рзНржЬрж╛, ржШржгрзНржЯрж╛
ЁЯФХ => ЁЯФХ, ржШржгрзНржЯрж╛, ржШржгрзНржЯрж╛ ржирж╛ржЗ, ржмрж╛рждрж┐рж▓ ржЪрж┐рж╣рзНржи рж╕рж╣ ржШржгрзНржЯрж╛, рж╢ржмрзНржж ржирж╛ржЗ
ЁЯО╝ => ЁЯО╝, рж╕ржЩрзНржЧрзАржд, рж╕ржЩрзНржЧрзАрждрз░ рж╕рзНржХтАЩрз░
ЁЯО╡ => ЁЯО╡, рж╕ржЩрзНржЧрзАржд, рж╕ржЩрзНржЧрзАрждрз░ рж╕рзБрз░, рж╕рзБрз░
ЁЯО╢ => ЁЯО╢, ржПржХрж╛ржзрж┐ржХ рж╕ржЩрзНржЧрзАрждрз░ рж╕рзБрз░, рж╕ржЩрзНржЧрзАржд, рж╕рзБрз░
ЁЯОд => ЁЯОд, ржХрж╛рз░рж╛ржУржХрзЗ, ржоржирзЛрз░ржЮрзНржЬржи, ржорж╛ржЗржХ, ржорж╛ржЗржХрзНрз░тАЩржлрзЛржи
ЁЯОз => ЁЯОз, ржоржирзЛрз░ржЮрзНржЬржи, рж╣рзЗржбржлрзЛржи
ЁЯУ╗ => ЁЯУ╗, рз░рзЗржбрж┐ржЕтАЩ
ЁЯО╖ => ЁЯО╖, ржЪрзЗржХрзНрж╕рж╛ржлрзЛржи, ржмрж╛ржжрзНржпржпржирзНрждрзНрз░, рж╕ржЩрзНржЧрзАржд
ЁЯО╕ => ЁЯО╕, ржЧрж┐ржЯрж╛рз░, ржмрж╛ржжрзНржпржпржирзНрждрзНрз░, рж╕ржЩрзНржЧрзАржд
ЁЯО╣ => ЁЯО╣, ржХрзАржмрзЛрз░рзНржб, ржкрж┐ржпрж╝рж╛ржирзЛ, ржмрж╛ржжрзНржпржпржирзНрждрзНрз░, рж╕ржЩрзНржЧрзАржд
ЁЯО║ => ЁЯО║, ржЯрзНрз░рж╛ржорзНржкрзЗржЯ, ржмрж╛ржжрзНржпржпржирзНрждрзНрз░, рж╕ржЩрзНржЧрзАржд, рж╕ржЩрзНржЧрзАржд ржмрж╛ржжрзНржп
ЁЯО╗ => ЁЯО╗, ржмрж╛ржжрзНржпржпржирзНрждрзНрз░, ржнрж╛ржпрж╝рзЛрж▓рж┐ржи, рж╕ржЩрзНржЧрзАржд
ЁЯУ▒ => ЁЯУ▒, ржЪрзЗрж▓ ржлрзЛржи, ржлрзЛржи, ржорзЛржмрж╛ржЗрж▓ ржлрзЛржи
ЁЯУ▓ => ЁЯУ▓, ржХрж╛ржбрж╝ ржЪрж┐ржи рж╕рж╣ ржЪрзЗрж▓ ржлрзЛржи, ржлрзЛржи, ржлрзЛржи ржХрз░рж╛, ржорзЛржмрж╛ржЗрж▓ ржлрзЛржи
ЁЯУЮ => ЁЯУЮ, ржЯрзЗрж▓рж┐ржлрзЛржи, ржлрзЛржи, ржлрзЛржи рз░рж┐ржЪрж┐ржнрж╛рз░, ржпрзЛржЧрж╛ржпрзЛржЧ
ЁЯУЯ => ЁЯУЯ, ржкрзЗржЬрж╛рз░, ржпрзЛржЧрж╛ржпрзЛржЧ
ЁЯУа => ЁЯУа, ржлрзЗржХрзНрж╕, ржлрзЗржХрзНрж╕ ржпржирзНрждрзНрз░, ржпрзЛржЧрж╛ржпрзЛржЧ
ЁЯФЛ => ЁЯФЛ, ржмрзЗржЯрж╛рз░рж┐
ЁЯФМ => ЁЯФМ, ржмрж┐ржжрзНржпрзБрзО, ржмрзИржжрзНржпрзБрждрж┐ржХ ржкрзНрж▓рж╛ржЧ
ЁЯТ╗ => ЁЯТ╗, ржХржорзНржкрж┐ржЙржЯрж╛рз░, ржкрж╛рз░рзНржЪржирзЗрж▓ ржХржорзНржкрж┐ржЙржЯрж╛рз░, ржкрж┐ржЪрж┐
ЁЯТ╜ => ЁЯТ╜, ржбрж┐рж╕рзНржХ, ржорж┐ржирж┐ ржбрж┐рж╕рзНржХ
ЁЯТ╛ => ЁЯТ╛, ржбрж┐рж╕рзНржХ, ржлрзНрж▓ржкрзА, ржлрзНрж▓ржкрзА ржбрж┐рж╕рзНржХ
ЁЯТ┐ => ЁЯТ┐, ржЕржкрзНржЯрж┐ржХрзЗрж▓ ржбрж┐рж╕рзНржХ, ржЪрж┐ржбрж┐, ржбрж┐ржнрж┐ржбрж┐, ржбрж┐рж╕рзНржХ, ржмрзНрж▓рзБ-рз░рзЗ
ЁЯУА => ЁЯУА, ржбрж┐ржнрж┐ржбрж┐, ржбрж┐ржнрж┐ржбрж┐ ржбрж┐рж╕рзНржХ, ржбрж┐рж╕рзНржХ
ЁЯОе => ЁЯОе, ржХрзЗржорзЗрз░рж╛, ржЪрж▓ржЪрж┐рждрзНрз░рз░ ржХрзЗржорзЗрз░рж╛, ржЪрж┐ржирзЗржорж╛, ржоржирзЛрз░ржЮрзНржЬржи
ЁЯОм => ЁЯОм, ржХрзНрж▓рзЗржкрж╛рз░, ржХрзНрж▓рзЗржкрж╛рз░ржмрзЛрз░рзНржб, ржЪрж▓ржЪрж┐рждрзНрз░, ржоржирзЛрз░ржЮрзНржЬржи
ЁЯУ║ => ЁЯУ║, ржЯрж┐ржнрж┐, ржЯрзЗрж▓рж┐ржнрж┐ржЫржи
ЁЯУ╖ => ЁЯУ╖, ржХрзЗржорзЗрз░рж╛
ЁЯУ╣ => ЁЯУ╣, ржХрзЗржорзЗрз░рж╛, ржнрж┐ржбрж┐ржЕтАЩ, ржнрж┐ржбрж┐ржЕтАЩ ржХрзЗржорзЗрз░рж╛
ЁЯУ╝ => ЁЯУ╝, ржХрзЗржЫрзЗржЯ, ржнрж┐ржбрж┐ржЕтАЩ, ржнрж┐ржбрж┐ржЕтАЩ ржХрзЗржЫрзЗржЯ
ЁЯФН => ЁЯФН, ржмрж╛ржУржБ ржорзБржЦрзА ржорзЗржЧржирж┐ржлрж╛ржпрж╝рж┐ржВ ржЧрзНрж▓рж╛ржЫ, ржорзЗржЧржирж┐ржлрж╛ржпрж╝рж┐ржВ ржЧрзНрж▓рж╛ржЫ, рж╕ржирзНржзрж╛ржи
ЁЯФО => ЁЯФО, ржорзЗржЧржирж┐ржлрж╛ржпрж╝рж┐ржВ ржЧрзНрж▓рж╛ржЫ, рж╕ржирзНржзрж╛ржи, рж╕рзЛржБ ржорзБржЦрзА ржорзЗржЧржирж┐ржлрж╛ржпрж╝рж┐ржВ ржЧрзНрж▓рж╛ржЫ
ЁЯФм => ЁЯФм, ржЕржирзБржмрзАржХрзНрж╖ржг ржпржирзНрждрзНрз░, ржорж╛ржЗржХрзНрз░тАЩрж╕рзНржХржк
ЁЯФн => ЁЯФн, ржЯрзЗрж▓рж┐рж╕рзНржХрзЛржк, ржжрзВрз░ржмрзАржХрзНрж╖ржг ржпржирзНрждрзНрз░
ЁЯУб => ЁЯУб, ржЙржкржЧрзНрз░рж╣ ржПржгрзНржЯрзЗржирж╛, ржЙржкржЧрзНрз░рж╣ ржбрж┐ржЫ, ржПржгрзНржЯрзЗржирж╛, ржпрзЛржЧрж╛ржпрзЛржЧ
ЁЯТб => ЁЯТб, ржмрж╛рж▓рзНржм, ржмрж┐ржжрзНржпрзБрждрзНтАН, ржоржирж▓рзИ ржзрж╛рз░ржгрж╛ ржПржЯрж╛ ржЖрж╣рж┐ржЫрзЗ
ЁЯФж => ЁЯФж, ржЯрз░рзНржЪ, ржлрзНрж▓рж╛ржЫрж▓рж╛ржЗржЯ
ЁЯПо => ЁЯПо, ржмрж╛рз░, рз░ржЩрж╛ рж▓рзЗржорзНржк, рз░рзЗрж╖рзНржЯрзБрз░рзЗржгрзНржЯ, рж▓рзЗржорзНржк
ЁЯУФ => ЁЯУФ, ржЕрж▓ржВржХрзГржд ржЯрзЛржХрж╛ржмрж╣рзА, ржЯрзЛржХрж╛ржмрж╣рзА, ржмрзЗржЯрзБржкрж╛ржд, рж╕ржЬрзЛрз▒рж╛ ржЯрзЛржХрж╛ржмрж╣рзА
ЁЯУХ => ЁЯУХ, ржХрж┐рждрж╛ржк, ржмржирзНржз ржХрж┐рждрж╛ржк
ЁЯУЦ => ЁЯУЦ, ржХрж┐рждрж╛ржк, ржЦрзЛрж▓рж╛ ржХрж┐рждрж╛ржк
ЁЯУЧ => ЁЯУЧ, ржХрж┐рждрж╛ржк, рж╕рзЗржЙржЬрзАржпрж╝рж╛ ржХрж┐рждрж╛ржк
ЁЯУШ => ЁЯУШ, ржХрж┐рждрж╛ржк, ржирзАрж▓рж╛ ржХрж┐рждрж╛ржк
ЁЯУЩ => ЁЯУЩ, ржХржорж▓рж╛ ржХрж┐рждрж╛ржк, ржХрж┐рждрж╛ржк
ЁЯУЪ => ЁЯУЪ, ржХрж┐рждрж╛ржк, ржХрж┐рждрж╛ржкрз░ ржарж╛ржХ
ЁЯУУ => ЁЯУУ, ржЯрзЛржХрж╛ржмрж╣рзА
ЁЯУТ => ЁЯУТ, ржЯрзЛржХрж╛ржмрж╣рзА, рж▓рзЗржЬрж╛рз░
ЁЯУГ => ЁЯУГ, ржбржХрзБржорзЗржгрзНржЯ, ржкрзГрж╖рзНржарж╛, ржнрж╛ржБржЬ рж╕рж╣ ржкрзГрж╖рзНржарж╛
ЁЯУЬ => ЁЯУЬ, ржХрж╛ржЧржЬрз░ рж╕рзНржХрзНрз░рзЛрж▓, рж╕рзНржХрзНрз░рзЛрж▓
ЁЯУД => ЁЯУД, ржбржХрзБржорзЗржгрзНржЯ, ржкрзГрж╖рзНржарж╛, рж╕ржирзНржорзБржЦрж▓рзИ ржорзБржЦ ржХрз░рж╛ ржкрзГрж╖рзНржарж╛
ЁЯУ░ => ЁЯУ░, ржмрж╛рждрз░рж┐, ржмрж╛рждрз░рж┐ржХрж╛ржХржд
ЁЯУС => ЁЯУС, ржЪрж┐рж╣рзНржиржХ, ржЯрзЗржм, ржмрзБржХржорж╛рз░рзНржХ, ржмрзБржХржорж╛рз░рзНржХ ржЯрзЗржм
ЁЯФЦ => ЁЯФЦ, ржмрзБржХржорж╛рз░рзНржХ
ЁЯТ░ => ЁЯТ░, ржЯржХрж╛, ржзржи, ржзржирз░ ржЯрзЛржкрзЛрж▓рж╛, ржзржирз░ ржмрзЗржЧ, ржмрзЗржЧ, ржорзБржжрзНрз░рж╛
ЁЯТ┤ => ЁЯТ┤, ржЬрж╛ржкрж╛ржирзА ржорзБржжрзНрз░рж╛рз░ ржирзЛржЯ, ржзржи, ржирзЛржЯ, ржпрж╝рзЗржи, ржпрж╝рзЗржи ржирзЛржЯ
ЁЯТ╡ => ЁЯТ╡, ржбрж▓рж╛рз░, ржбрж▓рж╛рз░ ржирзЛржЯ, ржзржи, ржирзЛржЯ, ржмрзЗржЩрзНржХржирзЛржЯ
ЁЯТ╢ => ЁЯТ╢, ржЗржЙрз░рзЛ, ржЗржЙрз░рзЛ ржирзЛржЯ, ржзржи, ржирзЛржЯ, ржмрзЗржЩрзНржХржирзЛржЯ
ЁЯТ╖ => ЁЯТ╖, ржзржи, ржирзЛржЯ, ржкрж╛ржЙржгрзНржб, ржкрж╛ржЙржгрзНржб ржирзЛржЯ, ржмрзЗржЩрзНржХржирзЛржЯ
ЁЯТ╕ => ЁЯТ╕, ржЙрз░ржгрзАржпрж╝рж╛ ржзржи, ржЙрз░рж┐ ржержХрж╛ ржмрзЗржЩрзНржХржирзЛржЯ, ржзржи, ржирзЛржЯ, ржкрж╛ржЦрж┐ рж▓ржЧрж╛ ржзржи
ЁЯТ│ => ЁЯТ│, ржХрж╛рз░рзНржб, ржХрзНрз░рзЗржбрж┐ржЯ ржХрж╛рз░рзНржб
ЁЯТ╣ => ЁЯТ╣, ржЙрз░рзНржзржорзБржЦрзА, ржЙрз░рзНржзржорзБржЦрзА ржЪрж╛рз░рзНржЯ, ржЪрж╛рз░рзНржЯ, ржмржЬрж╛рз░, ржмрз░рзНржзрж┐ржд ржмржЬрж╛рз░
ЁЯТ▒ => ЁЯТ▒, ржмрж┐ржжрзЗрж╢рзА ржорзБржжрзНрз░рж╛, ржмрж┐ржжрзЗрж╢рзА ржорзБржжрзНрз░рж╛рз░ ржмрж┐ржирж┐ржоржпрж╝
ЁЯТ▓ => ЁЯТ▓, ржбрж▓рж╛рз░, ржбрж▓рж╛рз░ ржЪрж┐ржи, ржзржи, ржмтАЩрж▓рзНржб ржбрж▓рз░ ржЪрж┐ржи, ржорзБржжрзНрз░рж╛
ЁЯУз => ЁЯУз, ржЗржорзЗржЗрж▓, ржкрждрзНрз░, ржорзЗржЗрж▓, ржпрзЛржЧрж╛ржпрзЛржЧ
ЁЯУи => ЁЯУи, ржЕржирзНрждрз░рзНржЧрж╛ржорзА, ржЕржирзНрждрз░рзНржЧрж╛ржорзА ржкрждрзНрз░, ржЗржорзЗржЗрж▓, ржПржиржнрзЗрж▓ржк, ржкрждрзНрз░, ржкрзНрз░рж╛ржкрзНржд ржкрждрзНрз░, ржорзЗржЗрж▓, ржпрзЛржЧрж╛ржпрзЛржЧ
ЁЯУй => ЁЯУй, ржЗржорзЗржЗрж▓, ржПржиржнрзЗрж▓ржк, ржкрждрзНрз░, ржкрзНрз░рзЗрз░рж┐ржд ржкрждрзНрз░, ржмрж╣рж┐рз░рзНржЧрж╛ржорзА, ржмрж╣рж┐рз░рзНржЧрж╛ржорзА ржкрждрзНрз░, ржорзЗржЗрж▓, ржпрзЛржЧрж╛ржпрзЛржЧ
ЁЯУд => ЁЯУд, ржЯрзНрз░рзЗ, ржкрзНрз░рзЗрз░рж┐ржд, ржкрзНрз░рзЗрз░рж┐ржд ржкрждрзНрз░, ржкрзНрз░рзЗрз░рж┐ржд ржмрж╛ржХржЪ, ржмрж╣рж┐рз░рзНржЧрж╛ржорзА ржмрж╛ржХржЪ, ржпрзЛржЧрж╛ржпрзЛржЧ
ЁЯУе => ЁЯУе, ржЕржирзНрждрз░рзНржЧрж╛ржорзА ржмрж╛ржХржЪ, ржЗржиржмржХрзНрж╕, ржЯрзНрз░рзЗ, ржкрзНрз░рж╛ржкрзНржд, ржкрзНрз░рж╛ржкрзНржд ржкрждрзНрз░, ржпрзЛржЧрж╛ржпрзЛржЧ
ЁЯУж => ЁЯУж, ржкрж╛рз░рзНржЪрзЗрж▓, ржкрзЗржХрзЗржЯ, ржмрж╛ржХржЪ
ЁЯУл => ЁЯУл, ржЙрз░рзНржзржорзБржЦрзА ржкрждрж╛ржХрж╛ рж╕рж╣ ржорзЗржЗрж▓ ржмрж╛ржХржЪ, ржбрж╛ржХ, ржбрж╛ржХ ржмрж╛ржХржЪ, ржкрждрж╛ржХрж╛, ржорзЗржЗрж▓ ржмрж╛ржХржЪ
ЁЯУк => ЁЯУк, ржбрж╛ржХ, ржбрж╛ржХ ржмрж╛ржХржЪ, ржирж┐ржорзНржиржорзБржЦрзА ржкрждрж╛ржХрж╛ рж╕рж╣ ржорзЗржЗрж▓ ржмрж╛ржХржЪ, ржкрждрж╛ржХрж╛, ржорзЗржЗрж▓ ржмрж╛ржХржЪ
ЁЯУм => ЁЯУм, ржЙрз░рзНржзржорзБржЦрзА ржкрждрж╛ржХрж╛ рж╕рж╣ ржЦрзЛрж▓рж╛ ржорзЗржЗрж▓ ржмрж╛ржХржЪ, ржбрж╛ржХ, ржбрж╛ржХ ржмрж╛ржХржЪ, ржкрждрж╛ржХрж╛, ржорзЗржЗрж▓ ржмрж╛ржХржЪ
ЁЯУн => ЁЯУн, ржбрж╛ржХ, ржбрж╛ржХ ржмрж╛ржХржЪ, ржирж┐ржорзНржиржорзБржЦрзА ржкрждрж╛ржХрж╛ рж╕рж╣ ржЦрзЛрж▓рж╛ ржорзЗржЗрж▓ ржмрж╛ржХржЪ, ржкрждрж╛ржХрж╛, ржорзЗржЗрж▓ ржмрж╛ржХржЪ
ЁЯУо => ЁЯУо, ржкрзЛрж╖рзНржЯржмржХрзНрж╕
ЁЯУЭ => ЁЯУЭ, ржорзЗржорзЛ, ржорзЗржорзЛ ржмрж╣рзА, ржпрзЛржЧрж╛ржпрзЛржЧ
ЁЯТ╝ => ЁЯТ╝, ржмрзНрз░рж┐ржлржХрзЗржЫ
ЁЯУБ => ЁЯУБ, ржлтАЩрж▓рзНржбрж╛рз░, ржлрж╛ржЗрж▓, ржлрж╛ржЗрж▓ ржлтАЩрж▓рзНржбрж╛рз░
ЁЯУВ => ЁЯУВ, ржЦрзЛрж▓рж╛, ржЦрзЛрж▓рж╛ ржлтАЩрж▓рзНржбрж╛рз░, ржЦрзЛрж▓рж╛ ржлрж╛ржЗрж▓ ржлтАЩрж▓рзНржбрж╛рз░, ржлтАЩрж▓рзНржбрж╛рз░, ржлрж╛ржЗрж▓
ЁЯУЕ => ЁЯУЕ, ржХрзЗрж▓рзЗржгрзНржбрж╛рз░
ЁЯУЖ => ЁЯУЖ, ржХрзЗрж▓рзЗржгрзНржбрж╛рз░, ржлрж╛рж▓рж┐ржм ржкрз░рж╛ ржХрзЗрж▓рзЗржгрзНржбрж╛рз░
ЁЯУЗ => ЁЯУЗ, ржЗржгрзНржбрзЗржХрзНрж╕, ржХрж╛рз░рзНржб ржЗржгрзНржбрзЗржХрзНрж╕, рз░рзЛрж▓рзЛржбрзЗрж╕рзНржХ
ЁЯУИ => ЁЯУИ, ржЙрз░рзНржзржорзБржЦрзА, ржЙрз░рзНржзржорзБржЦрзА ржкрзНрз░рз▒ржгрждрж╛, ржЙрз░рзНржзржорзБржЦрзА ржкрзНрз░рз▒ржгрждрж╛рз░ ржЪрж╛рз░рзНржЯ, ржЧрзНрз░рж╛ржл, ржЪрж╛рз░рзНржЯ
ЁЯУЙ => ЁЯУЙ, ржЧрзНрз░рж╛ржл, ржЪрж╛рз░рзНржЯ, ржирж┐ржорзНржиржорзБржЦрзА, ржирж┐ржорзНржиржорзБржЦрзА ржкрзНрз░рз▒ржгрждрж╛, ржирж┐ржорзНржиржорзБржЦрзА ржкрзНрз░рз▒ржгрждрж╛рз░ ржЪрж╛рз░рзНржЯ
ЁЯУК => ЁЯУК, ржжржгрзНржб ржЧрзНрз░рж╛ржл, ржжржгрзНржб ржЪрж╛рз░рзНржЯ
ЁЯУЛ => ЁЯУЛ, ржХрзНрж▓рж┐ржкржмтАЩрз░рзНржб
ЁЯУМ => ЁЯУМ, ржкрж┐ржи, ржкрзБржЫржкрж┐ржи
ЁЯУН => ЁЯУН, ржШрзВрз░ржгрзАржпрж╝рж╛ ржкрзБржЫржкрж┐ржи, ржкрж┐ржи, ржкрзБржЫржкрж┐ржи
ЁЯУО => ЁЯУО, ржХрзНрж▓рж┐ржк, ржкрзЗржкрж╛рз░ржХрзНрж▓рж┐ржк
ЁЯУП => ЁЯУП, ржкрзЛржг рз░рзБрж▓рж╛рз░, рз░рзБрж▓рж╛рз░
ЁЯУР => ЁЯУР, ржЫрзЗржЯ ржмрз░рзНржЧ, рждрзНрз░рж┐ржнрзБржЬ, рждрзНрз░рж┐ржнрзБржЬ рз░рзБрж▓рж╛рз░
ЁЯФТ => ЁЯФТ, рждрж▓рж╛, ржмржирзНржз рждрж▓рж╛
ЁЯФУ => ЁЯФУ, ржЦрзЛрж▓рж╛ рждрж▓рж╛, рждрж▓рж╛
ЁЯФП => ЁЯФП, ржЧрзЛржкржирзАржпрж╝рждрж╛, ржЪрж┐ржпрж╝рж╛рж╣рзАрз░ ржХрж▓ржо рж╕рж╣ рждрж▓рж╛, рждрж▓рж╛
ЁЯФР => ЁЯФР, ржЫрж╛ржмрж┐ рж╕рж╣ рждрж▓рж╛, ржмржирзНржз рждрж▓рж╛, рж╕рзБрз░ржХрзНрж╖рж┐ржд
ЁЯФС => ЁЯФС, ржЫрж╛ржмрж┐, ржкрж╛ржЫрз▒рз░рзНржб
ЁЯФи => ЁЯФи, рж╕ржБржЬрзБрж▓рж┐, рж╣рж╛ржБрждрзБрз░рзА
ЁЯФл => ЁЯФл, ржкрж┐рж╖рзНржЯрж▓, ржмржирзНржжрзБржХ, рз░рж┐ржнрж▓ржнрж╛рз░
ЁЯФз => ЁЯФз, рз░рзЗржЮрзНржЪ, рж╕ржБржЬрзБрж▓рж┐
ЁЯФй => ЁЯФй, ржирж╛ржЯ, ржирж╛ржЯ ржЖрз░рзБ ржмтАЩрж▓рзНржЯ, ржмтАЩрж▓рзНржЯ, рж╕ржБржЬрзБрж▓рж┐
ЁЯФЧ => ЁЯФЧ, ржжрзБржЯрж╛ рз░рж┐ржВ, рж▓рж┐ржВржХ ржЪрж┐рж╣рзНржи, рж╕ржВржпрзЛржЧ
ЁЯТЙ => ЁЯТЙ, ржФрж╖ржз, ржЪрж┐рз░рж┐ржЮрзНржЬ, ржмрзЗржЬрзА
ЁЯТК => ЁЯТК, ржФрж╖ржз, ржХрзЗржкржЪрзБрж▓, ржЪрж┐ржХрж┐рзОрж╕ржХ, ржкрж┐рж▓
ЁЯЪм => ЁЯЪм, ржЪрж┐рж╣рзНржи, ржзрзВржоржкрж╛ржи, ржзрзВржоржкрж╛ржи ржЕржирзБржорзЛржжрж┐ржд, ржзрзВржоржкрж╛ржи ржЪрж┐рж╣рзНржи
ЁЯЧ┐ => ЁЯЧ┐, ржорзВрз░рзНрждрж┐, ржорзЛрз▒рж╛ржЗ, ржорзЛрз▒рж╛ржЗ ржорзВрз░рзНрждрж┐
ЁЯФо => ЁЯФо, ржмрж▓, ржнрз▒рж┐рж╖рзНржпрзОржмрж╛ржгрзА, ржнрж╛ржЧрзНржп, рж╕рзНржлржЯрж┐ржХ, рж╕рзНржлржЯрж┐ржХрз░ ржмрж▓
ЁЯПз => ЁЯПз, ржПржЯрж┐ржПржо, ржПржЯрж┐ржПржо ржорзЗржЪрж┐ржи
ЁЯЪо => ЁЯЪо, ржЖрз▒рз░рзНржЬржирж╛рз░ ржкрж╛рждрзНрз░ ржЪрж┐рж╣рзНржи, ржЖрз▒рз░рзНржЬржирж╛рз░ ржмрж╛ржХржЪ, ржПржЗ рж╕рзНржерж╛ржиржд ржЖрз▒рз░рзНржЬржирж╛ ржкрзЗрж▓рж╛ржм, ржЪрж┐рж╣рзНржи
ЁЯЪ░ => ЁЯЪ░, ржЦрзЛрз▒рж╛ ржкрж╛ржирзА, ржЦрзЛрз▒рж╛ ржкрж╛ржирзАрз░ ржЪрж┐рж╣рзНржи, ржмрж┐рж╢рзБржжрзНржз ржкрж╛ржирзА
тЩ┐ => тЩ┐, ржЪрж┐рж╣рзНржи, ржкрзНрз░рз▒рзЗрж╢рж╛ржзрж┐ржХрж╛рз░, рж╣рзБржЗрж▓ржЪрзЗржпрж╝рж╛рз░, рж╣рзБржЗрж▓ржЪрзЗржпрж╝рж╛рз░ ржЪрж┐рж╣рзНржи, рж╣рзБржЗрж▓ржЪрзЗржпрж╝рж╛рз░рз░ ржкрзНрз░рз▒рзЗрж╢рж╛ржзрж┐ржХрж╛рз░
ЁЯЪ╣ => ЁЯЪ╣, ржЪрж┐рж╣рзНржи, ржкрзБрз░рзБрж╖ ржЪрж┐рж╣рзНржи, ржкрзБрз░рзБрж╖рз░ ржХрзЛржарж╛, ржкрзБрз░рзБрж╖рз░ ржЪрж┐рж╣рзНржи
ЁЯЪ║ => ЁЯЪ║, ржЪрж┐рж╣рзНржи, ржорж╣рж┐рж▓рж╛ ржЪрж┐рж╣рзНржи, ржорж╣рж┐рж▓рж╛рз░ ржХрзЛржарж╛
ЁЯЪ╗ => ЁЯЪ╗, рж╢рзМржЪрж╛ржЧрж╛рз░, рж╢рзМржЪрж╛ржЧрж╛рз░ ржЪрж┐рж╣рзНржи, рж╕рзНржирж╛ржирж╛ржЧрж╛рз░
ЁЯЪ╝ => ЁЯЪ╝, ржХрзЗржБржЪрзБрз▒рж╛, ржХрзЗржБржЪрзБрз▒рж╛ ржЖржЫрзЗ, ржХрзЗржБржЪрзБрз▒рж╛ ржЪрж┐рж╣рзНржи, ржХрзЗржБржЪрзБрз▒рж╛рз░ ржХрж╛ржкрзЛрз░ рж╕рж▓рзЛрз▒рж╛ рж╕рзНржерж╛ржи
ЁЯЪ╛ => ЁЯЪ╛, ржкрж╛ржирзА ржХрзНрж▓ржЬрзЗржЯ, рж╢рзМржЪрж╛ржЧрж╛рз░, рж╕рзНржирж╛ржирж╛ржЧрж╛рз░
ЁЯЫВ => ЁЯЫВ, ржирж┐ржпрж╝ржирзНрждрзНрз░ржг, ржкрж╛ржЫржктАЩрз░рзНржЯ, ржкрж╛ржЫржктАЩрз░рзНржЯ ржирж┐ржпрж╝ржирзНрждрзНрз░ржг
ЁЯЫГ => ЁЯЫГ, рж╢рзБрж▓рзНржХ ржмрж┐ржнрж╛ржЧ
ЁЯЫД => ЁЯЫД, ржмрзЗржЧрзЗржЬ, ржмрзЗржЧрзЗржЬ ржжрж╛ржмрзА
ЁЯЫЕ => ЁЯЫЕ, ржПрз░рж┐ ржпрзЛрз▒рж╛ рж▓рж╛ржЧрзЗржЬ, ржмрзЗржЧрзЗржЬ, ржмрзЗржЧрзЗржЬ рж╕рзЗрз▒рж╛, рж▓рж╛ржЧрзЗржЬ
тЪа => тЪа, ржЪрж┐рж╣рзНржи, рж╕рж╛рз▒ржзрж╛ржи, рж╕рж╛рз▒ржзрж╛ржи ржЪрж┐рж╣рзНржи
ЁЯЪ╕ => ЁЯЪ╕, ржЪрж┐рж╣рзНржи, ржкрже ржкрж╛рз░ ржХрз░рж╛, рж╢рж┐рж╢рзБ, рж╢рж┐рж╢рзБрз▒рзЗ ржкрже ржкрж╛рз░ ржХрз░рж╛ рж╕рзНржерж╛ржи
тЫФ => тЫФ, ржЪрж┐рж╣рзНржи, ржирж┐рж╖рж┐ржжрзНржз, ржкрзНрз░рз▒рзЗрж╢ ржирж┐рж╖рзЗржз, ржкрзНрз░рз▒рзЗрж╢ ржирж┐рж╖рзЗржз ржЪрж┐рж╣рзНржи
ЁЯЪл => ЁЯЪл, ржЪрж┐рж╣рзНржи, ржкрзНрз░рз▒рзЗрж╢ ржирж┐рж╖рзЗржз, ржкрзНрз░рз▒рзЗрж╢ ржирж┐рж╖рзЗржз ржЪрж┐рж╣рзНржи
ЁЯЪ│ => ЁЯЪ│, ржЪрж╛ржЗржХрзЗрж▓ ржирж╣ржпрж╝, ржмрж╛ржЗржХ, ржмрж╛ржЗржЪрж╛ржЗржХрзЗрж▓ ржЕржирзБржорзЛржжрж┐ржд ржирж╣ржпрж╝, ржмрж╛ржЗржЪрж╛ржЗржХрзЗрж▓ ржирж╣ржпрж╝, ржмрж╛рж╣ржи
ЁЯЪн => ЁЯЪн, ржЪрж┐рж╣рзНржи, ржзрзВржоржкрж╛ржи ржирж┐рж╖рзЗржз, ржзрзВржоржкрж╛ржи ржирж┐рж╖рзЗржз ржЪрж┐рж╣рзНржи
ЁЯЪп => ЁЯЪп, ржЖрз▒рз░рзНржЬржирж╛ ржкрзЗрж▓рзЛрз▒рж╛ ржирж┐рж╖рзЗржз, ржЪрж┐рж╣рзНржи, рж▓рзЗрждрзЗрз░рж╛ ржиржХрз░рж┐ржм, рж▓рзЗрждрзЗрз░рж╛ ржиржХрз░рж┐ржм ржЪрж┐рж╣рзНржи
ЁЯЪ▒ => ЁЯЪ▒, ржЕрж╢рзБржжрзНржз ржкрж╛ржирзА, ржЦрж╛ржм ржирзЛрз▒рж╛рз░рж╛ ржкрж╛ржирзА, ржЦрзЛрз▒рж╛рз░ ржмрж╛ржмрзЗ ржирж╣ржпрж╝, ржкрж╛ржирзА
ЁЯЪ╖ => ЁЯЪ╖, ржЦрзЛржЬ ржХржврж╝рж╛, ржЪрж┐рж╣рзНржи, ржкржержЪрж╛рз░рзА, ржкржержЪрж╛рз░рзА ржЕржирзБржорзЛржжрж┐ржд ржирж╣ржпрж╝, ржкржержЪрж╛рз░рзА ржирж╣ржпрж╝
ЁЯУ╡ => ЁЯУ╡, ржЪрзЗрж▓ ржлрзЛржи ржирж┐рж╖рзЗржз, ржлрзЛржи, ржлрзЛржи ржХрз░рж╛ ржирж┐рж╖рзЗржз, ржорзЛржмрж╛ржЗрж▓
ЁЯФЮ => ЁЯФЮ, 18 ржмржЫрз░рз░ рждрж▓ржд, 18 ржмржЫрз░рз░ рждрж▓ржд ржирж╣ржпрж╝, 18 ржмржЫрз░рз░ рждрж▓ржд ржирж┐рж╖рзЗржз
ЁЯФГ => ЁЯФГ, ржЙрж▓ржорзНржм ржШржбрж╝рзАрз░ ржХрж╛ржЯрж╛рз░ ржжрж┐рж╢рз░ ржХрж╛ржбрж╝, ржХрж╛ржбрж╝, ржкрзБржирз░-рж▓рзЛржб, ржкрзБржирз░-рж▓рзЛржб ржЪрж┐ржи
ЁЯФД => ЁЯФД, ржХрж╛ржбрж╝, ржШржбрж╝рзАрз░ ржХрж╛ржЯрж╛рз░ ржмрж┐ржкрз░рзАржд ржжрж┐рж╢, ржШржбрж╝рзАрз░ ржХрж╛ржЯрж╛рз░ ржмрж┐ржкрз░рзАржд ржжрж┐рж╢рз░ ржХрж╛ржбрж╝
ЁЯФЩ => ЁЯФЩ, ржХрж╛ржбрж╝, ржкрж┐ржЫрж▓рзИ, ржкрж┐ржЫрж▓рзИ ржХрж╛ржбрж╝, ржмрж╛ржУржБ ржХрж╛ржбрж╝, ржмрж╛ржУржБ ржХрж╛ржбрж╝ рж╕рж╣ ржкрж┐ржЫрж▓рзИ
ЁЯФЪ => ЁЯФЪ, ржХрж╛ржбрж╝, ржмрж╛ржУржБ ржХрж╛ржбрж╝, рж╕ржорж╛ржкрзНржд, рж╕ржорж╛ржкрзНржд ржХрж╛ржбрж╝, рж╕ржорж╛ржкрзНржд ржХрж╛ржбрж╝ рж╕рж╣ ржкрж┐ржЫрж▓рзИ
ЁЯФЫ => ЁЯФЫ, ржЕржи ржХрж╛ржбрж╝, ржЖрж╢рзНржЪрз░рзНржпржмрзЛржзржХ ржЪрж┐рж╣рзНржи рж╕рж╣ ржЕржи ржЖрз░рзБ ржХрж╛ржбрж╝, ржХрж╛ржбрж╝
ЁЯФЬ => ЁЯФЬ, ржХрж╛ржбрж╝, рж╕рзЛржБ ржХрж╛ржбрж╝ рж╕рж╣ рж╕рзЛржиржХрж╛рж▓рзЗ, рж╕рзЛржиржХрж╛рж▓рзЗ, рж╕рзЛржиржХрж╛рж▓рзЗ ржЪрж┐ржи
ЁЯФЭ => ЁЯФЭ, ржЙрз░рзНржзржорзБржЦрзА ржХрж╛ржбрж╝, ржЙрз░рзНржзржорзБржЦрзА ржХрж╛ржбрж╝ рж╕рж╣ рж╢рзАрз░рзНрж╖, рж╢рзАрз░рзНрж╖, рж╢рзАрз░рзНрж╖ ржХрж╛ржбрж╝
ЁЯФп => ЁЯФп, ржЫржпрж╝ ржорзБржЦрзА рждрз░рж╛, рждрз░рж╛, ржнрз▒рж┐рж╖рзНржпрзОржмрж╛ржгрзА, ржнрж╛ржЧрзНржп
тЩИ => тЩИ, ржорзЗрж╖, рз░рж╛рж╢рж┐
тЩЙ => тЩЙ, ржмрзГрж╖, рз░рж╛рж╢рж┐
тЩК => тЩК, ржорж┐ржерзБржи, рз░рж╛рж╢рж┐
тЩЛ => тЩЛ, ржХрз░рзНржХржЯ, рз░рж╛рж╢рж┐
тЩМ => тЩМ, рз░рж╛рж╢рж┐, рж╕рж┐ржВрж╣
тЩН => тЩН, ржХржирзНржпрж╛, рз░рж╛рж╢рж┐
тЩО => тЩО, рждрзБрж▓рж╛, рз░рж╛рж╢рж┐
тЩП => тЩП, ржмрзГрж╢рзНржЪрж┐ржХ, рз░рж╛рж╢рж┐
тЩР => тЩР, ржзржирзБ, рз░рж╛рж╢рж┐
тЩС => тЩС, ржоржХрз░, рз░рж╛рж╢рж┐
тЩТ => тЩТ, ржХрзБржорзНржн, рз░рж╛рж╢рж┐
тЩУ => тЩУ, ржорзАржи, рз░рж╛рж╢рж┐
тЫО => тЫО, ржЕржлрж┐ржЙржХрж╛ржЫ, рз░рж╛рж╢рж┐
ЁЯФА => ЁЯФА, ржХржЯрж╛ржХржЯрж┐ ржХрж╛ржбрж╝, ржХржЯрж╛ржХржЯрж┐ рж╕рзЛржБржорзБржЦрзА ржХрж╛ржбрж╝, ржХрж╛ржбрж╝ ржЪрж┐ржи
ЁЯФБ => ЁЯФБ, ржХрж╛ржбрж╝, ржШржбрж╝рзАрз░ ржХрж╛ржЯрж╛рз░ ржжрж┐рж╢, ржШржбрж╝рзАрз░ ржХрж╛ржЯрж╛рз░ ржжрж┐рж╢рз░ ржХрж╛ржбрж╝
ЁЯФВ => ЁЯФВ, 1 рж╕ржВржЦрзНржпрж╛ рж╕рж╣ ржШржбрж╝рзАрз░ ржХрж╛ржЯрж╛рз░ ржжрж┐рж╢рз░ ржХрж╛ржбрж╝, ржХрж╛ржбрж╝, ржШржбрж╝рзАрз░ ржХрж╛ржЯрж╛рз░ ржжрж┐рж╢, ржШржбрж╝рзАрз░ ржХрж╛ржЯрж╛рз░ ржжрж┐рж╢рз░ ржХрж╛ржбрж╝
тПй => тПй, ржХрж╛ржбрж╝, ржжрзНржмрзИржд рж╕рзЛржБ ржХрж╛ржбрж╝, ржжрзНрз░рзБрждржнрж╛рз▒рзЗ ржЖржЧрж▓рзИ, рж╕рзЛржБ
тПк => тПк, ржХрж╛ржбрж╝, ржжрзНржмрзИржд ржмрж╛ржУржБ ржХрж╛ржбрж╝, ржкрж┐ржЫрж▓рзИ, ржмрж╛ржУржБ
ЁЯФ╝ => ЁЯФ╝, ржЙрз░рзНржзржорзБржЦрзА рждрзНрз░рж┐ржнрзБржЬ, ржЙрз░рзНржзржорзБржЦрзА рждрзНрз░рж┐ржнрзБржЬ ржмрзБржЯрж╛ржо, рждрзНрз░рж┐ржнрзБржЬ
тПл => тПл, ржУржкрз░рж▓рзИ, ржУржкрж▓рзИ ржХрж╛ржбрж╝, ржХрж╛ржбрж╝, ржжрзНржмрзИржд ржУржкрз░рж▓рзИ ржХрж╛ржбрж╝
ЁЯФ╜ => ЁЯФ╜, рждрзНрз░рж┐ржнрзБржЬ, ржирж┐ржорзНржиржорзБржЦрзА рждрзНрз░рж┐ржнрзБржЬ, ржирж┐ржорзНржиржорзБржЦрзА рждрзНрз░рж┐ржнрзБржЬ ржмрзБржЯрж╛ржо
тПм => тПм, ржУржкрз░рж▓рзИ, ржХрж╛ржбрж╝, рждрж▓рж▓рзИ ржХрж╛ржбрж╝, ржжрзНржмрзИржд рждрж▓рж▓рзИ ржХрж╛ржбрж╝
ЁЯОж => ЁЯОж, ржЪрж▓ржЪрж┐рждрзНрз░, ржЪрж┐ржирзЗржорж╛, ржЪрж┐ржирзЗржорж╛рз░ ржЪрж┐ржи, ржоржирзЛрз░ржЮрзНржЬржи
ЁЯФЕ => ЁЯФЕ, ржЕржирзБржЬрзНржмрж▓, ржЙржЬрзНржЬрзНржмрж▓рждрж╛, ржирж┐ржорзНржи, ржирж┐ржорзНржи ржЙржЬрзНржЬрзНржмрж▓рждрж╛, ржирж┐ржорзНржи ржЙржЬрзНржЬрзНржмрж▓рждрж╛рз░ ржЪрж┐рж╣рзНржи
ЁЯФЖ => ЁЯФЖ, ржЙржЪрзНржЪ ржЙржЬрзНржЬрзНржмрж▓рждрж╛, ржЙржЪрзНржЪ ржЙржЬрзНржЬрзНржмрж▓рждрж╛рз░ ржЪрж┐рж╣рзНржи, ржЙржЬрзНржЬрзНржмрж▓, ржЙржЬрзНржЬрзНржмрж▓рждрж╛
ЁЯУ╢ => ЁЯУ╢, ржПржгрзНржЯрзЗржирж╛, ржжржгрзНржбрж┐ржХрж╛ рж╕рж╣ ржПржгрзНржЯрзЗржирж╛, ржлрзЛржи, ржорзЛржмрж╛ржЗрж▓, ржорзЛржмрж╛ржЗрж▓ рж╕ржВржХрзЗржд, рж╕ржВржХрзЗржд, рж╕ржВржХрзЗрждрз░ рж╢ржХрзНрждрж┐
ЁЯУ│ => ЁЯУ│, ржХржорзНржкржи ржорзЛржб, ржЪрзЗрж▓ ржлрзЛржи, ржлрзЛржи, ржорзЛржмрж╛ржЗрж▓ ржлрзЛржи
ЁЯУ┤ => ЁЯУ┤, ржЪрзЗрж▓ ржлрзЛржи, ржЪрзЗрж▓ ржлрзЛржи ржЕржл, ржлрзЛржи, ржлрзЛржи ржЕржл
тЩ╗ => тЩ╗, ржЧрзЛржЯрж╛ ржмрж┐рж╢рзНржмржЬржирзАржи рз░рж┐ржЪрж╛ржЗржХрж▓рж┐ржВ ржЪрж┐рж╣рзНржи, ржЪрж┐рж╣рзНржи, ржмрж┐рж╢рзНржмржЬржирзАржи, рз░рж┐ржЪрж╛ржЗржХрж▓рж┐ржВ, рз░рж┐ржЪрж╛ржЗржХрж▓рж┐ржВ ржЪрж┐рж╣рзНржи
ЁЯФ▒ => ЁЯФ▒, рждрзНрз░рж┐рж╢рзВрж▓, рждрзНрз░рж┐рж╢рзВрж▓ ржЪрж┐рж╣рзНржи, ржкрзНрз░рждрж┐ржХ, рж▓ржЩрзНржЧрз░
ЁЯУЫ => ЁЯУЫ, ржирж╛ржо, ржирж╛ржорз░ ржмрзЗржЬ
ЁЯФ░ => ЁЯФ░, ржЬрж╛ржкрж╛ржирзА, рж╕рзЗржЙржЬрзАржпрж╝рж╛ ржЖрз░рзБ рж╣рж╛рж▓ржзрзАржпрж╝рж╛, рж╕рзЗржЙржЬрзАржпрж╝рж╛ ржЖрз░рзБ рж╣рж╛рж▓ржзрзАржпрж╝рж╛ ржкрж╛ржд
тЬЕ => тЬЕ, ржЯрж┐ржХ, ржЯрж┐ржХ ржЪрж┐рж╣рзНржи, ржбрж╛ржа ржЯрж┐ржХ ржЪрж┐рж╣рзНржи
тЭМ => тЭМ, тАЬXтАЭ, ржХржЯрж╛ ржЪрж┐рж╣рзНржи
тЭО => тЭО, ржХржЯрж╛ ржЪрж┐рж╣рзНржи, ржмрз░рзНржЧрз░ ржнрж┐рждрз░ржд тАЬXтАЭ
тЮХ => тЮХ, ржЪрж┐рж╣рзНржи, ржбрж╛ржа ржпрзЛржЧ ржЪрж┐ржи, ржпрзЛржЧ, ржпрзЛржЧ ржЪрж┐ржи
тЮЦ => тЮЦ, ржЪрж┐рж╣рзНржи, ржбрж╛ржа ржмрж┐ржпрж╝рзЛржЧ ржЪрж┐ржи, ржмрж┐ржпрж╝рзЛржЧ, ржмрж┐ржпрж╝рзЛржЧ ржЪрж┐ржи
тЮЧ => тЮЧ, ржЪрж┐рж╣рзНржи, ржбрж╛ржа рж╣рз░ржг ржЪрж┐ржи, рж╣рз░ржг, рж╣рз░ржг ржЪрж┐ржи
тЮ░ => тЮ░, ржШрзБрз░рж╛, ржкрж╛ржХ, ржнрж╛ржЬржпрзБржХрзНржд ржкрж╛ржХ
тЮ┐ => тЮ┐, ржЬрж╛ржкрж╛ржи, ржжрзНржмрзИржд ржнрж╛ржЬржпрзБржХрзНржд ржкрж╛ржХ, ржмрж┐ржирж╛ржорзВрж▓рзАржпрж╝рж╛ ржбрж╛ржпрж╝рзЗрж▓, ржнрж╛ржЬржпрзБржХрзНржд ржкрж╛ржХ
тЭУ => тЭУ, ржкрзНрз░рж╢рзНржи, ржкрзНрз░рж╢рзНржиржмрзЛржзржХ ржЪрж┐ржи
тЭФ => тЭФ, ржкрзНрз░рж╢рзНржи, ржкрзНрз░рж╢рзНржиржмрзЛржзржХ ржЪрж┐ржи
тЭХ => тЭХ, ржнрж╛рз▒ржмрзЛржзржХ, ржнрж╛рз▒ржмрзЛржзржХ ржЪрж┐ржи
уА░ => уА░, ржбрзЗржЫ, ржврзМ, ржврзМ ржбрзЗржЫ, ржжрзАржШрж▓ рж╢ржмрзНржж ржЪрж┐рж╣рзНржи
┬й => ┬й, рж╕рзНржмрждрзНржмрж╛ржзрж┐ржХрж╛рз░, рж╕рзНржмрждрзНржмрж╛ржзрж┐ржХрж╛рз░ ржЪрж┐ржи
┬о => ┬о, ржкржЮрзНржЬрзАржХрзГржд, ржкржЮрзНржЬрзАржпрж╝ржи ржЪрж┐рж╣рзНржи
тДв => тДв, ржЪрж┐рж╣рзНржи, ржЯрзНрз░рзЗржб ржорж╛рз░рзНржХ, ржЯрзНрз░рзЗржб ржорж╛рз░рзНржХ ржЪрж┐рж╣рзНржи
ЁЯТп => ЁЯТп, 100, 100 ржкржЗржгрзНржЯ, рж╕ржорзНржкрзВрз░рзНржг рж╕рзНржХтАЩрз░, рж╕рзНржХтАЩрз░
ЁЯФа => ЁЯФа, ржмрз░ржлрж▓рж╛рз░ ржЖржЦрз░, ржмрз░ржлрж▓рж╛рз░ рж▓рзЗржЯрж┐ржи, ржмрз░ржлрж▓рж╛рз░ рж▓рзЗржЯрж┐ржи ржЖржЦрз░ ржЗржиржкрзБржЯ
ЁЯФб => ЁЯФб, рж╕рз░рзБржлрж▓рж╛рз░ ржЖржЦрз░, рж╕рз░рзБржлрж▓рж╛рз░ рж▓рзЗржЯрж┐ржи, рж╕рз░рзБрж▓рж╛рз░ рж▓рзЗржЯрж┐ржи ржЖржЦрз░ ржЗржиржкрзБржЯ
ЁЯФв => ЁЯФв, рж╕ржВржЦрзНржпрж╛, рж╕ржВржЦрзНржпрж╛ ржЗржиржкрзБржЯ
ЁЯФг => ЁЯФг, ржЪрж┐рж╣рзНржи, ржЪрж┐рж╣рзНржи ржЗржиржкрзБржЯ
ЁЯФд => ЁЯФд, ABC, ржЗржВрз░рж╛ржЬрзА, рж▓рзЗржЯрж┐ржи, рж▓рзЗржЯрж┐ржи ржмрз░рзНржгржорж╛рж▓рж╛, рж▓рзЗржЯрж┐ржи ржмрз░рзНржгржорж╛рж▓рж╛ ржЗржиржкрзБржЯ
ЁЯЕ░ => ЁЯЕ░, A, рждрзЗржЬ, рждрзЗржЬрз░ ржкрзНрз░ржХрж╛рз░, рждрзЗржЬрз░ ржкрзНрз░ржХрж╛рз░ A, ржкрзНрз░ржХрж╛рз░ A
ЁЯЖО => ЁЯЖО, AB, рждрзЗржЬ, рждрзЗржЬрз░ ржкрзНрз░ржХрж╛рз░, рждрзЗржЬрз░ ржкрзНрз░ржХрж╛рз░ AB, ржкрзНрз░ржХрж╛рз░ AB
ЁЯЕ▒ => ЁЯЕ▒, B, рждрзЗржЬ, рждрзЗржЬрз░ ржкрзНрз░ржХрж╛рз░, рждрзЗржЬрз░ ржкрзНрз░ржХрж╛рз░ B, ржкрзНрз░ржХрж╛рз░ B
ЁЯЖС => ЁЯЖС, CL, CL ржЪрж┐рж╣рзНржи, ржкрз░рж┐рж╖рзНржХрж╛рз░
ЁЯЖТ => ЁЯЖТ, ржарж╛ржгрзНржбрж╛, ржарж╛ржгрзНржбрж╛ ржЪрж┐рж╣рзНржи
ЁЯЖУ => ЁЯЖУ, ржЪрж┐рж╣рзНржи, ржорж╛ржЫрзБрж▓ржмрж┐рж╣рзАржи, ржорзБржХрзНржд, ржорзБржХрзНржд ржЪрж┐рж╣рзНржи
ЁЯЖФ => ЁЯЖФ, ID, ID ржЪрж┐рж╣рзНржи, ржЪрж┐рж╣рзНржи, ржкрз░рж┐ржЪржпрж╝
ЁЯЖХ => ЁЯЖХ, ржЪрж┐рж╣рзНржи, ржирждрзБржи, ржирждрзБржи ржЪрж┐рж╣рзНржи
ЁЯЖЦ => ЁЯЖЦ, NG, NG ржЪрж┐рж╣рзНржи, ржЪрж┐рж╣рзНржи
ЁЯЕ╛ => ЁЯЕ╛, O, рждрзЗржЬ, рждрзЗржЬрз░ ржкрзНрз░ржХрж╛рз░, рждрзЗржЬрз░ ржкрзНрз░ржХрж╛рз░ O, ржкрзНрз░ржХрж╛рз░ O
ЁЯЖЧ => ЁЯЖЧ, OK, OK ржЪрж┐рж╣рзНржи
ЁЯЕ┐ => ЁЯЕ┐, ржкрж╛рз░рзНржХрж┐ржВ, ржкрж╛рз░рзНржХрж┐ржВ рж╕рзНржерж╛ржи
ЁЯЖШ => ЁЯЖШ, SOS, SOS ржЪрж┐рж╣рзНржи, ржЪрж┐рж╣рзНржи, рж╕рж╣рж╛ржпрж╝
ЁЯЖЩ => ЁЯЖЩ, UP!, UP! ржЪрж┐рж╣рзНржи, ржЪрж┐рж╣рзНржи
ЁЯЖЪ => ЁЯЖЪ, vs, ржЪрж┐рж╣рзНржи, ржмржирж╛ржо, ржмржирж╛ржо ржЪрж┐рж╣рзНржи
ЁЯИБ => ЁЯИБ, ржЬрж╛ржкрж╛ржирзА рж╢ржмрзНржж
ЁЯИВ => ЁЯИВ, ржЬрж╛ржкрж╛ржирзА рж╢ржмрзНржж
ЁЯИ╖ => ЁЯИ╖, ржЬрж╛ржкрж╛ржирзА рж╢ржмрзНржж
ЁЯИ╢ => ЁЯИ╢, ржЬрж╛ржкрж╛ржирзА рж╢ржмрзНржж
ЁЯИп => ЁЯИп, ржЬрж╛ржкрж╛ржирзА рж╢ржмрзНржж
ЁЯЙР => ЁЯЙР, ржЬрж╛ржкрж╛ржирзА рж╢ржмрзНржж
ЁЯИ╣ => ЁЯИ╣, ржЬрж╛ржкрж╛ржирзА рж╢ржмрзНржж
ЁЯИЪ => ЁЯИЪ, ржЬрж╛ржкрж╛ржирзА рж╢ржмрзНржж
ЁЯИ▓ => ЁЯИ▓, ржЬрж╛ржкрж╛ржирзА рж╢ржмрзНржж
ЁЯЙС => ЁЯЙС, ржЪрзАржирж╛ рж╢ржмрзНржж
ЁЯИ╕ => ЁЯИ╕, ржЪрзАржирж╛ рж╢ржмрзНржж
ЁЯИ┤ => ЁЯИ┤, ржЪрзАржирж╛ рж╢ржмрзНржж
ЁЯИ│ => ЁЯИ│, ржЪрзАржирж╛ рж╢ржмрзНржж
ЁЯИ║ => ЁЯИ║, ржЪрзАржирж╛ рж╢ржмрзНржж
ЁЯИ╡ => ЁЯИ╡, ржЪрзАржирж╛ рж╢ржмрзНржж
ЁЯФ╢ => ЁЯФ╢, ржбрж╛ржЩрз░ ржХржорж▓рж╛ рж╣рзАрз░рж╛, ржбрж╛ржЩрз░ рж╣рзАрз░рж╛, рж╣рзАрз░рж╛
ЁЯФ╖ => ЁЯФ╖, ржбрж╛ржЩрз░ ржирзАрж▓рж╛ рж╣рзАрз░рж╛, ржбрж╛ржЩрз░ рж╣рзАрз░рж╛, рж╣рзАрз░рж╛
ЁЯФ╕ => ЁЯФ╕, рж╕рз░рзБ ржХржорж▓рж╛ рж╣рзАрз░рж╛, рж╕рз░рзБ рж╣рзАрз░рж╛, рж╣рзАрз░рж╛
ЁЯФ╣ => ЁЯФ╣, рж╕рз░рзБ ржирзАрж▓рж╛ рж╣рзАрз░рж╛, рж╕рз░рзБ рж╣рзАрз░рж╛, рж╣рзАрз░рж╛
ЁЯФ║ => ЁЯФ║, ржЙрз░рзНржзржорзБржЦрзА рждрзНрз░рж┐ржнрзБржЬ, ржЙрз░рзНржзржорзБржЦрзА рз░ржЩрж╛ рждрзНрз░рж┐ржнрзБржЬ, рждрзНрз░рж┐ржнрзБржЬ
ЁЯФ╗ => ЁЯФ╗, рждрзНрз░рж┐ржнрзБржЬ, ржирж┐ржорзНржиржорзБржЦрзА рждрзНрз░рж┐ржнрзБржЬ, ржирж┐ржорзНржиржорзБржЦрзА рз░ржЩрж╛ рждрзНрз░рж┐ржнрзБржЬ
ЁЯТа => ЁЯТа, ржЖржмрзЗржЧ, ржлрзБрж▓рз░ ржкрж╛рж╣рж┐, рж╣рзАрз░рж╛рз░ ржЖржХрзГрждрж┐
ЁЯФШ => ЁЯФШ, ржмрзБржЯрж╛ржо, рз░рзЗржбрж┐ржЕтАЩ, рз░рзЗржбрж┐ржЕтАЩ ржмрзБржЯрж╛ржо
ЁЯФ▓ => ЁЯФ▓, ржмрз░рзНржЧ, ржмрз░рзНржЧрж╛ржХрж╛рз░ ржмрзБржЯрж╛ржо, ржмрзБржЯрж╛ржо
ЁЯФ│ => ЁЯФ│, ржмрз░рзНржЧ, ржмрз░рзНржЧрж╛ржХрж╛рз░ ржмрзБржЯрж╛ржо, ржмрзБржЯрж╛ржо
ЁЯФ┤ => ЁЯФ┤, ржбрж╛ржЩрз░ ржмрзГрждрзНржд, ржбрж╛ржЩрз░ рз░ржЩрж╛ ржмрзГрждрзНржд, ржмрзГрждрзНржд
ЁЯФ╡ => ЁЯФ╡, ржбрж╛ржЩрз░ ржирзАрж▓рж╛ ржмрзГрждрзНржд, ржбрж╛ржЩрз░ ржмрзГрждрзНржд, ржмрзГрждрзНржд
ЁЯПБ => ЁЯПБ, ржЦрзЗрж▓, ржЪрзЗржХрж╛рз░рзНржб ржкрждрж╛ржкрж╛, ржкрждрж╛ржХрж╛, рз░рзЗржЪрж┐ржВ
ЁЯЪй => ЁЯЪй, ржЕрз▒рж╕рзНржерж╛ржи, ржЕрз▒рж╕рзНржерж╛ржи рждржерзНржп ржкрждрж╛ржХрж╛, ржЕрз▒рж╕рзНржерж╛ржи ржкрждрж╛ржХрж╛, рждрзНрз░рж┐ржнрзБржЬрж╛ржХрж╛рз░ ржЕрз▒рж╕рзНржерж╛ржи ржкрждрж╛ржХрж╛, рждрзНрз░рж┐ржнрзБржЬрж╛ржХрж╛рз░ ржкрждрж╛ржХрж╛
ЁЯОМ => ЁЯОМ, ржЙржжржпрж╛ржкржи, ржХржЯрж╛ржХржЯрж┐, ржХржЯрж╛ржХржЯрж┐ ржХрз░рж╛ ржкрждрж╛ржХрж╛, ржЬрж╛ржкрж╛ржирз░ ржХржЯрж╛ржХржЯрж┐ ржХрз░рж╛ ржкрждрж╛ржХрж╛, ржкрждрж╛ржХрж╛
